,Code département,département,Inscrits,Votants,Blancs et nuls,Exprimés,year,election_round,election
0,1,AIN,12513,6169,598,5571,2001,t2,cantonales
1,1,AIN,8358,4793,249,4544,2001,t2,cantonales
2,1,AIN,2619,1852,94,1758,2001,t2,cantonales
3,1,AIN,5830,3847,140,3707,2001,t2,cantonales
4,1,AIN,3592,2304,181,2123,2001,t2,cantonales
5,1,AIN,13208,5730,151,5579,2001,t2,cantonales
6,1,AIN,3095,1870,112,1758,2001,t2,cantonales
7,1,AIN,11722,5806,260,5546,2001,t2,cantonales
8,1,AIN,9134,4913,337,4576,2001,t2,cantonales
9,1,AIN,3420,2192,73,2119,2001,t2,cantonales
10,1,AIN,8078,3757,181,3576,2001,t2,cantonales
11,1,AIN,5274,3292,195,3097,2001,t2,cantonales
12,1,AIN,6613,3929,137,3792,2001,t2,cantonales
13,1,AIN,7296,4345,167,4178,2001,t2,cantonales
14,1,AIN,9263,5123,218,4905,2001,t2,cantonales
15,1,AIN,12946,6029,193,5836,2001,t2,cantonales
16,2,AISNE,2654,2096,105,1991,2001,t2,cantonales
17,2,AISNE,6175,4566,125,4441,2001,t2,cantonales
18,2,AISNE,6055,3859,264,3595,2001,t2,cantonales
19,2,AISNE,8144,5229,272,4957,2001,t2,cantonales
20,2,AISNE,5420,3991,181,3810,2001,t2,cantonales
21,2,AISNE,8259,4886,256,4630,2001,t2,cantonales
22,2,AISNE,6050,4297,297,4000,2001,t2,cantonales
23,2,AISNE,6689,3795,242,3553,2001,t2,cantonales
24,2,AISNE,3915,2728,120,2608,2001,t2,cantonales
25,2,AISNE,14476,6373,321,6052,2001,t2,cantonales
26,2,AISNE,9528,6161,190,5971,2001,t2,cantonales
27,2,AISNE,5049,3890,295,3595,2001,t2,cantonales
28,2,AISNE,15378,9400,652,8748,2001,t2,cantonales
29,2,AISNE,15960,7491,442,7049,2001,t2,cantonales
30,3,ALLIER,5565,3923,215,3708,2001,t2,cantonales
31,3,ALLIER,6340,4221,154,4067,2001,t2,cantonales
32,3,ALLIER,3564,2600,92,2508,2001,t2,cantonales
33,3,ALLIER,7259,5271,214,5057,2001,t2,cantonales
34,3,ALLIER,5926,3899,173,3726,2001,t2,cantonales
35,3,ALLIER,7406,4817,233,4584,2001,t2,cantonales
36,3,ALLIER,3857,2861,152,2709,2001,t2,cantonales
37,3,ALLIER,11005,6492,255,6237,2001,t2,cantonales
38,3,ALLIER,10190,5632,183,5449,2001,t2,cantonales
39,3,ALLIER,3832,2669,98,2571,2001,t2,cantonales
40,3,ALLIER,10838,7042,239,6803,2001,t2,cantonales
41,3,ALLIER,9063,5652,495,5157,2001,t2,cantonales
42,3,ALLIER,7456,4449,213,4236,2001,t2,cantonales
43,3,ALLIER,12145,7048,281,6767,2001,t2,cantonales
44,4,ALPES DE HAUTE PROVENCE,1884,1426,46,1380,2001,t2,cantonales
45,4,ALPES DE HAUTE PROVENCE,6490,4188,281,3907,2001,t2,cantonales
46,4,ALPES DE HAUTE PROVENCE,6789,4577,337,4240,2001,t2,cantonales
47,4,ALPES DE HAUTE PROVENCE,996,785,39,746,2001,t2,cantonales
48,4,ALPES DE HAUTE PROVENCE,2579,1966,103,1863,2001,t2,cantonales
49,4,ALPES DE HAUTE PROVENCE,2203,1626,304,1322,2001,t2,cantonales
50,4,ALPES DE HAUTE PROVENCE,2304,1841,58,1783,2001,t2,cantonales
51,4,ALPES DE HAUTE PROVENCE,8445,5525,455,5070,2001,t2,cantonales
52,4,ALPES DE HAUTE PROVENCE,7745,4981,270,4711,2001,t2,cantonales
53,5,HAUTES ALPES,1664,1374,64,1310,2001,t2,cantonales
54,5,HAUTES ALPES,3115,2200,118,2082,2001,t2,cantonales
55,5,HAUTES ALPES,4147,3141,179,2962,2001,t2,cantonales
56,5,HAUTES ALPES,6278,3410,177,3233,2001,t2,cantonales
57,6,ALPES MARITIMES,22858,10144,960,9184,2001,t2,cantonales
58,6,ALPES MARITIMES,20179,9605,370,9235,2001,t2,cantonales
59,6,ALPES MARITIMES,8205,5143,196,4947,2001,t2,cantonales
60,6,ALPES MARITIMES,17772,10064,889,9175,2001,t2,cantonales
61,6,ALPES MARITIMES,17066,7653,472,7181,2001,t2,cantonales
62,6,ALPES MARITIMES,13583,6900,612,6288,2001,t2,cantonales
63,6,ALPES MARITIMES,13053,6429,893,5536,2001,t2,cantonales
64,6,ALPES MARITIMES,13915,6404,305,6099,2001,t2,cantonales
65,6,ALPES MARITIMES,2499,1947,47,1900,2001,t2,cantonales
66,6,ALPES MARITIMES,17210,9942,333,9609,2001,t2,cantonales
67,6,ALPES MARITIMES,17709,9196,617,8579,2001,t2,cantonales
68,6,ALPES MARITIMES,19158,10327,786,9541,2001,t2,cantonales
69,6,ALPES MARITIMES,16687,8511,335,8176,2001,t2,cantonales
70,6,ALPES MARITIMES,23876,13761,883,12878,2001,t2,cantonales
71,6,ALPES MARITIMES,27251,13759,651,13108,2001,t2,cantonales
72,6,ALPES MARITIMES,18911,10873,1224,9649,2001,t2,cantonales
73,7,ARDECHE,12890,8605,620,7985,2001,t2,cantonales
74,7,ARDECHE,1261,1009,41,968,2001,t2,cantonales
75,7,ARDECHE,5376,3683,111,3572,2001,t2,cantonales
76,7,ARDECHE,4849,3390,118,3272,2001,t2,cantonales
77,7,ARDECHE,18176,9647,357,9290,2001,t2,cantonales
78,7,ARDECHE,7312,4323,204,4119,2001,t2,cantonales
79,7,ARDECHE,5855,4231,214,4017,2001,t2,cantonales
80,7,ARDECHE,15513,10081,618,9463,2001,t2,cantonales
81,7,ARDECHE,5905,4184,233,3951,2001,t2,cantonales
82,7,ARDECHE,6332,4563,192,4371,2001,t2,cantonales
83,7,ARDECHE,8416,5621,216,5405,2001,t2,cantonales
84,8,ARDENNES,3899,2662,129,2533,2001,t2,cantonales
85,8,ARDENNES,2339,1763,70,1693,2001,t2,cantonales
86,8,ARDENNES,1754,1457,152,1305,2001,t2,cantonales
87,8,ARDENNES,7260,4680,402,4278,2001,t2,cantonales
88,8,ARDENNES,8213,4908,183,4725,2001,t2,cantonales
89,8,ARDENNES,2123,1797,78,1719,2001,t2,cantonales
90,8,ARDENNES,2007,1562,75,1487,2001,t2,cantonales
91,8,ARDENNES,7478,4253,197,4056,2001,t2,cantonales
92,8,ARDENNES,10045,6550,187,6363,2001,t2,cantonales
93,8,ARDENNES,8621,4254,255,3999,2001,t2,cantonales
94,8,ARDENNES,8201,4565,195,4370,2001,t2,cantonales
95,8,ARDENNES,8774,4000,549,3451,2001,t2,cantonales
96,8,ARDENNES,5326,2921,149,2772,2001,t2,cantonales
97,8,ARDENNES,9822,5643,271,5372,2001,t2,cantonales
98,9,ARIEGE,5989,3481,138,3343,2001,t2,cantonales
99,9,ARIEGE,1955,1455,74,1381,2001,t2,cantonales
100,9,ARIEGE,9740,5848,397,5451,2001,t2,cantonales
101,9,ARIEGE,5606,4055,259,3796,2001,t2,cantonales
102,9,ARIEGE,6419,3380,842,2538,2001,t2,cantonales
103,9,ARIEGE,7871,4578,611,3967,2001,t2,cantonales
104,10,AUBE,3585,2354,64,2290,2001,t2,cantonales
105,10,AUBE,8506,5160,257,4903,2001,t2,cantonales
106,10,AUBE,1845,1126,527,599,2001,t2,cantonales
107,10,AUBE,3307,2467,109,2358,2001,t2,cantonales
108,10,AUBE,6164,3570,139,3431,2001,t2,cantonales
109,10,AUBE,6277,2764,683,2081,2001,t2,cantonales
110,10,AUBE,7635,3420,155,3265,2001,t2,cantonales
111,10,AUBE,10300,2926,892,2034,2001,t2,cantonales
112,10,AUBE,9603,4649,169,4480,2001,t2,cantonales
113,10,AUBE,12270,5378,195,5183,2001,t2,cantonales
114,11,AUDE,1881,1498,79,1419,2001,t2,cantonales
115,11,AUDE,9361,5653,367,5286,2001,t2,cantonales
116,11,AUDE,9567,6177,427,5750,2001,t2,cantonales
117,11,AUDE,10278,6458,335,6123,2001,t2,cantonales
118,11,AUDE,7123,3353,723,2630,2001,t2,cantonales
119,11,AUDE,9690,6173,351,5822,2001,t2,cantonales
120,11,AUDE,11677,6613,646,5967,2001,t2,cantonales
121,11,AUDE,4521,2520,1020,1500,2001,t2,cantonales
122,11,AUDE,7034,4669,328,4341,2001,t2,cantonales
123,11,AUDE,13977,8240,406,7834,2001,t2,cantonales
124,11,AUDE,7455,4689,366,4323,2001,t2,cantonales
125,11,AUDE,15341,8935,550,8385,2001,t2,cantonales
126,11,AUDE,11248,5671,310,5361,2001,t2,cantonales
127,12,AVEYRON,2238,1539,82,1457,2001,t2,cantonales
128,12,AVEYRON,6761,4719,282,4437,2001,t2,cantonales
129,12,AVEYRON,2476,1909,247,1662,2001,t2,cantonales
130,12,AVEYRON,8529,5609,266,5343,2001,t2,cantonales
131,12,AVEYRON,5741,4483,168,4315,2001,t2,cantonales
132,12,AVEYRON,6470,3814,263,3551,2001,t2,cantonales
133,12,AVEYRON,1892,1550,69,1481,2001,t2,cantonales
134,12,AVEYRON,4486,3725,143,3582,2001,t2,cantonales
135,12,AVEYRON,1959,1554,33,1521,2001,t2,cantonales
136,12,AVEYRON,747,624,13,611,2001,t2,cantonales
137,12,AVEYRON,2042,1680,74,1606,2001,t2,cantonales
138,12,AVEYRON,6810,5407,192,5215,2001,t2,cantonales
139,12,AVEYRON,3280,2710,93,2617,2001,t2,cantonales
140,12,AVEYRON,3642,2698,175,2523,2001,t2,cantonales
141,12,AVEYRON,13475,7724,363,7361,2001,t2,cantonales
142,12,AVEYRON,10712,6687,227,6460,2001,t2,cantonales
143,13,BOUCHES DU RHONE,34532,21834,935,20899,2001,t2,cantonales
144,13,BOUCHES DU RHONE,39196,22766,1066,21700,2001,t2,cantonales
145,13,BOUCHES DU RHONE,22160,14991,1540,13451,2001,t2,cantonales
146,13,BOUCHES DU RHONE,28936,13823,576,13247,2001,t2,cantonales
147,13,BOUCHES DU RHONE,21197,14790,1273,13517,2001,t2,cantonales
148,13,BOUCHES DU RHONE,4633,2702,142,2560,2001,t2,cantonales
149,13,BOUCHES DU RHONE,7354,3792,301,3491,2001,t2,cantonales
150,13,BOUCHES DU RHONE,14598,6732,625,6107,2001,t2,cantonales
151,13,BOUCHES DU RHONE,17122,7603,2636,4967,2001,t2,cantonales
152,13,BOUCHES DU RHONE,14906,9244,332,8912,2001,t2,cantonales
153,13,BOUCHES DU RHONE,27729,15947,1069,14878,2001,t2,cantonales
154,13,BOUCHES DU RHONE,25655,18364,2346,16018,2001,t2,cantonales
155,13,BOUCHES DU RHONE,23873,12060,795,11265,2001,t2,cantonales
156,13,BOUCHES DU RHONE,11319,4856,1196,3660,2001,t2,cantonales
157,13,BOUCHES DU RHONE,21444,9415,3143,6272,2001,t2,cantonales
158,13,BOUCHES DU RHONE,23846,12534,920,11614,2001,t2,cantonales
159,13,BOUCHES DU RHONE,27912,15009,1131,13878,2001,t2,cantonales
160,13,BOUCHES DU RHONE,23734,11173,628,10545,2001,t2,cantonales
161,13,BOUCHES DU RHONE,30733,16669,878,15791,2001,t2,cantonales
162,13,BOUCHES DU RHONE,20525,12687,761,11926,2001,t2,cantonales
163,13,BOUCHES DU RHONE,34087,23167,2689,20478,2001,t2,cantonales
164,14,CALVADOS,5072,2676,525,2151,2001,t2,cantonales
165,14,CALVADOS,14728,8144,540,7604,2001,t2,cantonales
166,14,CALVADOS,16111,8968,328,8640,2001,t2,cantonales
167,14,CALVADOS,7331,4725,224,4501,2001,t2,cantonales
168,14,CALVADOS,3486,2464,199,2265,2001,t2,cantonales
169,14,CALVADOS,6569,3956,135,3821,2001,t2,cantonales
170,14,CALVADOS,8369,4379,275,4104,2001,t2,cantonales
171,14,CALVADOS,5557,3482,137,3345,2001,t2,cantonales
172,14,CALVADOS,5557,3998,264,3734,2001,t2,cantonales
173,14,CALVADOS,6683,4149,243,3906,2001,t2,cantonales
174,14,CALVADOS,10414,6626,378,6248,2001,t2,cantonales
175,14,CALVADOS,6908,4196,269,3927,2001,t2,cantonales
176,14,CALVADOS,8530,4730,207,4523,2001,t2,cantonales
177,14,CALVADOS,11388,5693,348,5345,2001,t2,cantonales
178,14,CALVADOS,8795,4497,150,4347,2001,t2,cantonales
179,15,CANTAL,3306,2771,30,2741,2001,t2,cantonales
180,15,CANTAL,2794,2314,199,2115,2001,t2,cantonales
181,15,CANTAL,6727,4663,134,4529,2001,t2,cantonales
182,15,CANTAL,7643,5311,394,4917,2001,t2,cantonales
183,16,CHARENTE,7378,4623,171,4452,2001,t2,cantonales
184,16,CHARENTE,6201,3810,95,3715,2001,t2,cantonales
185,16,CHARENTE,1944,1347,61,1286,2001,t2,cantonales
186,16,CHARENTE,3848,2701,109,2592,2001,t2,cantonales
187,16,CHARENTE,13125,8316,518,7798,2001,t2,cantonales
188,16,CHARENTE,5610,4058,136,3922,2001,t2,cantonales
189,16,CHARENTE,4592,3460,162,3298,2001,t2,cantonales
190,16,CHARENTE,17110,8504,370,8134,2001,t2,cantonales
191,16,CHARENTE,13653,6452,534,5918,2001,t2,cantonales
192,16,CHARENTE,9372,5010,229,4781,2001,t2,cantonales
193,16,CHARENTE,12238,6419,369,6050,2001,t2,cantonales
194,16,CHARENTE,14071,7329,376,6953,2001,t2,cantonales
195,17,CHARENTE MARITIME,6961,4802,110,4692,2001,t2,cantonales
196,17,CHARENTE MARITIME,6670,4248,163,4085,2001,t2,cantonales
197,17,CHARENTE MARITIME,8202,4975,180,4795,2001,t2,cantonales
198,17,CHARENTE MARITIME,13605,6212,275,5937,2001,t2,cantonales
199,17,CHARENTE MARITIME,7382,4372,299,4073,2001,t2,cantonales
200,17,CHARENTE MARITIME,5920,3870,186,3684,2001,t2,cantonales
201,17,CHARENTE MARITIME,8435,4946,156,4790,2001,t2,cantonales
202,17,CHARENTE MARITIME,3421,2364,119,2245,2001,t2,cantonales
203,17,CHARENTE MARITIME,4981,3413,110,3303,2001,t2,cantonales
204,17,CHARENTE MARITIME,11454,6587,375,6212,2001,t2,cantonales
205,17,CHARENTE MARITIME,8490,5118,162,4956,2001,t2,cantonales
206,17,CHARENTE MARITIME,12754,6844,313,6531,2001,t2,cantonales
207,17,CHARENTE MARITIME,7158,4189,155,4034,2001,t2,cantonales
208,17,CHARENTE MARITIME,6244,2126,100,2026,2001,t2,cantonales
209,17,CHARENTE MARITIME,12054,5941,182,5759,2001,t2,cantonales
210,17,CHARENTE MARITIME,9914,6244,264,5980,2001,t2,cantonales
211,18,CHER,5529,3615,118,3497,2001,t2,cantonales
212,18,CHER,6678,2731,85,2646,2001,t2,cantonales
213,18,CHER,6653,3995,348,3647,2001,t2,cantonales
214,18,CHER,9116,5601,215,5386,2001,t2,cantonales
215,18,CHER,5954,3698,147,3551,2001,t2,cantonales
216,18,CHER,7820,4735,313,4422,2001,t2,cantonales
217,18,CHER,7892,3775,185,3590,2001,t2,cantonales
218,18,CHER,14060,7114,246,6868,2001,t2,cantonales
219,19,CORREZE,2861,2402,60,2342,2001,t2,cantonales
220,19,CORREZE,7372,4940,401,4539,2001,t2,cantonales
221,19,CORREZE,5189,4034,112,3922,2001,t2,cantonales
222,19,CORREZE,3875,2824,213,2611,2001,t2,cantonales
223,19,CORREZE,4167,3372,116,3256,2001,t2,cantonales
224,19,CORREZE,5697,4330,363,3967,2001,t2,cantonales
225,19,CORREZE,1981,1635,58,1577,2001,t2,cantonales
226,19,CORREZE,5793,3551,119,3432,2001,t2,cantonales
227,19,CORREZE,3038,2727,148,2579,2001,t2,cantonales
228,19,CORREZE,8693,5785,369,5416,2001,t2,cantonales
229,19,CORREZE,7753,5450,374,5076,2001,t2,cantonales
230,19,CORREZE,6231,4673,232,4441,2001,t2,cantonales
231,19,CORREZE,7252,5846,287,5559,2001,t2,cantonales
232,2A,CORSE SUD,6540,4453,203,4250,2001,t2,cantonales
233,2A,CORSE SUD,2270,1758,27,1731,2001,t2,cantonales
234,2A,CORSE SUD,2888,2462,117,2345,2001,t2,cantonales
235,2A,CORSE SUD,2147,1639,159,1480,2001,t2,cantonales
236,2A,CORSE SUD,8124,5991,467,5524,2001,t2,cantonales
237,2B,HAUTE CORSE,4684,3422,316,3106,2001,t2,cantonales
238,2B,HAUTE CORSE,2825,2485,26,2459,2001,t2,cantonales
239,2B,HAUTE CORSE,3394,2564,51,2513,2001,t2,cantonales
240,2B,HAUTE CORSE,1685,1495,8,1487,2001,t2,cantonales
241,2B,HAUTE CORSE,1701,1243,35,1208,2001,t2,cantonales
242,2B,HAUTE CORSE,4384,3073,369,2704,2001,t2,cantonales
243,21,COTE D'OR,1368,1056,60,996,2001,t2,cantonales
244,21,COTE D'OR,13600,7252,416,6836,2001,t2,cantonales
245,21,COTE D'OR,8189,5789,177,5612,2001,t2,cantonales
246,21,COTE D'OR,16121,8563,262,8301,2001,t2,cantonales
247,21,COTE D'OR,21528,10948,402,10546,2001,t2,cantonales
248,21,COTE D'OR,10270,6131,245,5886,2001,t2,cantonales
249,21,COTE D'OR,2112,1446,92,1354,2001,t2,cantonales
250,21,COTE D'OR,13558,7628,507,7121,2001,t2,cantonales
251,21,COTE D'OR,2864,2122,134,1988,2001,t2,cantonales
252,21,COTE D'OR,4889,2602,809,1793,2001,t2,cantonales
253,21,COTE D'OR,4692,3170,125,3045,2001,t2,cantonales
254,21,COTE D'OR,6831,5477,227,5250,2001,t2,cantonales
255,21,COTE D'OR,6232,3637,151,3486,2001,t2,cantonales
256,21,COTE D'OR,5909,4188,169,4019,2001,t2,cantonales
257,21,COTE D'OR,16766,7253,297,6956,2001,t2,cantonales
258,21,COTE D'OR,10910,6648,238,6410,2001,t2,cantonales
259,21,COTE D'OR,8308,4642,127,4515,2001,t2,cantonales
260,22,COTES D'ARMOR,6243,4842,243,4599,2001,t2,cantonales
261,22,COTES D'ARMOR,4462,3728,159,3569,2001,t2,cantonales
262,22,COTES D'ARMOR,5377,4434,182,4252,2001,t2,cantonales
263,22,COTES D'ARMOR,3364,2725,103,2622,2001,t2,cantonales
264,22,COTES D'ARMOR,11369,7125,326,6799,2001,t2,cantonales
265,22,COTES D'ARMOR,2977,2418,86,2332,2001,t2,cantonales
266,22,COTES D'ARMOR,15884,10186,979,9207,2001,t2,cantonales
267,22,COTES D'ARMOR,14040,9479,246,9233,2001,t2,cantonales
268,22,COTES D'ARMOR,18405,8943,639,8304,2001,t2,cantonales
269,22,COTES D'ARMOR,7062,5543,171,5372,2001,t2,cantonales
270,22,COTES D'ARMOR,5952,4816,141,4675,2001,t2,cantonales
271,22,COTES D'ARMOR,10030,6662,213,6449,2001,t2,cantonales
272,22,COTES D'ARMOR,6619,4978,245,4733,2001,t2,cantonales
273,22,COTES D'ARMOR,7740,6134,248,5886,2001,t2,cantonales
274,22,COTES D'ARMOR,6453,5121,203,4918,2001,t2,cantonales
275,22,COTES D'ARMOR,9567,5426,304,5122,2001,t2,cantonales
276,22,COTES D'ARMOR,10112,5812,413,5399,2001,t2,cantonales
277,22,COTES D'ARMOR,9463,6881,436,6445,2001,t2,cantonales
278,22,COTES D'ARMOR,15586,7949,2011,5938,2001,t2,cantonales
279,23,CREUSE,4641,3192,99,3093,2001,t2,cantonales
280,23,CREUSE,1613,1307,62,1245,2001,t2,cantonales
281,23,CREUSE,3157,2386,77,2309,2001,t2,cantonales
282,23,CREUSE,6065,4295,198,4097,2001,t2,cantonales
283,23,CREUSE,2631,2091,56,2035,2001,t2,cantonales
284,23,CREUSE,6204,4197,192,4005,2001,t2,cantonales
285,23,CREUSE,2755,1938,117,1821,2001,t2,cantonales
286,23,CREUSE,2560,2071,72,1999,2001,t2,cantonales
287,23,CREUSE,8578,5705,234,5471,2001,t2,cantonales
288,24,DORDOGNE,3876,2987,151,2836,2001,t2,cantonales
289,24,DORDOGNE,2545,1934,104,1830,2001,t2,cantonales
290,24,DORDOGNE,3250,2584,117,2467,2001,t2,cantonales
291,24,DORDOGNE,3339,2324,207,2117,2001,t2,cantonales
292,24,DORDOGNE,2806,2189,173,2016,2001,t2,cantonales
293,24,DORDOGNE,5583,4702,143,4559,2001,t2,cantonales
294,24,DORDOGNE,10976,5730,222,5508,2001,t2,cantonales
295,24,DORDOGNE,13043,8417,657,7760,2001,t2,cantonales
296,24,DORDOGNE,5379,3833,178,3655,2001,t2,cantonales
297,24,DORDOGNE,5534,4011,142,3869,2001,t2,cantonales
298,24,DORDOGNE,4061,3315,106,3209,2001,t2,cantonales
299,24,DORDOGNE,10274,7126,251,6875,2001,t2,cantonales
300,24,DORDOGNE,5976,4832,203,4629,2001,t2,cantonales
301,24,DORDOGNE,7439,5376,379,4997,2001,t2,cantonales
302,25,DOUBS,17468,10508,639,9869,2001,t2,cantonales
303,25,DOUBS,11624,5215,293,4922,2001,t2,cantonales
304,25,DOUBS,6376,4894,365,4529,2001,t2,cantonales
305,25,DOUBS,13012,7360,470,6890,2001,t2,cantonales
306,25,DOUBS,12930,7786,451,7335,2001,t2,cantonales
307,25,DOUBS,11450,7125,445,6680,2001,t2,cantonales
308,25,DOUBS,8235,5893,176,5717,2001,t2,cantonales
309,25,DOUBS,5870,4579,316,4263,2001,t2,cantonales
310,25,DOUBS,13431,8218,371,7847,2001,t2,cantonales
311,25,DOUBS,14977,8180,1798,6382,2001,t2,cantonales
312,25,DOUBS,8359,4616,269,4347,2001,t2,cantonales
313,25,DOUBS,8638,4060,1083,2977,2001,t2,cantonales
314,25,DOUBS,13423,7951,505,7446,2001,t2,cantonales
315,26,DROME,1056,830,50,780,2001,t2,cantonales
316,26,DROME,1651,1328,78,1250,2001,t2,cantonales
317,26,DROME,11030,6869,203,6666,2001,t2,cantonales
318,26,DROME,5736,3503,202,3301,2001,t2,cantonales
319,26,DROME,11086,6671,369,6302,2001,t2,cantonales
320,26,DROME,8157,5409,247,5162,2001,t2,cantonales
321,26,DROME,18086,10668,726,9942,2001,t2,cantonales
322,26,DROME,1603,1209,61,1148,2001,t2,cantonales
323,26,DROME,11918,7290,307,6983,2001,t2,cantonales
324,26,DROME,16407,9479,402,9077,2001,t2,cantonales
325,26,DROME,1902,1446,56,1390,2001,t2,cantonales
326,26,DROME,10307,4276,94,4182,2001,t2,cantonales
327,26,DROME,9373,3912,105,3807,2001,t2,cantonales
328,26,DROME,13912,8656,763,7893,2001,t2,cantonales
329,26,DROME,11468,6624,357,6267,2001,t2,cantonales
330,27,EURE,7716,5226,228,4998,2001,t2,cantonales
331,27,EURE,4768,3150,240,2910,2001,t2,cantonales
332,27,EURE,10434,6062,235,5827,2001,t2,cantonales
333,27,EURE,10553,4908,1490,3418,2001,t2,cantonales
334,27,EURE,11946,6188,301,5887,2001,t2,cantonales
335,27,EURE,5775,3632,137,3495,2001,t2,cantonales
336,27,EURE,3303,2215,94,2121,2001,t2,cantonales
337,27,EURE,8127,4456,602,3854,2001,t2,cantonales
338,27,EURE,11049,5993,414,5579,2001,t2,cantonales
339,27,EURE,11738,7123,350,6773,2001,t2,cantonales
340,27,EURE,11043,5183,300,4883,2001,t2,cantonales
341,27,EURE,10505,6287,190,6097,2001,t2,cantonales
342,27,EURE,9556,4719,251,4468,2001,t2,cantonales
343,27,EURE,10781,4633,245,4388,2001,t2,cantonales
344,28,EURE ET LOIR,9782,5592,354,5238,2001,t2,cantonales
345,28,EURE ET LOIR,9140,4713,245,4468,2001,t2,cantonales
346,28,EURE ET LOIR,11235,4843,217,4626,2001,t2,cantonales
347,28,EURE ET LOIR,7084,4305,150,4155,2001,t2,cantonales
348,28,EURE ET LOIR,10986,5504,246,5258,2001,t2,cantonales
349,28,EURE ET LOIR,6539,4520,287,4233,2001,t2,cantonales
350,28,EURE ET LOIR,13789,7399,476,6923,2001,t2,cantonales
351,28,EURE ET LOIR,8252,3057,256,2801,2001,t2,cantonales
352,28,EURE ET LOIR,12938,6904,558,6346,2001,t2,cantonales
353,29,FINISTERE,10748,6058,215,5843,2001,t2,cantonales
354,29,FINISTERE,6959,5122,226,4896,2001,t2,cantonales
355,29,FINISTERE,13448,9339,394,8945,2001,t2,cantonales
356,29,FINISTERE,10373,7785,219,7566,2001,t2,cantonales
357,29,FINISTERE,19018,12297,496,11801,2001,t2,cantonales
358,29,FINISTERE,4927,3570,86,3484,2001,t2,cantonales
359,29,FINISTERE,17991,11682,518,11164,2001,t2,cantonales
360,29,FINISTERE,12113,7919,391,7528,2001,t2,cantonales
361,29,FINISTERE,18067,10974,643,10331,2001,t2,cantonales
362,29,FINISTERE,8137,5992,158,5834,2001,t2,cantonales
363,29,FINISTERE,13417,8759,404,8355,2001,t2,cantonales
364,29,FINISTERE,16592,11376,410,10966,2001,t2,cantonales
365,29,FINISTERE,21876,12571,582,11989,2001,t2,cantonales
366,29,FINISTERE,6529,4947,158,4789,2001,t2,cantonales
367,29,FINISTERE,7682,5489,148,5341,2001,t2,cantonales
368,29,FINISTERE,8070,4147,189,3958,2001,t2,cantonales
369,29,FINISTERE,19201,12444,438,12006,2001,t2,cantonales
370,29,FINISTERE,16225,10069,409,9660,2001,t2,cantonales
371,30,GARD,7816,4326,337,3989,2001,t2,cantonales
372,30,GARD,9737,7091,543,6548,2001,t2,cantonales
373,30,GARD,22898,14424,573,13851,2001,t2,cantonales
374,30,GARD,16304,11667,343,11324,2001,t2,cantonales
375,30,GARD,8391,5880,441,5439,2001,t2,cantonales
376,30,GARD,2399,1806,63,1743,2001,t2,cantonales
377,30,GARD,3023,2239,92,2147,2001,t2,cantonales
378,30,GARD,17883,10650,561,10089,2001,t2,cantonales
379,30,GARD,18886,12618,549,12069,2001,t2,cantonales
380,30,GARD,17235,10987,392,10595,2001,t2,cantonales
381,30,GARD,3787,2819,189,2630,2001,t2,cantonales
382,30,GARD,5816,3996,229,3767,2001,t2,cantonales
383,30,GARD,10201,6700,288,6412,2001,t2,cantonales
384,30,GARD,9469,6595,1044,5551,2001,t2,cantonales
385,30,GARD,2428,1919,138,1781,2001,t2,cantonales
386,30,GARD,21699,12599,484,12115,2001,t2,cantonales
387,30,GARD,18766,9676,372,9304,2001,t2,cantonales
388,30,GARD,9509,5552,277,5275,2001,t2,cantonales
389,30,GARD,14574,7773,350,7423,2001,t2,cantonales
390,30,GARD,13803,8342,335,8007,2001,t2,cantonales
391,31,HAUTE GARONNE,4515,3440,82,3358,2001,t2,cantonales
392,31,HAUTE GARONNE,11469,7130,254,6876,2001,t2,cantonales
393,31,HAUTE GARONNE,16370,9816,546,9270,2001,t2,cantonales
394,31,HAUTE GARONNE,25658,12871,700,12171,2001,t2,cantonales
395,31,HAUTE GARONNE,14801,7705,1152,6553,2001,t2,cantonales
396,31,HAUTE GARONNE,6124,4512,229,4283,2001,t2,cantonales
397,31,HAUTE GARONNE,13648,8887,564,8323,2001,t2,cantonales
398,31,HAUTE GARONNE,6234,4759,205,4554,2001,t2,cantonales
399,31,HAUTE GARONNE,12593,7932,281,7651,2001,t2,cantonales
400,31,HAUTE GARONNE,11477,7372,321,7051,2001,t2,cantonales
401,31,HAUTE GARONNE,32400,19889,968,18921,2001,t2,cantonales
402,31,HAUTE GARONNE,26629,16023,641,15382,2001,t2,cantonales
403,31,HAUTE GARONNE,15635,9657,452,9205,2001,t2,cantonales
404,31,HAUTE GARONNE,14957,9350,361,8989,2001,t2,cantonales
405,31,HAUTE GARONNE,35696,20032,1233,18799,2001,t2,cantonales
406,31,HAUTE GARONNE,23657,10740,789,9951,2001,t2,cantonales
407,32,GERS,6726,4121,210,3911,2001,t2,cantonales
408,32,GERS,7855,5695,258,5437,2001,t2,cantonales
409,32,GERS,5004,3625,161,3464,2001,t2,cantonales
410,32,GERS,4937,3072,191,2881,2001,t2,cantonales
411,32,GERS,3201,2588,98,2490,2001,t2,cantonales
412,32,GERS,2469,2124,62,2062,2001,t2,cantonales
413,32,GERS,6143,4347,228,4119,2001,t2,cantonales
414,32,GERS,4743,3661,81,3580,2001,t2,cantonales
415,33,GIRONDE,32636,15267,825,14442,2001,t2,cantonales
416,33,GIRONDE,9470,5462,492,4970,2001,t2,cantonales
417,33,GIRONDE,10540,4550,215,4335,2001,t2,cantonales
418,33,GIRONDE,15288,6129,227,5902,2001,t2,cantonales
419,33,GIRONDE,10057,4330,128,4202,2001,t2,cantonales
420,33,GIRONDE,6512,2974,168,2806,2001,t2,cantonales
421,33,GIRONDE,27048,13416,972,12444,2001,t2,cantonales
422,33,GIRONDE,2143,1839,66,1773,2001,t2,cantonales
423,33,GIRONDE,10708,7015,594,6421,2001,t2,cantonales
424,33,GIRONDE,11454,7538,229,7309,2001,t2,cantonales
425,33,GIRONDE,9211,5936,360,5576,2001,t2,cantonales
426,33,GIRONDE,11733,6013,453,5560,2001,t2,cantonales
427,33,GIRONDE,8508,5773,236,5537,2001,t2,cantonales
428,33,GIRONDE,12031,6537,277,6260,2001,t2,cantonales
429,33,GIRONDE,7013,4555,182,4373,2001,t2,cantonales
430,33,GIRONDE,30630,18318,814,17504,2001,t2,cantonales
431,33,GIRONDE,20989,8145,373,7772,2001,t2,cantonales
432,33,GIRONDE,17213,9119,350,8769,2001,t2,cantonales
433,33,GIRONDE,30032,16376,789,15587,2001,t2,cantonales
434,33,GIRONDE,17992,6800,346,6454,2001,t2,cantonales
435,33,GIRONDE,31592,16183,712,15471,2001,t2,cantonales
436,34,HERAULT,27142,18398,1385,17013,2001,t2,cantonales
437,34,HERAULT,5540,4164,173,3991,2001,t2,cantonales
438,34,HERAULT,7381,3479,722,2757,2001,t2,cantonales
439,34,HERAULT,13457,5403,286,5117,2001,t2,cantonales
440,34,HERAULT,22120,11220,525,10695,2001,t2,cantonales
441,34,HERAULT,27988,17973,1795,16178,2001,t2,cantonales
442,34,HERAULT,8042,5850,303,5547,2001,t2,cantonales
443,34,HERAULT,17177,10791,481,10310,2001,t2,cantonales
444,34,HERAULT,6761,4473,186,4287,2001,t2,cantonales
445,34,HERAULT,11441,5473,457,5016,2001,t2,cantonales
446,34,HERAULT,13011,6959,360,6599,2001,t2,cantonales
447,34,HERAULT,4173,3011,179,2832,2001,t2,cantonales
448,34,HERAULT,5179,3568,161,3407,2001,t2,cantonales
449,34,HERAULT,15221,10616,574,10042,2001,t2,cantonales
450,34,HERAULT,12475,7059,527,6532,2001,t2,cantonales
451,34,HERAULT,10866,6327,703,5624,2001,t2,cantonales
452,34,HERAULT,19542,11946,507,11439,2001,t2,cantonales
453,35,ILLE ET VILAINE,6549,4976,213,4763,2001,t2,cantonales
454,35,ILLE ET VILAINE,15798,9163,250,8913,2001,t2,cantonales
455,35,ILLE ET VILAINE,17899,10625,486,10139,2001,t2,cantonales
456,35,ILLE ET VILAINE,9198,6145,294,5851,2001,t2,cantonales
457,35,ILLE ET VILAINE,16834,9511,562,8949,2001,t2,cantonales
458,35,ILLE ET VILAINE,15377,7831,240,7591,2001,t2,cantonales
459,35,ILLE ET VILAINE,8827,5191,269,4922,2001,t2,cantonales
460,35,ILLE ET VILAINE,5252,3536,203,3333,2001,t2,cantonales
461,35,ILLE ET VILAINE,17091,8967,389,8578,2001,t2,cantonales
462,35,ILLE ET VILAINE,17509,10634,370,10264,2001,t2,cantonales
463,35,ILLE ET VILAINE,12456,8032,339,7693,2001,t2,cantonales
464,35,ILLE ET VILAINE,15597,8325,250,8075,2001,t2,cantonales
465,35,ILLE ET VILAINE,6044,4728,258,4470,2001,t2,cantonales
466,35,ILLE ET VILAINE,6622,4742,256,4486,2001,t2,cantonales
467,35,ILLE ET VILAINE,10621,5516,189,5327,2001,t2,cantonales
468,35,ILLE ET VILAINE,9809,5154,227,4927,2001,t2,cantonales
469,35,ILLE ET VILAINE,16626,8785,414,8371,2001,t2,cantonales
470,35,ILLE ET VILAINE,9228,4317,226,4091,2001,t2,cantonales
471,35,ILLE ET VILAINE,16254,8055,238,7817,2001,t2,cantonales
472,36,INDRE,11857,7335,505,6830,2001,t2,cantonales
473,36,INDRE,2910,1915,135,1780,2001,t2,cantonales
474,36,INDRE,9055,6051,181,5870,2001,t2,cantonales
475,36,INDRE,12202,7858,334,7524,2001,t2,cantonales
476,36,INDRE,5245,3839,219,3620,2001,t2,cantonales
477,36,INDRE,4905,3318,93,3225,2001,t2,cantonales
478,36,INDRE,7536,4410,377,4033,2001,t2,cantonales
479,37,INDRE ET LOIRE ,10036,5958,329,5629,2001,t2,cantonales
480,37,INDRE ET LOIRE ,14393,7505,595,6910,2001,t2,cantonales
481,37,INDRE ET LOIRE ,13331,7561,309,7252,2001,t2,cantonales
482,37,INDRE ET LOIRE ,8154,4900,271,4629,2001,t2,cantonales
483,37,INDRE ET LOIRE ,8043,5091,181,4910,2001,t2,cantonales
484,37,INDRE ET LOIRE ,11427,5889,168,5721,2001,t2,cantonales
485,37,INDRE ET LOIRE ,17314,9525,448,9077,2001,t2,cantonales
486,37,INDRE ET LOIRE ,10887,5780,171,5609,2001,t2,cantonales
487,37,INDRE ET LOIRE ,12296,6752,343,6409,2001,t2,cantonales
488,37,INDRE ET LOIRE ,11734,5349,171,5178,2001,t2,cantonales
489,37,INDRE ET LOIRE ,14078,7420,288,7132,2001,t2,cantonales
490,37,INDRE ET LOIRE ,10547,6352,236,6116,2001,t2,cantonales
491,37,INDRE ET LOIRE ,13310,7684,318,7366,2001,t2,cantonales
492,38,ISERE,4570,2671,78,2593,2001,t2,cantonales
493,38,ISERE,8795,5563,199,5364,2001,t2,cantonales
494,38,ISERE,12765,6381,200,6181,2001,t2,cantonales
495,38,ISERE,13012,7309,236,7073,2001,t2,cantonales
496,38,ISERE,12835,6855,276,6579,2001,t2,cantonales
497,38,ISERE,18451,9808,297,9511,2001,t2,cantonales
498,38,ISERE,4352,3046,109,2937,2001,t2,cantonales
499,38,ISERE,7544,4620,135,4485,2001,t2,cantonales
500,38,ISERE,16260,8633,361,8272,2001,t2,cantonales
501,38,ISERE,15753,8814,255,8559,2001,t2,cantonales
502,38,ISERE,21908,10822,478,10344,2001,t2,cantonales
503,38,ISERE,21073,12072,540,11532,2001,t2,cantonales
504,38,ISERE,19394,10675,739,9936,2001,t2,cantonales
505,38,ISERE,9918,5368,190,5178,2001,t2,cantonales
506,38,ISERE,14175,7462,353,7109,2001,t2,cantonales
507,38,ISERE,19729,13192,451,12741,2001,t2,cantonales
508,38,ISERE,14621,8025,434,7591,2001,t2,cantonales
509,38,ISERE,10286,4356,190,4166,2001,t2,cantonales
510,38,ISERE,12025,5177,461,4716,2001,t2,cantonales
511,38,ISERE,18079,8393,202,8191,2001,t2,cantonales
512,38,ISERE,14523,7860,615,7245,2001,t2,cantonales
513,38,ISERE,5962,2951,823,2128,2001,t2,cantonales
514,38,ISERE,13098,6585,190,6395,2001,t2,cantonales
515,39,JURA,12469,8000,625,7375,2001,t2,cantonales
516,39,JURA,4707,3408,157,3251,2001,t2,cantonales
517,39,JURA,6899,4426,225,4201,2001,t2,cantonales
518,39,JURA,4408,3070,81,2989,2001,t2,cantonales
519,39,JURA,13480,8388,318,8070,2001,t2,cantonales
520,39,JURA,3961,2727,184,2543,2001,t2,cantonales
521,39,JURA,4486,3035,156,2879,2001,t2,cantonales
522,39,JURA,4842,3178,92,3086,2001,t2,cantonales
523,39,JURA,11503,5822,219,5603,2001,t2,cantonales
524,39,JURA,10187,5059,250,4809,2001,t2,cantonales
525,40,LANDES,15181,10433,438,9995,2001,t2,cantonales
526,40,LANDES,7636,4581,303,4278,2001,t2,cantonales
527,40,LANDES,4309,2805,166,2639,2001,t2,cantonales
528,40,LANDES,15595,8450,440,8010,2001,t2,cantonales
529,40,LANDES,7185,5594,169,5425,2001,t2,cantonales
530,40,LANDES,17152,10832,683,10149,2001,t2,cantonales
531,40,LANDES,20578,12513,548,11965,2001,t2,cantonales
532,41,LOIR ET CHER,13012,7151,585,6566,2001,t2,cantonales
533,41,LOIR ET CHER,10903,6891,506,6385,2001,t2,cantonales
534,41,LOIR ET CHER,5266,3246,82,3164,2001,t2,cantonales
535,41,LOIR ET CHER,13314,8855,378,8477,2001,t2,cantonales
536,41,LOIR ET CHER,3558,2395,172,2223,2001,t2,cantonales
537,41,LOIR ET CHER,9100,5476,190,5286,2001,t2,cantonales
538,41,LOIR ET CHER,7998,4768,220,4548,2001,t2,cantonales
539,41,LOIR ET CHER,6873,4395,226,4169,2001,t2,cantonales
540,42,LOIRE,8690,5611,250,5361,2001,t2,cantonales
541,42,LOIRE,13759,7281,294,6987,2001,t2,cantonales
542,42,LOIRE,10653,6404,242,6162,2001,t2,cantonales
543,42,LOIRE,22476,11980,674,11306,2001,t2,cantonales
544,42,LOIRE,3560,2685,86,2599,2001,t2,cantonales
545,42,LOIRE,9570,5722,158,5564,2001,t2,cantonales
546,42,LOIRE,18053,9606,623,8983,2001,t2,cantonales
547,42,LOIRE,15396,7603,442,7161,2001,t2,cantonales
548,42,LOIRE,20218,10438,462,9976,2001,t2,cantonales
549,42,LOIRE,4475,2878,172,2706,2001,t2,cantonales
550,42,LOIRE,4609,3077,115,2962,2001,t2,cantonales
551,42,LOIRE,23552,11625,612,11013,2001,t2,cantonales
552,42,LOIRE,14570,6297,632,5665,2001,t2,cantonales
553,42,LOIRE,24642,13171,635,12536,2001,t2,cantonales
554,42,LOIRE,16014,8912,375,8537,2001,t2,cantonales
555,42,LOIRE,13148,7031,297,6734,2001,t2,cantonales
556,43,HAUTE LOIRE,2683,2073,139,1934,2001,t2,cantonales
557,43,HAUTE LOIRE,2026,1722,127,1595,2001,t2,cantonales
558,43,HAUTE LOIRE,3767,2741,174,2567,2001,t2,cantonales
559,43,HAUTE LOIRE,6250,3267,783,2484,2001,t2,cantonales
560,43,HAUTE LOIRE,3724,2806,129,2677,2001,t2,cantonales
561,43,HAUTE LOIRE,3487,2546,153,2393,2001,t2,cantonales
562,43,HAUTE LOIRE,1114,892,28,864,2001,t2,cantonales
563,43,HAUTE LOIRE,8050,4887,150,4737,2001,t2,cantonales
564,43,HAUTE LOIRE,2355,1787,78,1709,2001,t2,cantonales
565,43,HAUTE LOIRE,9661,5796,363,5433,2001,t2,cantonales
566,43,HAUTE LOIRE,4213,3422,71,3351,2001,t2,cantonales
567,43,HAUTE LOIRE,3548,2106,126,1980,2001,t2,cantonales
568,43,HAUTE LOIRE,5310,2845,91,2754,2001,t2,cantonales
569,43,HAUTE LOIRE,4893,3238,293,2945,2001,t2,cantonales
570,44,LOIRE ATLANTIQUE,28018,14571,439,14132,2001,t2,cantonales
571,44,LOIRE ATLANTIQUE,7168,4411,103,4308,2001,t2,cantonales
572,44,LOIRE ATLANTIQUE,23618,12461,580,11881,2001,t2,cantonales
573,44,LOIRE ATLANTIQUE,11781,6839,205,6634,2001,t2,cantonales
574,44,LOIRE ATLANTIQUE,19832,11708,518,11190,2001,t2,cantonales
575,44,LOIRE ATLANTIQUE,6818,4006,173,3833,2001,t2,cantonales
576,44,LOIRE ATLANTIQUE,8756,5198,363,4835,2001,t2,cantonales
577,44,LOIRE ATLANTIQUE,4721,3241,86,3155,2001,t2,cantonales
578,44,LOIRE ATLANTIQUE,20367,7796,191,7605,2001,t2,cantonales
579,44,LOIRE ATLANTIQUE,20744,7309,150,7159,2001,t2,cantonales
580,44,LOIRE ATLANTIQUE,16696,6677,154,6523,2001,t2,cantonales
581,44,LOIRE ATLANTIQUE,12790,4362,136,4226,2001,t2,cantonales
582,44,LOIRE ATLANTIQUE,8781,3809,869,2940,2001,t2,cantonales
583,44,LOIRE ATLANTIQUE,16772,10004,414,9590,2001,t2,cantonales
584,44,LOIRE ATLANTIQUE,8070,5438,73,5365,2001,t2,cantonales
585,44,LOIRE ATLANTIQUE,6815,4028,271,3757,2001,t2,cantonales
586,44,LOIRE ATLANTIQUE,15822,4101,619,3482,2001,t2,cantonales
587,44,LOIRE ATLANTIQUE,15255,5480,175,5305,2001,t2,cantonales
588,44,LOIRE ATLANTIQUE,15020,7393,482,6911,2001,t2,cantonales
589,44,LOIRE ATLANTIQUE,15106,5038,268,4770,2001,t2,cantonales
590,45,LOIRET,4687,2993,91,2902,2001,t2,cantonales
591,45,LOIRET,7191,4243,334,3909,2001,t2,cantonales
592,45,LOIRET,6246,3791,204,3587,2001,t2,cantonales
593,45,LOIRET,16130,9481,530,8951,2001,t2,cantonales
594,45,LOIRET,9452,5462,207,5255,2001,t2,cantonales
595,45,LOIRET,10290,5576,240,5336,2001,t2,cantonales
596,45,LOIRET,8539,4489,267,4222,2001,t2,cantonales
597,45,LOIRET,11162,6314,219,6095,2001,t2,cantonales
598,45,LOIRET,6277,3566,270,3296,2001,t2,cantonales
599,45,LOIRET,15294,7123,360,6763,2001,t2,cantonales
600,45,LOIRET,17825,9026,394,8632,2001,t2,cantonales
601,45,LOIRET,8892,4276,177,4099,2001,t2,cantonales
602,45,LOIRET,11614,7718,345,7373,2001,t2,cantonales
603,45,LOIRET,22342,13277,684,12593,2001,t2,cantonales
604,45,LOIRET,9030,4569,246,4323,2001,t2,cantonales
605,46,LOT,6576,5048,405,4643,2001,t2,cantonales
606,46,LOT,3096,2537,170,2367,2001,t2,cantonales
607,46,LOT,3788,2556,232,2324,2001,t2,cantonales
608,46,LOT,1774,1374,67,1307,2001,t2,cantonales
609,46,LOT,2467,2015,148,1867,2001,t2,cantonales
610,46,LOT,2677,1853,735,1118,2001,t2,cantonales
611,46,LOT,2983,2131,183,1948,2001,t2,cantonales
612,46,LOT,7286,4125,875,3250,2001,t2,cantonales
613,47,LOT ET GARONNE ,8227,5645,318,5327,2001,t2,cantonales
614,47,LOT ET GARONNE ,5795,4405,237,4168,2001,t2,cantonales
615,47,LOT ET GARONNE ,5097,3752,226,3526,2001,t2,cantonales
616,47,LOT ET GARONNE ,2625,2112,84,2028,2001,t2,cantonales
617,47,LOT ET GARONNE ,2151,1706,100,1606,2001,t2,cantonales
618,47,LOT ET GARONNE ,7201,5058,236,4822,2001,t2,cantonales
619,47,LOT ET GARONNE ,6444,4112,213,3899,2001,t2,cantonales
620,47,LOT ET GARONNE ,4385,3156,193,2963,2001,t2,cantonales
621,47,LOT ET GARONNE ,2990,2202,87,2115,2001,t2,cantonales
622,47,LOT ET GARONNE ,6993,4595,268,4327,2001,t2,cantonales
623,47,LOT ET GARONNE ,5619,3763,158,3605,2001,t2,cantonales
624,47,LOT ET GARONNE ,6043,3949,217,3732,2001,t2,cantonales
625,47,LOT ET GARONNE ,4651,3482,151,3331,2001,t2,cantonales
626,47,LOT ET GARONNE ,5011,3359,162,3197,2001,t2,cantonales
627,47,LOT ET GARONNE ,9561,6019,398,5621,2001,t2,cantonales
628,47,LOT ET GARONNE ,9727,6276,554,5722,2001,t2,cantonales
629,48,LOZERE,1730,1317,69,1248,2001,t2,cantonales
630,48,LOZERE,3037,2231,98,2133,2001,t2,cantonales
631,48,LOZERE,1684,1382,49,1333,2001,t2,cantonales
632,48,LOZERE,6251,3665,217,3448,2001,t2,cantonales
633,48,LOZERE,5019,4149,83,4066,2001,t2,cantonales
634,48,LOZERE,4246,2839,116,2723,2001,t2,cantonales
635,49,MAINE ET LOIRE ,18294,9156,621,8535,2001,t2,cantonales
636,49,MAINE ET LOIRE ,19066,10658,556,10102,2001,t2,cantonales
637,49,MAINE ET LOIRE ,7529,4698,263,4435,2001,t2,cantonales
638,49,MAINE ET LOIRE ,6069,4207,183,4024,2001,t2,cantonales
639,49,MAINE ET LOIRE ,9122,5183,213,4970,2001,t2,cantonales
640,49,MAINE ET LOIRE ,7349,4191,110,4081,2001,t2,cantonales
641,49,MAINE ET LOIRE ,9166,5601,300,5301,2001,t2,cantonales
642,49,MAINE ET LOIRE ,15288,7706,394,7312,2001,t2,cantonales
643,49,MAINE ET LOIRE ,13604,8521,416,8105,2001,t2,cantonales
644,50,MANCHE,4951,3118,289,2829,2001,t2,cantonales
645,50,MANCHE,7062,3697,126,3571,2001,t2,cantonales
646,50,MANCHE,4150,3018,133,2885,2001,t2,cantonales
647,50,MANCHE,18069,9423,391,9032,2001,t2,cantonales
648,50,MANCHE,4842,3427,136,3291,2001,t2,cantonales
649,50,MANCHE,8480,5946,308,5638,2001,t2,cantonales
650,50,MANCHE,7240,4569,275,4294,2001,t2,cantonales
651,50,MANCHE,9771,4653,188,4465,2001,t2,cantonales
652,50,MANCHE,4088,3038,118,2920,2001,t2,cantonales
653,50,MANCHE,4934,3628,114,3514,2001,t2,cantonales
654,50,MANCHE,5365,3394,240,3154,2001,t2,cantonales
655,50,MANCHE,17679,8191,453,7738,2001,t2,cantonales
656,51,MARNE,10207,5807,197,5610,2001,t2,cantonales
657,51,MARNE,6725,3833,182,3651,2001,t2,cantonales
658,51,MARNE,12773,6506,341,6165,2001,t2,cantonales
659,51,MARNE,9875,4466,299,4167,2001,t2,cantonales
660,51,MARNE,9117,5202,156,5046,2001,t2,cantonales
661,51,MARNE,11039,5282,279,5003,2001,t2,cantonales
662,51,MARNE,10383,5099,196,4903,2001,t2,cantonales
663,51,MARNE,11997,5942,275,5667,2001,t2,cantonales
664,52,HAUTE MARNE,2776,2180,126,2054,2001,t2,cantonales
665,52,HAUTE MARNE,5578,3736,219,3517,2001,t2,cantonales
666,52,HAUTE MARNE,2293,1694,132,1562,2001,t2,cantonales
667,52,HAUTE MARNE,7017,4368,217,4151,2001,t2,cantonales
668,52,HAUTE MARNE,1700,1349,53,1296,2001,t2,cantonales
669,52,HAUTE MARNE,13029,6393,390,6003,2001,t2,cantonales
670,52,HAUTE MARNE,5276,2033,100,1933,2001,t2,cantonales
671,53,MAYENNE,4042,2884,156,2728,2001,t2,cantonales
672,53,MAYENNE,2875,1982,120,1862,2001,t2,cantonales
673,53,MAYENNE,2717,1624,310,1314,2001,t2,cantonales
674,53,MAYENNE,3834,2919,113,2806,2001,t2,cantonales
675,53,MAYENNE,5178,3725,169,3556,2001,t2,cantonales
676,54,MEURTHE ET MOSELLE,7876,4500,218,4282,2001,t2,cantonales
677,54,MEURTHE ET MOSELLE,9306,5328,356,4972,2001,t2,cantonales
678,54,MEURTHE ET MOSELLE,11119,5825,291,5534,2001,t2,cantonales
679,54,MEURTHE ET MOSELLE,2729,1785,72,1713,2001,t2,cantonales
680,54,MEURTHE ET MOSELLE,10559,5207,302,4905,2001,t2,cantonales
681,54,MEURTHE ET MOSELLE,8093,3836,492,3344,2001,t2,cantonales
682,54,MEURTHE ET MOSELLE,15203,9514,319,9195,2001,t2,cantonales
683,54,MEURTHE ET MOSELLE,16041,8915,334,8581,2001,t2,cantonales
684,54,MEURTHE ET MOSELLE,17111,10358,578,9780,2001,t2,cantonales
685,54,MEURTHE ET MOSELLE,6740,4473,223,4250,2001,t2,cantonales
686,54,MEURTHE ET MOSELLE,13166,5516,254,5262,2001,t2,cantonales
687,54,MEURTHE ET MOSELLE,13075,6933,317,6616,2001,t2,cantonales
688,54,MEURTHE ET MOSELLE,19494,10102,401,9701,2001,t2,cantonales
689,54,MEURTHE ET MOSELLE,12237,5720,749,4971,2001,t2,cantonales
690,54,MEURTHE ET MOSELLE,7237,3965,206,3759,2001,t2,cantonales
691,54,MEURTHE ET MOSELLE,19835,10618,408,10210,2001,t2,cantonales
692,54,MEURTHE ET MOSELLE,13998,7358,517,6841,2001,t2,cantonales
693,54,MEURTHE ET MOSELLE,15311,7500,400,7100,2001,t2,cantonales
694,54,MEURTHE ET MOSELLE,7969,4566,185,4381,2001,t2,cantonales
695,55,MEUSE,3268,2209,137,2072,2001,t2,cantonales
696,55,MEUSE,9084,4784,404,4380,2001,t2,cantonales
697,55,MEUSE,5080,3638,97,3541,2001,t2,cantonales
698,55,MEUSE,8301,5198,351,4847,2001,t2,cantonales
699,55,MEUSE,2262,1775,102,1673,2001,t2,cantonales
700,55,MEUSE,5749,3503,184,3319,2001,t2,cantonales
701,55,MEUSE,4043,3145,445,2700,2001,t2,cantonales
702,55,MEUSE,7050,3854,208,3646,2001,t2,cantonales
703,55,MEUSE,4497,2703,176,2527,2001,t2,cantonales
704,56,MORBIHAN,9955,5218,1202,4016,2001,t2,cantonales
705,56,MORBIHAN,10161,4364,548,3816,2001,t2,cantonales
706,56,MORBIHAN,6980,5615,175,5440,2001,t2,cantonales
707,56,MORBIHAN,11291,7286,110,7176,2001,t2,cantonales
708,56,MORBIHAN,11472,7490,252,7238,2001,t2,cantonales
709,56,MORBIHAN,2561,1949,139,1810,2001,t2,cantonales
710,56,MORBIHAN,6626,5046,139,4907,2001,t2,cantonales
711,56,MORBIHAN,20377,12406,583,11823,2001,t2,cantonales
712,56,MORBIHAN,10467,5085,218,4867,2001,t2,cantonales
713,56,MORBIHAN,3900,2785,51,2734,2001,t2,cantonales
714,56,MORBIHAN,9534,6638,180,6458,2001,t2,cantonales
715,56,MORBIHAN,24804,12677,503,12174,2001,t2,cantonales
716,56,MORBIHAN,25254,16532,522,16010,2001,t2,cantonales
717,56,MORBIHAN,15289,7450,403,7047,2001,t2,cantonales
718,57,MOSELLE,22243,11353,509,10844,2001,t2,cantonales
719,57,MOSELLE,14204,5292,345,4947,2001,t2,cantonales
720,57,MOSELLE,25501,10611,3300,7311,2001,t2,cantonales
721,57,MOSELLE,22538,12559,466,12093,2001,t2,cantonales
722,57,MOSELLE,14075,7351,1670,5681,2001,t2,cantonales
723,57,MOSELLE,13118,7307,453,6854,2001,t2,cantonales
724,57,MOSELLE,12539,7919,434,7485,2001,t2,cantonales
725,57,MOSELLE,3220,2073,98,1975,2001,t2,cantonales
726,57,MOSELLE,12422,8991,344,8647,2001,t2,cantonales
727,57,MOSELLE,19234,9731,499,9232,2001,t2,cantonales
728,57,MOSELLE,7937,4829,251,4578,2001,t2,cantonales
729,57,MOSELLE,14210,5266,228,5038,2001,t2,cantonales
730,57,MOSELLE,20989,12162,1220,10942,2001,t2,cantonales
731,57,MOSELLE,10669,6030,365,5665,2001,t2,cantonales
732,57,MOSELLE,11065,5786,301,5485,2001,t2,cantonales
733,57,MOSELLE,16718,7170,597,6573,2001,t2,cantonales
734,57,MOSELLE,18429,10043,680,9363,2001,t2,cantonales
735,57,MOSELLE,13428,4095,201,3894,2001,t2,cantonales
736,58,NIEVRE,3477,2609,74,2535,2001,t2,cantonales
737,58,NIEVRE,6465,3916,196,3720,2001,t2,cantonales
738,58,NIEVRE,6859,3650,179,3471,2001,t2,cantonales
739,58,NIEVRE,6954,3786,257,3529,2001,t2,cantonales
740,58,NIEVRE,8646,4778,253,4525,2001,t2,cantonales
741,58,NIEVRE,4045,2808,134,2674,2001,t2,cantonales
742,58,NIEVRE,4721,3253,93,3160,2001,t2,cantonales
743,58,NIEVRE,12117,4744,1175,3569,2001,t2,cantonales
744,58,NIEVRE,6108,3213,139,3074,2001,t2,cantonales
745,59,NORD,11617,6576,433,6143,2001,t2,cantonales
746,59,NORD,18538,10440,540,9900,2001,t2,cantonales
747,59,NORD,13744,7901,258,7643,2001,t2,cantonales
748,59,NORD,16768,9056,607,8449,2001,t2,cantonales
749,59,NORD,30846,10199,2344,7855,2001,t2,cantonales
750,59,NORD,29952,14094,749,13345,2001,t2,cantonales
751,59,NORD,22706,12564,630,11934,2001,t2,cantonales
752,59,NORD,34725,16665,1098,15567,2001,t2,cantonales
753,59,NORD,32171,12960,919,12041,2001,t2,cantonales
754,59,NORD,10879,4921,218,4703,2001,t2,cantonales
755,59,NORD,18238,7243,323,6920,2001,t2,cantonales
756,59,NORD,43949,17676,769,16907,2001,t2,cantonales
757,59,NORD,20734,7725,2400,5325,2001,t2,cantonales
758,59,NORD,11100,8019,360,7659,2001,t2,cantonales
759,59,NORD,29209,16537,505,16032,2001,t2,cantonales
760,59,NORD,17672,11038,610,10428,2001,t2,cantonales
761,59,NORD,16554,9679,421,9258,2001,t2,cantonales
762,59,NORD,9235,6252,336,5916,2001,t2,cantonales
763,59,NORD,28346,10710,696,10014,2001,t2,cantonales
764,59,NORD,33622,12924,616,12308,2001,t2,cantonales
765,59,NORD,13811,6436,344,6092,2001,t2,cantonales
766,59,NORD,27509,11663,991,10672,2001,t2,cantonales
767,59,NORD,32148,15329,711,14618,2001,t2,cantonales
768,59,NORD,19429,11459,457,11002,2001,t2,cantonales
769,59,NORD,31311,16122,865,15257,2001,t2,cantonales
770,59,NORD,28294,14393,591,13802,2001,t2,cantonales
771,59,NORD,28058,15262,1156,14106,2001,t2,cantonales
772,59,NORD,17922,7688,354,7334,2001,t2,cantonales
773,60,OISE,10409,6376,773,5603,2001,t2,cantonales
774,60,OISE,7301,3870,265,3605,2001,t2,cantonales
775,60,OISE,7823,5658,321,5337,2001,t2,cantonales
776,60,OISE,18880,9396,720,8676,2001,t2,cantonales
777,60,OISE,17891,9186,410,8776,2001,t2,cantonales
778,60,OISE,10242,5744,380,5364,2001,t2,cantonales
779,60,OISE,10672,5477,349,5128,2001,t2,cantonales
780,60,OISE,6744,4629,194,4435,2001,t2,cantonales
781,60,OISE,23763,12327,1110,11217,2001,t2,cantonales
782,60,OISE,18070,10636,622,10014,2001,t2,cantonales
783,60,OISE,11113,6595,278,6317,2001,t2,cantonales
784,60,OISE,18461,9646,618,9028,2001,t2,cantonales
785,60,OISE,11235,6256,346,5910,2001,t2,cantonales
786,60,OISE,7735,4801,202,4599,2001,t2,cantonales
787,60,OISE,10001,5913,334,5579,2001,t2,cantonales
788,60,OISE,10620,5766,269,5497,2001,t2,cantonales
789,60,OISE,15864,7117,306,6811,2001,t2,cantonales
790,60,OISE,12373,8002,447,7555,2001,t2,cantonales
791,60,OISE,13093,6424,368,6056,2001,t2,cantonales
792,61,ORNE,7756,3750,85,3665,2001,t2,cantonales
793,61,ORNE,6293,3724,213,3511,2001,t2,cantonales
794,61,ORNE,2636,1730,74,1656,2001,t2,cantonales
795,61,ORNE,2144,1555,74,1481,2001,t2,cantonales
796,61,ORNE,4620,3190,242,2948,2001,t2,cantonales
797,61,ORNE,5984,3074,268,2806,2001,t2,cantonales
798,61,ORNE,5312,3788,73,3715,2001,t2,cantonales
799,62,PAS DE CALAIS,17952,12218,575,11643,2001,t2,cantonales
800,62,PAS DE CALAIS,6309,4370,286,4084,2001,t2,cantonales
801,62,PAS DE CALAIS,16957,9497,617,8880,2001,t2,cantonales
802,62,PAS DE CALAIS,12370,5809,512,5297,2001,t2,cantonales
803,62,PAS DE CALAIS,8221,6342,342,6000,2001,t2,cantonales
804,62,PAS DE CALAIS,5464,4837,174,4663,2001,t2,cantonales
805,62,PAS DE CALAIS,8895,6248,306,5942,2001,t2,cantonales
806,62,PAS DE CALAIS,5375,4669,155,4514,2001,t2,cantonales
807,62,PAS DE CALAIS,12729,7614,377,7237,2001,t2,cantonales
808,62,PAS DE CALAIS,14944,4034,920,3114,2001,t2,cantonales
809,62,PAS DE CALAIS,14876,4804,825,3979,2001,t2,cantonales
810,62,PAS DE CALAIS,8494,5543,170,5373,2001,t2,cantonales
811,62,PAS DE CALAIS,18391,10896,611,10285,2001,t2,cantonales
812,62,PAS DE CALAIS,5692,4573,370,4203,2001,t2,cantonales
813,62,PAS DE CALAIS,11846,7099,236,6863,2001,t2,cantonales
814,62,PAS DE CALAIS,20319,11892,506,11386,2001,t2,cantonales
815,62,PAS DE CALAIS,15106,8821,1641,7180,2001,t2,cantonales
816,62,PAS DE CALAIS,15598,8034,473,7561,2001,t2,cantonales
817,62,PAS DE CALAIS,18383,10025,674,9351,2001,t2,cantonales
818,62,PAS DE CALAIS,12598,4231,798,3433,2001,t2,cantonales
819,62,PAS DE CALAIS,15474,7841,1713,6128,2001,t2,cantonales
820,62,PAS DE CALAIS,15091,7130,572,6558,2001,t2,cantonales
821,63,PUY DE DOME,3282,2473,66,2407,2001,t2,cantonales
822,63,PUY DE DOME,6963,3480,237,3243,2001,t2,cantonales
823,63,PUY DE DOME,9389,4512,295,4217,2001,t2,cantonales
824,63,PUY DE DOME,5405,2735,186,2549,2001,t2,cantonales
825,63,PUY DE DOME,6189,4300,134,4166,2001,t2,cantonales
826,63,PUY DE DOME,5882,3961,84,3877,2001,t2,cantonales
827,63,PUY DE DOME,3615,2810,87,2723,2001,t2,cantonales
828,63,PUY DE DOME,2727,1935,107,1828,2001,t2,cantonales
829,63,PUY DE DOME,5218,3941,161,3780,2001,t2,cantonales
830,63,PUY DE DOME,16259,10446,747,9699,2001,t2,cantonales
831,63,PUY DE DOME,2777,2269,85,2184,2001,t2,cantonales
832,63,PUY DE DOME,1977,1628,39,1589,2001,t2,cantonales
833,63,PUY DE DOME,7178,3464,273,3191,2001,t2,cantonales
834,63,PUY DE DOME,13725,8009,382,7627,2001,t2,cantonales
835,63,PUY DE DOME,5627,2739,215,2524,2001,t2,cantonales
836,64,PYRENEES ATLANTIQUES,9760,5942,389,5553,2001,t2,cantonales
837,64,PYRENEES ATLANTIQUES,2852,2251,30,2221,2001,t2,cantonales
838,64,PYRENEES ATLANTIQUES,2062,1742,45,1697,2001,t2,cantonales
839,64,PYRENEES ATLANTIQUES,13828,8498,442,8056,2001,t2,cantonales
840,64,PYRENEES ATLANTIQUES,5853,4582,211,4371,2001,t2,cantonales
841,64,PYRENEES ATLANTIQUES,12666,9256,563,8693,2001,t2,cantonales
842,64,PYRENEES ATLANTIQUES,15764,8472,492,7980,2001,t2,cantonales
843,64,PYRENEES ATLANTIQUES,6237,4493,311,4182,2001,t2,cantonales
844,64,PYRENEES ATLANTIQUES,4961,3850,92,3758,2001,t2,cantonales
845,64,PYRENEES ATLANTIQUES,17309,8797,654,8143,2001,t2,cantonales
846,64,PYRENEES ATLANTIQUES,14577,8998,928,8070,2001,t2,cantonales
847,64,PYRENEES ATLANTIQUES,19049,13422,949,12473,2001,t2,cantonales
848,64,PYRENEES ATLANTIQUES,12366,6932,375,6557,2001,t2,cantonales
849,64,PYRENEES ATLANTIQUES,14776,8855,421,8434,2001,t2,cantonales
850,64,PYRENEES ATLANTIQUES,10211,7418,689,6729,2001,t2,cantonales
851,65,HAUTES PYRENEES,8409,5873,287,5586,2001,t2,cantonales
852,65,HAUTES PYRENEES,10320,6600,302,6298,2001,t2,cantonales
853,65,HAUTES PYRENEES,3201,2452,82,2370,2001,t2,cantonales
854,65,HAUTES PYRENEES,1597,1375,46,1329,2001,t2,cantonales
855,65,HAUTES PYRENEES,1957,1514,78,1436,2001,t2,cantonales
856,65,HAUTES PYRENEES,8042,4569,1937,2632,2001,t2,cantonales
857,65,HAUTES PYRENEES,7933,5424,412,5012,2001,t2,cantonales
858,65,HAUTES PYRENEES,2936,2303,75,2228,2001,t2,cantonales
859,65,HAUTES PYRENEES,3703,2776,70,2706,2001,t2,cantonales
860,65,HAUTES PYRENEES,9065,6167,361,5806,2001,t2,cantonales
861,65,HAUTES PYRENEES,5355,3183,863,2320,2001,t2,cantonales
862,65,HAUTES PYRENEES,4868,3045,175,2870,2001,t2,cantonales
863,65,HAUTES PYRENEES,7903,4446,218,4228,2001,t2,cantonales
864,66,PYRENEES ORIENTALES,5694,4204,197,4007,2001,t2,cantonales
865,66,PYRENEES ORIENTALES,15081,9695,671,9024,2001,t2,cantonales
866,66,PYRENEES ORIENTALES,13030,9419,447,8972,2001,t2,cantonales
867,66,PYRENEES ORIENTALES,1664,1328,33,1295,2001,t2,cantonales
868,66,PYRENEES ORIENTALES,7547,5776,224,5552,2001,t2,cantonales
869,66,PYRENEES ORIENTALES,9223,5628,366,5262,2001,t2,cantonales
870,66,PYRENEES ORIENTALES,6566,4166,177,3989,2001,t2,cantonales
871,66,PYRENEES ORIENTALES,4780,2560,158,2402,2001,t2,cantonales
872,66,PYRENEES ORIENTALES,7416,4115,227,3888,2001,t2,cantonales
873,66,PYRENEES ORIENTALES,13119,8313,533,7780,2001,t2,cantonales
874,66,PYRENEES ORIENTALES,9944,6942,319,6623,2001,t2,cantonales
875,66,PYRENEES ORIENTALES,12006,8264,547,7717,2001,t2,cantonales
876,67,BAS RHIN,14070,8116,345,7771,2001,t2,cantonales
877,67,BAS RHIN,14816,9901,492,9409,2001,t2,cantonales
878,67,BAS RHIN,13998,8157,273,7884,2001,t2,cantonales
879,67,BAS RHIN,11244,6707,331,6376,2001,t2,cantonales
880,67,BAS RHIN,11542,7329,231,7098,2001,t2,cantonales
881,67,BAS RHIN,12190,7519,544,6975,2001,t2,cantonales
882,67,BAS RHIN,13091,7520,387,7133,2001,t2,cantonales
883,67,BAS RHIN,15088,7475,362,7113,2001,t2,cantonales
884,68,HAUT RHIN,24032,11075,783,10292,2001,t2,cantonales
885,68,HAUT RHIN,15091,5079,234,4845,2001,t2,cantonales
886,68,HAUT RHIN,9633,7073,223,6850,2001,t2,cantonales
887,68,HAUT RHIN,10578,6989,242,6747,2001,t2,cantonales
888,68,HAUT RHIN,14765,7486,539,6947,2001,t2,cantonales
889,68,HAUT RHIN,24245,12785,746,12039,2001,t2,cantonales
890,68,HAUT RHIN,9471,6440,200,6240,2001,t2,cantonales
891,68,HAUT RHIN,8358,5498,325,5173,2001,t2,cantonales
892,68,HAUT RHIN,32384,15033,692,14341,2001,t2,cantonales
893,68,HAUT RHIN,26444,10291,473,9818,2001,t2,cantonales
894,68,HAUT RHIN,15339,7768,486,7282,2001,t2,cantonales
895,68,HAUT RHIN,11833,6054,304,5750,2001,t2,cantonales
896,68,HAUT RHIN,22747,10665,587,10078,2001,t2,cantonales
897,69,RHONE,13381,6005,296,5709,2001,t2,cantonales
898,69,RHONE,10202,5661,258,5403,2001,t2,cantonales
899,69,RHONE,14441,9537,336,9201,2001,t2,cantonales
900,69,RHONE,12810,8059,292,7767,2001,t2,cantonales
901,69,RHONE,20621,12386,546,11840,2001,t2,cantonales
902,69,RHONE,15419,10209,273,9936,2001,t2,cantonales
903,69,RHONE,11307,7360,302,7058,2001,t2,cantonales
904,69,RHONE,14158,7684,201,7483,2001,t2,cantonales
905,69,RHONE,24371,10706,469,10237,2001,t2,cantonales
906,69,RHONE,14399,8227,667,7560,2001,t2,cantonales
907,69,RHONE,19692,10729,485,10244,2001,t2,cantonales
908,69,RHONE,11700,7094,290,6804,2001,t2,cantonales
909,69,RHONE,25523,10577,2685,7892,2001,t2,cantonales
910,69,RHONE,14701,7429,583,6846,2001,t2,cantonales
911,69,RHONE,11410,4959,367,4592,2001,t2,cantonales
912,69,RHONE,26258,14011,1853,12158,2001,t2,cantonales
913,69,RHONE,27548,14673,669,14004,2001,t2,cantonales
914,69,RHONE,17860,9727,411,9316,2001,t2,cantonales
915,69,RHONE,19284,9567,401,9166,2001,t2,cantonales
916,69,RHONE,20506,10392,781,9611,2001,t2,cantonales
917,69,RHONE,15652,7091,585,6506,2001,t2,cantonales
918,69,RHONE,12458,7856,311,7545,2001,t2,cantonales
919,69,RHONE,15258,8891,535,8356,2001,t2,cantonales
920,70,HAUTE SAONE,9502,5593,268,5325,2001,t2,cantonales
921,70,HAUTE SAONE,6943,4364,239,4125,2001,t2,cantonales
922,70,HAUTE SAONE,4111,2946,202,2744,2001,t2,cantonales
923,70,HAUTE SAONE,5546,3954,187,3767,2001,t2,cantonales
924,70,HAUTE SAONE,3308,2511,200,2311,2001,t2,cantonales
925,70,HAUTE SAONE,10893,6924,583,6341,2001,t2,cantonales
926,70,HAUTE SAONE,5057,3657,169,3488,2001,t2,cantonales
927,70,HAUTE SAONE,3325,2387,88,2299,2001,t2,cantonales
928,70,HAUTE SAONE,10039,6060,342,5718,2001,t2,cantonales
929,70,HAUTE SAONE,5795,4047,237,3810,2001,t2,cantonales
930,70,HAUTE SAONE,7406,4372,440,3932,2001,t2,cantonales
931,71,SAONE ET LOIRE ,7025,4373,272,4101,2001,t2,cantonales
932,71,SAONE ET LOIRE ,10759,6266,308,5958,2001,t2,cantonales
933,71,SAONE ET LOIRE ,12605,5842,322,5520,2001,t2,cantonales
934,71,SAONE ET LOIRE ,9556,6677,387,6290,2001,t2,cantonales
935,71,SAONE ET LOIRE ,10322,6683,284,6399,2001,t2,cantonales
936,71,SAONE ET LOIRE ,16995,8076,417,7659,2001,t2,cantonales
937,71,SAONE ET LOIRE ,2839,2117,86,2031,2001,t2,cantonales
938,71,SAONE ET LOIRE ,2186,1598,71,1527,2001,t2,cantonales
939,71,SAONE ET LOIRE ,3303,2521,89,2432,2001,t2,cantonales
940,71,SAONE ET LOIRE ,3430,2185,108,2077,2001,t2,cantonales
941,71,SAONE ET LOIRE ,9659,5868,203,5665,2001,t2,cantonales
942,71,SAONE ET LOIRE ,8527,4113,164,3949,2001,t2,cantonales
943,71,SAONE ET LOIRE ,9364,3676,213,3463,2001,t2,cantonales
944,71,SAONE ET LOIRE ,9279,4348,191,4157,2001,t2,cantonales
945,71,SAONE ET LOIRE ,13857,6734,211,6523,2001,t2,cantonales
946,72,SARTHE,8885,5434,379,5055,2001,t2,cantonales
947,72,SARTHE,4702,3332,103,3229,2001,t2,cantonales
948,72,SARTHE,4307,2795,219,2576,2001,t2,cantonales
949,72,SARTHE,8602,5343,149,5194,2001,t2,cantonales
950,72,SARTHE,17995,9302,460,8842,2001,t2,cantonales
951,72,SARTHE,11922,6338,368,5970,2001,t2,cantonales
952,72,SARTHE,6352,4048,141,3907,2001,t2,cantonales
953,72,SARTHE,14636,8104,343,7761,2001,t2,cantonales
954,72,SARTHE,11814,6519,342,6177,2001,t2,cantonales
955,72,SARTHE,3135,2102,60,2042,2001,t2,cantonales
956,72,SARTHE,14820,8281,653,7628,2001,t2,cantonales
957,72,SARTHE,4440,3065,72,2993,2001,t2,cantonales
958,72,SARTHE,11602,5619,1147,4472,2001,t2,cantonales
959,72,SARTHE,11377,6967,339,6628,2001,t2,cantonales
960,73,SAVOIE,3876,2859,81,2778,2001,t2,cantonales
961,73,SAVOIE,3443,2530,136,2394,2001,t2,cantonales
962,73,SAVOIE,6862,2856,81,2775,2001,t2,cantonales
963,73,SAVOIE,3643,2181,116,2065,2001,t2,cantonales
964,73,SAVOIE,4361,2838,133,2705,2001,t2,cantonales
965,73,SAVOIE,9164,5433,114,5319,2001,t2,cantonales
966,73,SAVOIE,9841,6035,239,5796,2001,t2,cantonales
967,73,SAVOIE,5081,3271,112,3159,2001,t2,cantonales
968,73,SAVOIE,3269,2303,112,2191,2001,t2,cantonales
969,73,SAVOIE,3926,2634,86,2548,2001,t2,cantonales
970,73,SAVOIE,11270,6479,195,6284,2001,t2,cantonales
971,73,SAVOIE,4143,3023,140,2883,2001,t2,cantonales
972,73,SAVOIE,10428,4955,291,4664,2001,t2,cantonales
973,73,SAVOIE,6372,2593,107,2486,2001,t2,cantonales
974,74,HAUTE SAVOIE,11260,6100,278,5822,2001,t2,cantonales
975,74,HAUTE SAVOIE,4947,3490,136,3354,2001,t2,cantonales
976,74,HAUTE SAVOIE,4268,2996,109,2887,2001,t2,cantonales
977,74,HAUTE SAVOIE,6100,3985,179,3806,2001,t2,cantonales
978,74,HAUTE SAVOIE,18085,10309,486,9823,2001,t2,cantonales
979,74,HAUTE SAVOIE,14701,7841,191,7650,2001,t2,cantonales
980,74,HAUTE SAVOIE,17109,9067,862,8205,2001,t2,cantonales
981,74,HAUTE SAVOIE,12667,7177,233,6944,2001,t2,cantonales
982,74,HAUTE SAVOIE,7016,4218,243,3975,2001,t2,cantonales
983,74,HAUTE SAVOIE,20451,6965,299,6666,2001,t2,cantonales
984,74,HAUTE SAVOIE,5640,3416,121,3295,2001,t2,cantonales
985,74,HAUTE SAVOIE,29114,13409,698,12711,2001,t2,cantonales
986,76,SEINE MARITIME ,16845,9893,466,9427,2001,t2,cantonales
987,76,SEINE MARITIME ,26337,12678,335,12343,2001,t2,cantonales
988,76,SEINE MARITIME ,6799,3948,146,3802,2001,t2,cantonales
989,76,SEINE MARITIME ,5601,3815,253,3562,2001,t2,cantonales
990,76,SEINE MARITIME ,16477,6389,363,6026,2001,t2,cantonales
991,76,SEINE MARITIME ,20031,11453,539,10914,2001,t2,cantonales
992,76,SEINE MARITIME ,11919,5661,260,5401,2001,t2,cantonales
993,76,SEINE MARITIME ,19208,10799,393,10406,2001,t2,cantonales
994,76,SEINE MARITIME ,25820,12869,434,12435,2001,t2,cantonales
995,76,SEINE MARITIME ,10235,5807,198,5609,2001,t2,cantonales
996,76,SEINE MARITIME ,5848,3411,124,3287,2001,t2,cantonales
997,76,SEINE MARITIME ,5636,3892,201,3691,2001,t2,cantonales
998,76,SEINE MARITIME ,14411,5830,1677,4153,2001,t2,cantonales
999,76,SEINE MARITIME ,14676,7973,292,7681,2001,t2,cantonales
1000,76,SEINE MARITIME ,16212,8491,310,8181,2001,t2,cantonales
1001,76,SEINE MARITIME ,7809,3849,142,3707,2001,t2,cantonales
1002,76,SEINE MARITIME ,17582,9675,522,9153,2001,t2,cantonales
1003,76,SEINE MARITIME ,18395,7934,528,7406,2001,t2,cantonales
1004,76,SEINE MARITIME ,13329,9037,329,8708,2001,t2,cantonales
1005,76,SEINE MARITIME ,11676,4584,313,4271,2001,t2,cantonales
1006,77,SEINE ET MARNE ,8319,4737,219,4518,2001,t2,cantonales
1007,77,SEINE ET MARNE ,23311,9950,437,9513,2001,t2,cantonales
1008,77,SEINE ET MARNE ,24934,10192,378,9814,2001,t2,cantonales
1009,77,SEINE ET MARNE ,22216,10210,485,9725,2001,t2,cantonales
1010,77,SEINE ET MARNE ,20003,10466,426,10040,2001,t2,cantonales
1011,77,SEINE ET MARNE ,25366,12884,609,12275,2001,t2,cantonales
1012,77,SEINE ET MARNE ,6775,4001,187,3814,2001,t2,cantonales
1013,77,SEINE ET MARNE ,27629,14287,556,13731,2001,t2,cantonales
1014,77,SEINE ET MARNE ,19970,9019,531,8488,2001,t2,cantonales
1015,77,SEINE ET MARNE ,10103,5439,307,5132,2001,t2,cantonales
1016,77,SEINE ET MARNE ,18425,7214,297,6917,2001,t2,cantonales
1017,77,SEINE ET MARNE ,17143,8271,269,8002,2001,t2,cantonales
1018,77,SEINE ET MARNE ,29571,14271,371,13900,2001,t2,cantonales
1019,77,SEINE ET MARNE ,15441,7661,364,7297,2001,t2,cantonales
1020,77,SEINE ET MARNE ,14233,7044,289,6755,2001,t2,cantonales
1021,77,SEINE ET MARNE ,14160,5634,299,5335,2001,t2,cantonales
1022,78,YVELINES,14922,8198,383,7815,2001,t2,cantonales
1023,78,YVELINES,24230,13028,520,12508,2001,t2,cantonales
1024,78,YVELINES,31850,15847,607,15240,2001,t2,cantonales
1025,78,YVELINES,24571,14411,521,13890,2001,t2,cantonales
1026,78,YVELINES,19255,9729,740,8989,2001,t2,cantonales
1027,78,YVELINES,14124,6285,280,6005,2001,t2,cantonales
1028,78,YVELINES,24789,12611,651,11960,2001,t2,cantonales
1029,78,YVELINES,23770,13306,697,12609,2001,t2,cantonales
1030,78,YVELINES,34533,17273,812,16461,2001,t2,cantonales
1031,78,YVELINES,22604,11822,556,11266,2001,t2,cantonales
1032,78,YVELINES,10841,5391,1258,4133,2001,t2,cantonales
1033,78,YVELINES,21166,13156,620,12536,2001,t2,cantonales
1034,78,YVELINES,20211,11058,1179,9879,2001,t2,cantonales
1035,78,YVELINES,31306,15389,554,14835,2001,t2,cantonales
1036,78,YVELINES,10096,5002,168,4834,2001,t2,cantonales
1037,78,YVELINES,18780,10557,555,10002,2001,t2,cantonales
1038,78,YVELINES,33316,15176,551,14625,2001,t2,cantonales
1039,78,YVELINES,14800,7804,336,7468,2001,t2,cantonales
1040,79,DEUX SEVRES,4137,2887,107,2780,2001,t2,cantonales
1041,79,DEUX SEVRES,7767,4888,255,4633,2001,t2,cantonales
1042,79,DEUX SEVRES,3536,2340,251,2089,2001,t2,cantonales
1043,79,DEUX SEVRES,16206,8286,520,7766,2001,t2,cantonales
1044,79,DEUX SEVRES,7107,4009,142,3867,2001,t2,cantonales
1045,79,DEUX SEVRES,6917,3989,158,3831,2001,t2,cantonales
1046,79,DEUX SEVRES,5714,3782,244,3538,2001,t2,cantonales
1047,79,DEUX SEVRES,10244,6491,423,6068,2001,t2,cantonales
1048,80,SOMME,10925,6320,208,6112,2001,t2,cantonales
1049,80,SOMME,5484,4161,217,3944,2001,t2,cantonales
1050,80,SOMME,11371,5160,217,4943,2001,t2,cantonales
1051,80,SOMME,7508,2962,191,2771,2001,t2,cantonales
1052,80,SOMME,10813,5134,583,4551,2001,t2,cantonales
1053,80,SOMME,4074,3430,112,3318,2001,t2,cantonales
1054,80,SOMME,4741,3708,81,3627,2001,t2,cantonales
1055,80,SOMME,5900,4629,181,4448,2001,t2,cantonales
1056,80,SOMME,9739,6174,233,5941,2001,t2,cantonales
1057,80,SOMME,4595,3756,180,3576,2001,t2,cantonales
1058,80,SOMME,12491,8153,256,7897,2001,t2,cantonales
1059,80,SOMME,13701,9325,634,8691,2001,t2,cantonales
1060,80,SOMME,9250,7269,238,7031,2001,t2,cantonales
1061,80,SOMME,8960,3946,268,3678,2001,t2,cantonales
1062,81,TARN,2991,2184,122,2062,2001,t2,cantonales
1063,81,TARN,7204,4899,435,4464,2001,t2,cantonales
1064,81,TARN,8957,6514,273,6241,2001,t2,cantonales
1065,81,TARN,3141,2614,50,2564,2001,t2,cantonales
1066,81,TARN,14799,9545,675,8870,2001,t2,cantonales
1067,81,TARN,4992,3650,256,3394,2001,t2,cantonales
1068,81,TARN,5709,4235,315,3920,2001,t2,cantonales
1069,81,TARN,5391,3612,194,3418,2001,t2,cantonales
1070,81,TARN,2940,2422,70,2352,2001,t2,cantonales
1071,81,TARN,9412,6255,345,5910,2001,t2,cantonales
1072,81,TARN,7409,5391,306,5085,2001,t2,cantonales
1073,81,TARN,8463,6163,382,5781,2001,t2,cantonales
1074,81,TARN,7616,5845,363,5482,2001,t2,cantonales
1075,82,TARN ET GARONNE,1690,1216,57,1159,2001,t2,cantonales
1076,82,TARN ET GARONNE,2084,1681,81,1600,2001,t2,cantonales
1077,82,TARN ET GARONNE,2092,1772,51,1721,2001,t2,cantonales
1078,82,TARN ET GARONNE,5975,3096,261,2835,2001,t2,cantonales
1079,82,TARN ET GARONNE,6211,4422,260,4162,2001,t2,cantonales
1080,82,TARN ET GARONNE,11237,6467,392,6075,2001,t2,cantonales
1081,82,TARN ET GARONNE,8014,5344,413,4931,2001,t2,cantonales
1082,82,TARN ET GARONNE,3886,2560,167,2393,2001,t2,cantonales
1083,82,TARN ET GARONNE,6834,4716,256,4460,2001,t2,cantonales
1084,82,TARN ET GARONNE,4169,2818,178,2640,2001,t2,cantonales
1085,82,TARN ET GARONNE,6181,4484,278,4206,2001,t2,cantonales
1086,83,VAR,2370,1901,110,1791,2001,t2,cantonales
1087,83,VAR,6288,3818,163,3655,2001,t2,cantonales
1088,83,VAR,10517,6463,323,6140,2001,t2,cantonales
1089,83,VAR,12935,7600,320,7280,2001,t2,cantonales
1090,83,VAR,30388,19740,738,19002,2001,t2,cantonales
1091,83,VAR,12316,7823,319,7504,2001,t2,cantonales
1092,83,VAR,19357,9229,670,8559,2001,t2,cantonales
1093,83,VAR,12576,7633,283,7350,2001,t2,cantonales
1094,83,VAR,17862,10107,429,9678,2001,t2,cantonales
1095,83,VAR,7022,4003,297,3706,2001,t2,cantonales
1096,83,VAR,16054,9097,648,8449,2001,t2,cantonales
1097,83,VAR,6961,4095,244,3851,2001,t2,cantonales
1098,83,VAR,19755,10901,628,10273,2001,t2,cantonales
1099,83,VAR,6712,3865,97,3768,2001,t2,cantonales
1100,83,VAR,16968,9132,553,8579,2001,t2,cantonales
1101,83,VAR,24560,15731,832,14899,2001,t2,cantonales
1102,83,VAR,20049,11064,1168,9896,2001,t2,cantonales
1103,84,VAUCLUSE,20591,11757,717,11040,2001,t2,cantonales
1104,84,VAUCLUSE,17858,11827,601,11226,2001,t2,cantonales
1105,84,VAUCLUSE,24364,15654,755,14899,2001,t2,cantonales
1106,84,VAUCLUSE,25608,15255,1212,14043,2001,t2,cantonales
1107,84,VAUCLUSE,14556,9955,332,9623,2001,t2,cantonales
1108,84,VAUCLUSE,11993,7297,443,6854,2001,t2,cantonales
1109,84,VAUCLUSE,8806,5387,483,4904,2001,t2,cantonales
1110,84,VAUCLUSE,13852,9008,394,8614,2001,t2,cantonales
1111,85,VENDEE,15011,9663,524,9139,2001,t2,cantonales
1112,85,VENDEE,5653,3974,208,3766,2001,t2,cantonales
1113,85,VENDEE,10464,6494,111,6383,2001,t2,cantonales
1114,85,VENDEE,8369,5637,267,5370,2001,t2,cantonales
1115,85,VENDEE,6621,3990,231,3759,2001,t2,cantonales
1116,85,VENDEE,6955,4815,145,4670,2001,t2,cantonales
1117,85,VENDEE,12735,7518,208,7310,2001,t2,cantonales
1118,85,VENDEE,29659,15511,970,14541,2001,t2,cantonales
1119,86,VIENNE,2528,1981,72,1909,2001,t2,cantonales
1120,86,VIENNE,7189,4168,134,4034,2001,t2,cantonales
1121,86,VIENNE,4508,3076,170,2906,2001,t2,cantonales
1122,86,VIENNE,9544,5590,212,5378,2001,t2,cantonales
1123,86,VIENNE,11469,5676,328,5348,2001,t2,cantonales
1124,86,VIENNE,7509,4934,206,4728,2001,t2,cantonales
1125,86,VIENNE,11052,6503,267,6236,2001,t2,cantonales
1126,86,VIENNE,8409,4854,213,4641,2001,t2,cantonales
1127,87,HAUTE VIENNE,4832,3087,430,2657,2001,t2,cantonales
1128,87,HAUTE VIENNE,3997,2719,127,2592,2001,t2,cantonales
1129,87,HAUTE VIENNE,3016,1945,550,1395,2001,t2,cantonales
1130,87,HAUTE VIENNE,3874,1792,90,1702,2001,t2,cantonales
1131,87,HAUTE VIENNE,3266,2330,123,2207,2001,t2,cantonales
1132,87,HAUTE VIENNE,6853,4049,341,3708,2001,t2,cantonales
1133,87,HAUTE VIENNE,5833,4082,399,3683,2001,t2,cantonales
1134,87,HAUTE VIENNE,3018,2093,628,1465,2001,t2,cantonales
1135,87,HAUTE VIENNE,9005,6304,292,6012,2001,t2,cantonales
1136,87,HAUTE VIENNE,3898,1808,135,1673,2001,t2,cantonales
1137,87,HAUTE VIENNE,12136,7221,546,6675,2001,t2,cantonales
1138,87,HAUTE VIENNE,6241,4338,362,3976,2001,t2,cantonales
1139,87,HAUTE VIENNE,5640,2103,450,1653,2001,t2,cantonales
1140,88,VOSGES,4548,3598,186,3412,2001,t2,cantonales
1141,88,VOSGES,8914,6206,245,5961,2001,t2,cantonales
1142,88,VOSGES,3205,2529,137,2392,2001,t2,cantonales
1143,88,VOSGES,9472,6614,256,6358,2001,t2,cantonales
1144,88,VOSGES,7723,4899,262,4637,2001,t2,cantonales
1145,88,VOSGES,10094,6523,387,6136,2001,t2,cantonales
1146,88,VOSGES,24147,12196,446,11750,2001,t2,cantonales
1147,88,VOSGES,12776,7548,547,7001,2001,t2,cantonales
1148,89,YONNE,6926,4012,273,3739,2001,t2,cantonales
1149,89,YONNE,5836,3089,175,2914,2001,t2,cantonales
1150,89,YONNE,5451,3910,178,3732,2001,t2,cantonales
1151,89,YONNE,2368,1733,84,1649,2001,t2,cantonales
1152,89,YONNE,9659,4783,165,4618,2001,t2,cantonales
1153,89,YONNE,2466,1823,97,1726,2001,t2,cantonales
1154,89,YONNE,13913,6512,341,6171,2001,t2,cantonales
1155,89,YONNE,5665,3610,157,3453,2001,t2,cantonales
1156,89,YONNE,7043,4255,324,3931,2001,t2,cantonales
1157,89,YONNE,4339,2595,99,2496,2001,t2,cantonales
1158,89,YONNE,8890,5389,157,5232,2001,t2,cantonales
1159,90,TERRITOIRE DE BELFORT,4979,3425,361,3064,2001,t2,cantonales
1160,90,TERRITOIRE DE BELFORT,9188,5566,432,5134,2001,t2,cantonales
1161,90,TERRITOIRE DE BELFORT,3813,2461,154,2307,2001,t2,cantonales
1162,90,TERRITOIRE DE BELFORT,4816,3433,175,3258,2001,t2,cantonales
1163,90,TERRITOIRE DE BELFORT,6467,3596,289,3307,2001,t2,cantonales
1164,90,TERRITOIRE DE BELFORT,4882,2671,253,2418,2001,t2,cantonales
1165,91,ESSONNE,18028,9110,269,8841,2001,t2,cantonales
1166,91,ESSONNE,20000,8946,3397,5549,2001,t2,cantonales
1167,91,ESSONNE,14510,8643,464,8179,2001,t2,cantonales
1168,91,ESSONNE,17214,8920,541,8379,2001,t2,cantonales
1169,91,ESSONNE,14403,7227,293,6934,2001,t2,cantonales
1170,91,ESSONNE,14718,8257,193,8064,2001,t2,cantonales
1171,91,ESSONNE,25573,14579,1041,13538,2001,t2,cantonales
1172,91,ESSONNE,22241,11870,535,11335,2001,t2,cantonales
1173,91,ESSONNE,14684,8216,450,7766,2001,t2,cantonales
1174,91,ESSONNE,24409,9267,2898,6369,2001,t2,cantonales
1175,91,ESSONNE,13707,7803,513,7290,2001,t2,cantonales
1176,91,ESSONNE,16240,8250,340,7910,2001,t2,cantonales
1177,91,ESSONNE,16351,7144,247,6897,2001,t2,cantonales
1178,91,ESSONNE,16621,8080,264,7816,2001,t2,cantonales
1179,91,ESSONNE,19713,9786,387,9399,2001,t2,cantonales
1180,91,ESSONNE,11530,6272,236,6036,2001,t2,cantonales
1181,91,ESSONNE,13326,7179,229,6950,2001,t2,cantonales
1182,91,ESSONNE,9380,4493,111,4382,2001,t2,cantonales
1183,91,ESSONNE,16370,7655,572,7083,2001,t2,cantonales
1184,91,ESSONNE,10194,4645,234,4411,2001,t2,cantonales
1185,92,HAUTS DE SEINE ,28333,12938,462,12476,2001,t2,cantonales
1186,92,HAUTS DE SEINE ,14582,6827,324,6503,2001,t2,cantonales
1187,92,HAUTS DE SEINE ,19817,10353,453,9900,2001,t2,cantonales
1188,92,HAUTS DE SEINE ,13292,8114,430,7684,2001,t2,cantonales
1189,92,HAUTS DE SEINE ,22798,10546,389,10157,2001,t2,cantonales
1190,92,HAUTS DE SEINE ,19473,11681,347,11334,2001,t2,cantonales
1191,92,HAUTS DE SEINE ,17609,9931,591,9340,2001,t2,cantonales
1192,92,HAUTS DE SEINE ,15888,9918,317,9601,2001,t2,cantonales
1193,92,HAUTS DE SEINE ,15891,8749,501,8248,2001,t2,cantonales
1194,92,HAUTS DE SEINE ,14245,9895,285,9610,2001,t2,cantonales
1195,92,HAUTS DE SEINE ,14553,7622,495,7127,2001,t2,cantonales
1196,92,HAUTS DE SEINE ,12935,6275,141,6134,2001,t2,cantonales
1197,92,HAUTS DE SEINE ,21169,11819,439,11380,2001,t2,cantonales
1198,92,HAUTS DE SEINE ,11248,4448,151,4297,2001,t2,cantonales
1199,92,HAUTS DE SEINE ,11448,6334,209,6125,2001,t2,cantonales
1200,92,HAUTS DE SEINE ,13712,7142,199,6943,2001,t2,cantonales
1201,92,HAUTS DE SEINE ,8193,2606,332,2274,2001,t2,cantonales
1202,93,SEINE SAINT-DENIS,8651,4245,541,3704,2001,t2,cantonales
1203,93,SEINE SAINT-DENIS,15227,8646,398,8248,2001,t2,cantonales
1204,93,SEINE SAINT-DENIS,13865,6268,1688,4580,2001,t2,cantonales
1205,93,SEINE SAINT-DENIS,21325,10301,3644,6657,2001,t2,cantonales
1206,93,SEINE SAINT-DENIS,18254,4762,1114,3648,2001,t2,cantonales
1207,93,SEINE SAINT-DENIS,10031,5642,396,5246,2001,t2,cantonales
1208,93,SEINE SAINT-DENIS,23162,10712,317,10395,2001,t2,cantonales
1209,93,SEINE SAINT-DENIS,21664,8935,426,8509,2001,t2,cantonales
1210,93,SEINE SAINT-DENIS,16113,7030,756,6274,2001,t2,cantonales
1211,93,SEINE SAINT-DENIS,11023,4880,112,4768,2001,t2,cantonales
1212,93,SEINE SAINT-DENIS,16634,8597,426,8171,2001,t2,cantonales
1213,93,SEINE SAINT-DENIS,10705,4939,1396,3543,2001,t2,cantonales
1214,93,SEINE SAINT-DENIS,18489,4268,722,3546,2001,t2,cantonales
1215,93,SEINE SAINT-DENIS,11440,5949,417,5532,2001,t2,cantonales
1216,93,SEINE SAINT-DENIS,15000,4019,1179,2840,2001,t2,cantonales
1217,93,SEINE SAINT-DENIS,18714,5905,532,5373,2001,t2,cantonales
1218,93,SEINE SAINT-DENIS,15008,8505,440,8065,2001,t2,cantonales
1219,93,SEINE SAINT-DENIS,10115,5377,377,5000,2001,t2,cantonales
1220,93,SEINE SAINT-DENIS,14726,6197,1993,4204,2001,t2,cantonales
1221,94,VAL DE MARNE,10591,4434,288,4146,2001,t2,cantonales
1222,94,VAL DE MARNE,16109,9342,390,8952,2001,t2,cantonales
1223,94,VAL DE MARNE,9191,4301,150,4151,2001,t2,cantonales
1224,94,VAL DE MARNE,12446,5478,237,5241,2001,t2,cantonales
1225,94,VAL DE MARNE,17558,6739,279,6460,2001,t2,cantonales
1226,94,VAL DE MARNE,10769,5810,1044,4766,2001,t2,cantonales
1227,94,VAL DE MARNE,15756,8452,433,8019,2001,t2,cantonales
1228,94,VAL DE MARNE,9932,5842,405,5437,2001,t2,cantonales
1229,94,VAL DE MARNE,14341,6290,239,6051,2001,t2,cantonales
1230,94,VAL DE MARNE,14841,7685,410,7275,2001,t2,cantonales
1231,94,VAL DE MARNE,12411,7374,249,7125,2001,t2,cantonales
1232,94,VAL DE MARNE,14657,7996,343,7653,2001,t2,cantonales
1233,94,VAL DE MARNE,11706,6642,288,6354,2001,t2,cantonales
1234,94,VAL DE MARNE,12729,3157,707,2450,2001,t2,cantonales
1235,94,VAL DE MARNE,13830,3339,671,2668,2001,t2,cantonales
1236,94,VAL DE MARNE,10962,4007,217,3790,2001,t2,cantonales
1237,94,VAL DE MARNE,13310,6754,375,6379,2001,t2,cantonales
1238,94,VAL DE MARNE,22064,10327,344,9983,2001,t2,cantonales
1239,94,VAL DE MARNE,14823,7377,346,7031,2001,t2,cantonales
1240,94,VAL DE MARNE,11277,6608,780,5828,2001,t2,cantonales
1241,94,VAL DE MARNE,15674,9121,468,8653,2001,t2,cantonales
1242,94,VAL DE MARNE,12692,3332,673,2659,2001,t2,cantonales
1243,95,VAL D'OISE,16872,9576,405,9171,2001,t2,cantonales
1244,95,VAL D'OISE,11051,5068,233,4835,2001,t2,cantonales
1245,95,VAL D'OISE,20568,8698,379,8319,2001,t2,cantonales
1246,95,VAL D'OISE,13793,6771,333,6438,2001,t2,cantonales
1247,95,VAL D'OISE,22865,11524,396,11128,2001,t2,cantonales
1248,95,VAL D'OISE,16987,7261,246,7015,2001,t2,cantonales
1249,95,VAL D'OISE,5673,2546,87,2459,2001,t2,cantonales
1250,95,VAL D'OISE,22499,11188,719,10469,2001,t2,cantonales
1251,95,VAL D'OISE,14566,8454,296,8158,2001,t2,cantonales
1252,95,VAL D'OISE,15938,9361,365,8996,2001,t2,cantonales
1253,95,VAL D'OISE,12715,5938,254,5684,2001,t2,cantonales
1254,95,VAL D'OISE,21810,9466,346,9120,2001,t2,cantonales
1255,95,VAL D'OISE,7344,4449,195,4254,2001,t2,cantonales
1256,95,VAL D'OISE,23590,11305,530,10775,2001,t2,cantonales
1257,95,VAL D'OISE,17438,10803,392,10411,2001,t2,cantonales
1258,95,VAL D'OISE,17141,7963,543,7420,2001,t2,cantonales
1259,95,VAL D'OISE,16925,9667,381,9286,2001,t2,cantonales
1260,95,VAL D'OISE,23416,12103,411,11692,2001,t2,cantonales
1261,95,VAL D'OISE,11827,5075,151,4924,2001,t2,cantonales
1262,971,GUADELOUPE,6134,4647,148,4499,2001,t2,cantonales
1263,971,GUADELOUPE,3214,2614,68,2546,2001,t2,cantonales
1264,971,GUADELOUPE,7298,4939,171,4768,2001,t2,cantonales
1265,971,GUADELOUPE,4960,3401,353,3048,2001,t2,cantonales
1266,971,GUADELOUPE,5239,3335,104,3231,2001,t2,cantonales
1267,971,GUADELOUPE,10332,8372,312,8060,2001,t2,cantonales
1268,971,GUADELOUPE,7530,5411,328,5083,2001,t2,cantonales
1269,971,GUADELOUPE,7756,4541,349,4192,2001,t2,cantonales
1270,972,MARTINIQUE,1344,865,63,802,2001,t2,cantonales
1271,972,MARTINIQUE,4118,2519,153,2366,2001,t2,cantonales
1272,972,MARTINIQUE,4229,2875,159,2716,2001,t2,cantonales
1273,972,MARTINIQUE,5683,2761,282,2479,2001,t2,cantonales
1274,972,MARTINIQUE,3135,1558,121,1437,2001,t2,cantonales
1275,972,MARTINIQUE,7361,3247,124,3123,2001,t2,cantonales
1276,972,MARTINIQUE,7112,3918,101,3817,2001,t2,cantonales
1277,972,MARTINIQUE,9754,6277,226,6051,2001,t2,cantonales
1278,972,MARTINIQUE,5044,1657,137,1520,2001,t2,cantonales
1279,972,MARTINIQUE,5821,4245,176,4069,2001,t2,cantonales
1280,972,MARTINIQUE,4501,2275,228,2047,2001,t2,cantonales
1281,972,MARTINIQUE,10617,5910,405,5505,2001,t2,cantonales
1282,973,GUYANE,1894,970,83,887,2001,t2,cantonales
1283,973,GUYANE,3460,1732,170,1562,2001,t2,cantonales
1284,973,GUYANE,1812,1194,41,1153,2001,t2,cantonales
1285,973,GUYANE,610,452,10,442,2001,t2,cantonales
1286,973,GUYANE,2827,1507,94,1413,2001,t2,cantonales
1287,973,GUYANE,2671,1452,79,1373,2001,t2,cantonales
1288,974,LA REUNION,6008,4480,275,4205,2001,t2,cantonales
1289,974,LA REUNION,3871,3379,107,3272,2001,t2,cantonales
1290,974,LA REUNION,10215,7537,208,7329,2001,t2,cantonales
1291,974,LA REUNION,5690,2680,107,2573,2001,t2,cantonales
1292,974,LA REUNION,6640,4354,148,4206,2001,t2,cantonales
1293,974,LA REUNION,7181,4131,142,3989,2001,t2,cantonales
1294,974,LA REUNION,7789,5560,155,5405,2001,t2,cantonales
1295,974,LA REUNION,14155,12020,365,11655,2001,t2,cantonales
1296,974,LA REUNION,10307,7110,480,6630,2001,t2,cantonales
1297,974,LA REUNION,12878,8363,334,8029,2001,t2,cantonales
1298,974,LA REUNION,4661,3571,88,3483,2001,t2,cantonales
1299,974,LA REUNION,7660,3662,188,3474,2001,t2,cantonales
1300,974,LA REUNION,7365,3357,171,3186,2001,t2,cantonales
1301,974,LA REUNION,9874,4692,215,4477,2001,t2,cantonales
1302,1,AIN,10638,4926,117,4809,2011,t1,cantonales
1303,1,AIN,10657,4683,57,4626,2011,t1,cantonales
1304,1,AIN,12238,6196,118,6078,2011,t1,cantonales
1305,1,AIN,12550,5410,116,5294,2011,t1,cantonales
1306,1,AIN,5032,2752,52,2700,2011,t1,cantonales
1307,1,AIN,16774,6007,92,5915,2011,t1,cantonales
1308,1,AIN,3560,1764,68,1696,2011,t1,cantonales
1309,1,AIN,4087,2083,50,2033,2011,t1,cantonales
1310,1,AIN,14103,5853,74,5779,2011,t1,cantonales
1311,1,AIN,7608,3605,41,3564,2011,t1,cantonales
1312,1,AIN,4914,2647,25,2622,2011,t1,cantonales
1313,1,AIN,9152,4161,74,4087,2011,t1,cantonales
1314,1,AIN,8943,4355,95,4260,2011,t1,cantonales
1315,1,AIN,4219,2183,28,2155,2011,t1,cantonales
1316,1,AIN,4111,1850,22,1828,2011,t1,cantonales
1317,1,AIN,10187,4184,82,4102,2011,t1,cantonales
1318,1,AIN,11852,4552,64,4488,2011,t1,cantonales
1319,1,AIN,6725,2914,45,2869,2011,t1,cantonales
1320,1,AIN,3248,1854,27,1827,2011,t1,cantonales
1321,1,AIN,9942,4292,93,4199,2011,t1,cantonales
1322,1,AIN,14225,5442,64,5378,2011,t1,cantonales
1323,1,AIN,12216,6060,84,5976,2011,t1,cantonales
1324,2,AISNE,7466,3541,81,3460,2011,t1,cantonales
1325,2,AISNE,9831,4764,156,4608,2011,t1,cantonales
1326,2,AISNE,8175,4064,83,3981,2011,t1,cantonales
1327,2,AISNE,6170,3013,122,2891,2011,t1,cantonales
1328,2,AISNE,19797,8815,232,8583,2011,t1,cantonales
1329,2,AISNE,17080,7551,169,7382,2011,t1,cantonales
1330,2,AISNE,4105,2259,57,2202,2011,t1,cantonales
1331,2,AISNE,6537,3248,72,3176,2011,t1,cantonales
1332,2,AISNE,10281,4499,116,4383,2011,t1,cantonales
1333,2,AISNE,5301,3125,219,2906,2011,t1,cantonales
1334,2,AISNE,7014,3158,87,3071,2011,t1,cantonales
1335,2,AISNE,4814,2602,63,2539,2011,t1,cantonales
1336,2,AISNE,6375,3311,94,3217,2011,t1,cantonales
1337,2,AISNE,3328,2159,71,2088,2011,t1,cantonales
1338,2,AISNE,11987,4704,129,4575,2011,t1,cantonales
1339,2,AISNE,7207,3647,101,3546,2011,t1,cantonales
1340,2,AISNE,7395,3736,76,3660,2011,t1,cantonales
1341,2,AISNE,7325,3871,143,3728,2011,t1,cantonales
1342,2,AISNE,5979,3204,73,3131,2011,t1,cantonales
1343,2,AISNE,7776,3731,105,3626,2011,t1,cantonales
1344,2,AISNE,15578,6604,209,6395,2011,t1,cantonales
1345,3,ALLIER,4824,2697,219,2478,2011,t1,cantonales
1346,3,ALLIER,4824,2847,123,2724,2011,t1,cantonales
1347,3,ALLIER,4188,2283,91,2192,2011,t1,cantonales
1348,3,ALLIER,9230,4199,144,4055,2011,t1,cantonales
1349,3,ALLIER,6796,3452,121,3331,2011,t1,cantonales
1350,3,ALLIER,14932,7071,169,6902,2011,t1,cantonales
1351,3,ALLIER,6864,3939,141,3798,2011,t1,cantonales
1352,3,ALLIER,3428,1841,87,1754,2011,t1,cantonales
1353,3,ALLIER,4819,2485,87,2398,2011,t1,cantonales
1354,3,ALLIER,3786,2186,79,2107,2011,t1,cantonales
1355,3,ALLIER,3831,2476,97,2379,2011,t1,cantonales
1356,3,ALLIER,9153,3687,156,3531,2011,t1,cantonales
1357,3,ALLIER,11086,4499,161,4338,2011,t1,cantonales
1358,3,ALLIER,4984,2841,84,2757,2011,t1,cantonales
1359,3,ALLIER,8426,3288,65,3223,2011,t1,cantonales
1360,3,ALLIER,12480,5928,162,5766,2011,t1,cantonales
1361,3,ALLIER,8889,4107,174,3933,2011,t1,cantonales
1362,3,ALLIER,10562,5057,179,4878,2011,t1,cantonales
1363,4,ALPES DE HAUTE PROVENCE,1957,1363,45,1318,2011,t1,cantonales
1364,4,ALPES DE HAUTE PROVENCE,2455,1577,46,1531,2011,t1,cantonales
1365,4,ALPES DE HAUTE PROVENCE,5440,2721,107,2614,2011,t1,cantonales
1366,4,ALPES DE HAUTE PROVENCE,1240,837,17,820,2011,t1,cantonales
1367,4,ALPES DE HAUTE PROVENCE,2061,1274,112,1162,2011,t1,cantonales
1368,4,ALPES DE HAUTE PROVENCE,10266,5216,115,5101,2011,t1,cantonales
1369,4,ALPES DE HAUTE PROVENCE,1604,981,75,906,2011,t1,cantonales
1370,4,ALPES DE HAUTE PROVENCE,8679,3766,95,3671,2011,t1,cantonales
1371,4,ALPES DE HAUTE PROVENCE,1724,1121,57,1064,2011,t1,cantonales
1372,4,ALPES DE HAUTE PROVENCE,1153,825,4,821,2011,t1,cantonales
1373,4,ALPES DE HAUTE PROVENCE,2887,1821,61,1760,2011,t1,cantonales
1374,4,ALPES DE HAUTE PROVENCE,4163,2486,58,2428,2011,t1,cantonales
1375,4,ALPES DE HAUTE PROVENCE,1420,904,18,886,2011,t1,cantonales
1376,4,ALPES DE HAUTE PROVENCE,5085,2505,60,2445,2011,t1,cantonales
1377,4,ALPES DE HAUTE PROVENCE,8489,4534,89,4445,2011,t1,cantonales
1378,4,ALPES DE HAUTE PROVENCE,6024,3149,255,2894,2011,t1,cantonales
1379,5,HAUTES ALPES,1849,1277,46,1231,2011,t1,cantonales
1380,5,HAUTES ALPES,5222,3014,98,2916,2011,t1,cantonales
1381,5,HAUTES ALPES,3654,2260,69,2191,2011,t1,cantonales
1382,5,HAUTES ALPES,3675,1701,45,1656,2011,t1,cantonales
1383,5,HAUTES ALPES,3675,2398,75,2323,2011,t1,cantonales
1384,5,HAUTES ALPES,3171,1518,59,1459,2011,t1,cantonales
1385,5,HAUTES ALPES,1026,794,22,772,2011,t1,cantonales
1386,5,HAUTES ALPES,6134,4001,77,3924,2011,t1,cantonales
1387,5,HAUTES ALPES,1658,1251,16,1235,2011,t1,cantonales
1388,5,HAUTES ALPES,1578,1147,33,1114,2011,t1,cantonales
1389,5,HAUTES ALPES,2152,1438,48,1390,2011,t1,cantonales
1390,5,HAUTES ALPES,4683,3279,62,3217,2011,t1,cantonales
1391,5,HAUTES ALPES,3445,2055,125,1930,2011,t1,cantonales
1392,5,HAUTES ALPES,5658,2325,83,2242,2011,t1,cantonales
1393,5,HAUTES ALPES,6282,2491,99,2392,2011,t1,cantonales
1394,6,ALPES MARITIMES,27153,10897,250,10647,2011,t1,cantonales
1395,6,ALPES MARITIMES,2124,1237,22,1215,2011,t1,cantonales
1396,6,ALPES MARITIMES,7397,3886,91,3795,2011,t1,cantonales
1397,6,ALPES MARITIMES,21843,8642,150,8492,2011,t1,cantonales
1398,6,ALPES MARITIMES,3053,1872,86,1786,2011,t1,cantonales
1399,6,ALPES MARITIMES,15978,7552,236,7316,2011,t1,cantonales
1400,6,ALPES MARITIMES,21373,9045,169,8876,2011,t1,cantonales
1401,6,ALPES MARITIMES,2673,1825,46,1779,2011,t1,cantonales
1402,6,ALPES MARITIMES,2868,1968,93,1875,2011,t1,cantonales
1403,6,ALPES MARITIMES,1732,1322,18,1304,2011,t1,cantonales
1404,6,ALPES MARITIMES,15827,7712,130,7582,2011,t1,cantonales
1405,6,ALPES MARITIMES,2287,1675,28,1647,2011,t1,cantonales
1406,6,ALPES MARITIMES,2799,1926,28,1898,2011,t1,cantonales
1407,6,ALPES MARITIMES,16932,7663,153,7510,2011,t1,cantonales
1408,6,ALPES MARITIMES,18296,6896,141,6755,2011,t1,cantonales
1409,6,ALPES MARITIMES,29352,11173,232,10941,2011,t1,cantonales
1410,6,ALPES MARITIMES,28315,11607,298,11309,2011,t1,cantonales
1411,6,ALPES MARITIMES,14915,5670,92,5578,2011,t1,cantonales
1412,6,ALPES MARITIMES,12987,4836,70,4766,2011,t1,cantonales
1413,6,ALPES MARITIMES,20919,7318,151,7167,2011,t1,cantonales
1414,6,ALPES MARITIMES,19188,7581,133,7448,2011,t1,cantonales
1415,6,ALPES MARITIMES,12492,5074,129,4945,2011,t1,cantonales
1416,6,ALPES MARITIMES,13854,5421,128,5293,2011,t1,cantonales
1417,6,ALPES MARITIMES,19658,6547,157,6390,2011,t1,cantonales
1418,6,ALPES MARITIMES,18022,7013,116,6897,2011,t1,cantonales
1419,6,ALPES MARITIMES,15253,5944,124,5820,2011,t1,cantonales
1420,7,ARDECHE,13726,5548,164,5384,2011,t1,cantonales
1421,7,ARDECHE,2541,1650,28,1622,2011,t1,cantonales
1422,7,ARDECHE,5297,3366,85,3281,2011,t1,cantonales
1423,7,ARDECHE,7859,4342,81,4261,2011,t1,cantonales
1424,7,ARDECHE,5224,3500,63,3437,2011,t1,cantonales
1425,7,ARDECHE,1837,1284,18,1266,2011,t1,cantonales
1426,7,ARDECHE,14186,6585,196,6389,2011,t1,cantonales
1427,7,ARDECHE,883,644,12,632,2011,t1,cantonales
1428,7,ARDECHE,3088,1918,61,1857,2011,t1,cantonales
1429,7,ARDECHE,2904,1879,59,1820,2011,t1,cantonales
1430,7,ARDECHE,2678,1488,87,1401,2011,t1,cantonales
1431,7,ARDECHE,964,609,21,588,2011,t1,cantonales
1432,7,ARDECHE,7095,4197,67,4130,2011,t1,cantonales
1433,7,ARDECHE,10509,5407,131,5276,2011,t1,cantonales
1434,7,ARDECHE,11179,5044,157,4887,2011,t1,cantonales
1435,7,ARDECHE,11516,4825,161,4664,2011,t1,cantonales
1436,8,ARDENNES,4863,2024,37,1987,2011,t1,cantonales
1437,8,ARDENNES,3648,1847,71,1776,2011,t1,cantonales
1438,8,ARDENNES,1700,1004,50,954,2011,t1,cantonales
1439,8,ARDENNES,8907,3843,84,3759,2011,t1,cantonales
1440,8,ARDENNES,2077,1167,40,1127,2011,t1,cantonales
1441,8,ARDENNES,3640,1921,40,1881,2011,t1,cantonales
1442,8,ARDENNES,1916,1065,12,1053,2011,t1,cantonales
1443,8,ARDENNES,2963,1680,56,1624,2011,t1,cantonales
1444,8,ARDENNES,5940,3038,57,2981,2011,t1,cantonales
1445,8,ARDENNES,9478,4071,101,3970,2011,t1,cantonales
1446,8,ARDENNES,3169,2045,45,2000,2011,t1,cantonales
1447,8,ARDENNES,7137,2797,61,2736,2011,t1,cantonales
1448,8,ARDENNES,8904,3409,80,3329,2011,t1,cantonales
1449,8,ARDENNES,3094,1751,35,1716,2011,t1,cantonales
1450,8,ARDENNES,2779,1652,43,1609,2011,t1,cantonales
1451,8,ARDENNES,1108,664,26,638,2011,t1,cantonales
1452,8,ARDENNES,4477,2496,55,2441,2011,t1,cantonales
1453,8,ARDENNES,6686,3727,53,3674,2011,t1,cantonales
1454,9,ARIEGE,4586,2802,116,2686,2011,t1,cantonales
1455,9,ARIEGE,10293,5165,147,5018,2011,t1,cantonales
1456,9,ARIEGE,3451,2032,80,1952,2011,t1,cantonales
1457,9,ARIEGE,2736,1584,61,1523,2011,t1,cantonales
1458,9,ARIEGE,7516,3255,92,3163,2011,t1,cantonales
1459,9,ARIEGE,489,389,30,359,2011,t1,cantonales
1460,9,ARIEGE,1798,1321,50,1271,2011,t1,cantonales
1461,9,ARIEGE,7722,3666,216,3450,2011,t1,cantonales
1462,9,ARIEGE,6715,4486,129,4357,2011,t1,cantonales
1463,9,ARIEGE,1450,893,74,819,2011,t1,cantonales
1464,9,ARIEGE,9670,4310,143,4167,2011,t1,cantonales
1465,10,AUBE,6934,3354,142,3212,2011,t1,cantonales
1466,10,AUBE,7839,3802,182,3620,2011,t1,cantonales
1467,10,AUBE,5772,3288,159,3129,2011,t1,cantonales
1468,10,AUBE,4294,2277,59,2218,2011,t1,cantonales
1469,10,AUBE,4441,2344,32,2312,2011,t1,cantonales
1470,10,AUBE,5086,2501,72,2429,2011,t1,cantonales
1471,10,AUBE,2579,1415,39,1376,2011,t1,cantonales
1472,10,AUBE,7641,3456,95,3361,2011,t1,cantonales
1473,10,AUBE,2861,1644,58,1586,2011,t1,cantonales
1474,10,AUBE,2246,1347,81,1266,2011,t1,cantonales
1475,10,AUBE,10101,4104,88,4016,2011,t1,cantonales
1476,10,AUBE,8022,2610,49,2561,2011,t1,cantonales
1477,10,AUBE,2844,1490,42,1448,2011,t1,cantonales
1478,10,AUBE,6812,2798,70,2728,2011,t1,cantonales
1479,10,AUBE,5079,1693,19,1674,2011,t1,cantonales
1480,10,AUBE,10936,4147,81,4066,2011,t1,cantonales
1481,10,AUBE,5965,2138,54,2084,2011,t1,cantonales
1482,11,AUDE,3882,2583,59,2524,2011,t1,cantonales
1483,11,AUDE,6308,3464,99,3365,2011,t1,cantonales
1484,11,AUDE,1572,972,33,939,2011,t1,cantonales
1485,11,AUDE,1709,1120,27,1093,2011,t1,cantonales
1486,11,AUDE,13977,6367,228,6139,2011,t1,cantonales
1487,11,AUDE,7070,3813,118,3695,2011,t1,cantonales
1488,11,AUDE,2523,1667,62,1605,2011,t1,cantonales
1489,11,AUDE,3207,1866,110,1756,2011,t1,cantonales
1490,11,AUDE,20094,9843,336,9507,2011,t1,cantonales
1491,11,AUDE,3199,2126,50,2076,2011,t1,cantonales
1492,11,AUDE,2633,1688,72,1616,2011,t1,cantonales
1493,11,AUDE,15385,8311,231,8080,2011,t1,cantonales
1494,11,AUDE,1877,1292,49,1243,2011,t1,cantonales
1495,11,AUDE,14387,6248,216,6032,2011,t1,cantonales
1496,11,AUDE,9621,5621,177,5444,2011,t1,cantonales
1497,11,AUDE,1640,1149,37,1112,2011,t1,cantonales
1498,11,AUDE,1625,1000,101,899,2011,t1,cantonales
1499,11,AUDE,6300,2735,139,2596,2011,t1,cantonales
1500,12,AVEYRON,2249,1543,69,1474,2011,t1,cantonales
1501,12,AVEYRON,5600,3243,118,3125,2011,t1,cantonales
1502,12,AVEYRON,1493,1103,38,1065,2011,t1,cantonales
1503,12,AVEYRON,2144,1436,56,1380,2011,t1,cantonales
1504,12,AVEYRON,2574,1629,70,1559,2011,t1,cantonales
1505,12,AVEYRON,1999,1462,31,1431,2011,t1,cantonales
1506,12,AVEYRON,3683,2579,105,2474,2011,t1,cantonales
1507,12,AVEYRON,7797,4307,286,4021,2011,t1,cantonales
1508,12,AVEYRON,5621,3978,78,3900,2011,t1,cantonales
1509,12,AVEYRON,2569,1943,26,1917,2011,t1,cantonales
1510,12,AVEYRON,3431,2374,68,2306,2011,t1,cantonales
1511,12,AVEYRON,2776,1927,53,1874,2011,t1,cantonales
1512,12,AVEYRON,4316,3068,145,2923,2011,t1,cantonales
1513,12,AVEYRON,5601,3590,107,3483,2011,t1,cantonales
1514,12,AVEYRON,9276,4268,176,4092,2011,t1,cantonales
1515,12,AVEYRON,9539,5902,314,5588,2011,t1,cantonales
1516,12,AVEYRON,2019,1368,56,1312,2011,t1,cantonales
1517,12,AVEYRON,3038,2168,105,2063,2011,t1,cantonales
1518,12,AVEYRON,1745,1392,24,1368,2011,t1,cantonales
1519,12,AVEYRON,1449,1185,26,1159,2011,t1,cantonales
1520,12,AVEYRON,12758,6842,247,6595,2011,t1,cantonales
1521,12,AVEYRON,14034,6869,260,6609,2011,t1,cantonales
1522,13,BOUCHES DU RHONE,46464,15444,301,15143,2011,t1,cantonales
1523,13,BOUCHES DU RHONE,17786,7377,175,7202,2011,t1,cantonales
1524,13,BOUCHES DU RHONE,23510,9581,227,9354,2011,t1,cantonales
1525,13,BOUCHES DU RHONE,29928,12000,256,11744,2011,t1,cantonales
1526,13,BOUCHES DU RHONE,17729,7932,216,7716,2011,t1,cantonales
1527,13,BOUCHES DU RHONE,20230,9577,155,9422,2011,t1,cantonales
1528,13,BOUCHES DU RHONE,16962,5844,96,5748,2011,t1,cantonales
1529,13,BOUCHES DU RHONE,18451,7048,124,6924,2011,t1,cantonales
1530,13,BOUCHES DU RHONE,16209,6854,152,6702,2011,t1,cantonales
1531,13,BOUCHES DU RHONE,17310,5605,136,5469,2011,t1,cantonales
1532,13,BOUCHES DU RHONE,21790,8241,149,8092,2011,t1,cantonales
1533,13,BOUCHES DU RHONE,19808,6776,158,6618,2011,t1,cantonales
1534,13,BOUCHES DU RHONE,14167,6375,146,6229,2011,t1,cantonales
1535,13,BOUCHES DU RHONE,6227,3963,87,3876,2011,t1,cantonales
1536,13,BOUCHES DU RHONE,12757,5939,163,5776,2011,t1,cantonales
1537,13,BOUCHES DU RHONE,13003,6174,126,6048,2011,t1,cantonales
1538,13,BOUCHES DU RHONE,23380,10480,184,10296,2011,t1,cantonales
1539,13,BOUCHES DU RHONE,25491,11345,285,11060,2011,t1,cantonales
1540,13,BOUCHES DU RHONE,26990,11485,254,11231,2011,t1,cantonales
1541,13,BOUCHES DU RHONE,19668,8051,133,7918,2011,t1,cantonales
1542,13,BOUCHES DU RHONE,24851,8953,235,8718,2011,t1,cantonales
1543,13,BOUCHES DU RHONE,18488,6209,129,6080,2011,t1,cantonales
1544,13,BOUCHES DU RHONE,23836,9057,152,8905,2011,t1,cantonales
1545,13,BOUCHES DU RHONE,36858,15888,321,15567,2011,t1,cantonales
1546,13,BOUCHES DU RHONE,35166,14948,395,14553,2011,t1,cantonales
1547,13,BOUCHES DU RHONE,32635,13839,192,13647,2011,t1,cantonales
1548,13,BOUCHES DU RHONE,23035,9144,209,8935,2011,t1,cantonales
1549,13,BOUCHES DU RHONE,31633,12948,264,12684,2011,t1,cantonales
1550,13,BOUCHES DU RHONE,21956,8089,131,7958,2011,t1,cantonales
1551,14,CALVADOS,6235,2813,111,2702,2011,t1,cantonales
1552,14,CALVADOS,7802,3556,77,3479,2011,t1,cantonales
1553,14,CALVADOS,14464,6856,125,6731,2011,t1,cantonales
1554,14,CALVADOS,6288,3267,98,3169,2011,t1,cantonales
1555,14,CALVADOS,16893,7223,313,6910,2011,t1,cantonales
1556,14,CALVADOS,10450,4923,138,4785,2011,t1,cantonales
1557,14,CALVADOS,11064,4819,106,4713,2011,t1,cantonales
1558,14,CALVADOS,3883,2006,32,1974,2011,t1,cantonales
1559,14,CALVADOS,4523,2419,338,2081,2011,t1,cantonales
1560,14,CALVADOS,5897,3245,117,3128,2011,t1,cantonales
1561,14,CALVADOS,15954,7659,138,7521,2011,t1,cantonales
1562,14,CALVADOS,11729,5768,248,5520,2011,t1,cantonales
1563,14,CALVADOS,8169,3949,132,3817,2011,t1,cantonales
1564,14,CALVADOS,6411,3142,68,3074,2011,t1,cantonales
1565,14,CALVADOS,9891,4366,129,4237,2011,t1,cantonales
1566,14,CALVADOS,7594,2899,148,2751,2011,t1,cantonales
1567,14,CALVADOS,4994,2709,77,2632,2011,t1,cantonales
1568,14,CALVADOS,7805,3248,91,3157,2011,t1,cantonales
1569,14,CALVADOS,11188,4278,102,4176,2011,t1,cantonales
1570,14,CALVADOS,6697,2782,78,2704,2011,t1,cantonales
1571,14,CALVADOS,10002,3892,106,3786,2011,t1,cantonales
1572,14,CALVADOS,14356,5883,139,5744,2011,t1,cantonales
1573,14,CALVADOS,9495,4113,256,3857,2011,t1,cantonales
1574,15,CANTAL,5922,2479,108,2371,2011,t1,cantonales
1575,15,CANTAL,2507,1661,60,1601,2011,t1,cantonales
1576,15,CANTAL,2045,1455,57,1398,2011,t1,cantonales
1577,15,CANTAL,2505,1540,62,1478,2011,t1,cantonales
1578,15,CANTAL,6077,3333,166,3167,2011,t1,cantonales
1579,15,CANTAL,5095,3371,150,3221,2011,t1,cantonales
1580,15,CANTAL,3918,2693,73,2620,2011,t1,cantonales
1581,15,CANTAL,5254,3019,147,2872,2011,t1,cantonales
1582,15,CANTAL,2189,1196,128,1068,2011,t1,cantonales
1583,15,CANTAL,5972,3033,223,2810,2011,t1,cantonales
1584,15,CANTAL,6650,3667,153,3514,2011,t1,cantonales
1585,15,CANTAL,4875,3046,166,2880,2011,t1,cantonales
1586,15,CANTAL,3134,1946,61,1885,2011,t1,cantonales
1587,15,CANTAL,7085,3812,142,3670,2011,t1,cantonales
1588,16,CHARENTE,3857,2525,90,2435,2011,t1,cantonales
1589,16,CHARENTE,8044,2696,113,2583,2011,t1,cantonales
1590,16,CHARENTE,8504,3111,65,3046,2011,t1,cantonales
1591,16,CHARENTE,2424,1485,67,1418,2011,t1,cantonales
1592,16,CHARENTE,3285,1488,79,1409,2011,t1,cantonales
1593,16,CHARENTE,11804,4639,94,4545,2011,t1,cantonales
1594,16,CHARENTE,3518,2365,61,2304,2011,t1,cantonales
1595,16,CHARENTE,4753,2809,66,2743,2011,t1,cantonales
1596,16,CHARENTE,9472,3912,123,3789,2011,t1,cantonales
1597,16,CHARENTE,9515,3843,120,3723,2011,t1,cantonales
1598,16,CHARENTE,5631,2990,265,2725,2011,t1,cantonales
1599,16,CHARENTE,3709,2097,53,2044,2011,t1,cantonales
1600,16,CHARENTE,6445,3362,166,3196,2011,t1,cantonales
1601,16,CHARENTE,7021,3379,98,3281,2011,t1,cantonales
1602,16,CHARENTE,8374,4192,140,4052,2011,t1,cantonales
1603,16,CHARENTE,9454,3952,101,3851,2011,t1,cantonales
1604,16,CHARENTE,5856,3132,82,3050,2011,t1,cantonales
1605,16,CHARENTE,9323,3176,80,3096,2011,t1,cantonales
1606,17,CHARENTE MARITIME,9230,3886,124,3762,2011,t1,cantonales
1607,17,CHARENTE MARITIME,5217,2682,90,2592,2011,t1,cantonales
1608,17,CHARENTE MARITIME,5104,2458,69,2389,2011,t1,cantonales
1609,17,CHARENTE MARITIME,3881,2124,38,2086,2011,t1,cantonales
1610,17,CHARENTE MARITIME,8797,3807,113,3694,2011,t1,cantonales
1611,17,CHARENTE MARITIME,11025,5315,106,5209,2011,t1,cantonales
1612,17,CHARENTE MARITIME,5018,2796,60,2736,2011,t1,cantonales
1613,17,CHARENTE MARITIME,4912,2673,88,2585,2011,t1,cantonales
1614,17,CHARENTE MARITIME,9407,4555,111,4444,2011,t1,cantonales
1615,17,CHARENTE MARITIME,10658,5057,84,4973,2011,t1,cantonales
1616,17,CHARENTE MARITIME,7201,2572,48,2524,2011,t1,cantonales
1617,17,CHARENTE MARITIME,6348,2395,39,2356,2011,t1,cantonales
1618,17,CHARENTE MARITIME,14839,6745,159,6586,2011,t1,cantonales
1619,17,CHARENTE MARITIME,5841,2771,70,2701,2011,t1,cantonales
1620,17,CHARENTE MARITIME,12606,5927,131,5796,2011,t1,cantonales
1621,17,CHARENTE MARITIME,10990,5709,89,5620,2011,t1,cantonales
1622,17,CHARENTE MARITIME,10760,4981,97,4884,2011,t1,cantonales
1623,17,CHARENTE MARITIME,12157,4987,144,4843,2011,t1,cantonales
1624,17,CHARENTE MARITIME,13893,6110,148,5962,2011,t1,cantonales
1625,17,CHARENTE MARITIME,10878,5108,129,4979,2011,t1,cantonales
1626,17,CHARENTE MARITIME,2565,1488,28,1460,2011,t1,cantonales
1627,17,CHARENTE MARITIME,5483,1727,26,1701,2011,t1,cantonales
1628,17,CHARENTE MARITIME,8917,3632,38,3594,2011,t1,cantonales
1629,17,CHARENTE MARITIME,17327,7517,146,7371,2011,t1,cantonales
1630,17,CHARENTE MARITIME,13663,5582,107,5475,2011,t1,cantonales
1631,17,CHARENTE MARITIME,9884,3479,49,3430,2011,t1,cantonales
1632,18,CHER,4236,2288,32,2256,2011,t1,cantonales
1633,18,CHER,7125,3537,134,3403,2011,t1,cantonales
1634,18,CHER,2075,1097,32,1065,2011,t1,cantonales
1635,18,CHER,3229,1932,71,1861,2011,t1,cantonales
1636,18,CHER,10659,4856,133,4723,2011,t1,cantonales
1637,18,CHER,2176,1272,90,1182,2011,t1,cantonales
1638,18,CHER,2793,1582,27,1555,2011,t1,cantonales
1639,18,CHER,8262,3997,131,3866,2011,t1,cantonales
1640,18,CHER,3196,1931,52,1879,2011,t1,cantonales
1641,18,CHER,8461,4072,127,3945,2011,t1,cantonales
1642,18,CHER,3515,1814,50,1764,2011,t1,cantonales
1643,18,CHER,12513,5729,181,5548,2011,t1,cantonales
1644,18,CHER,4117,2265,59,2206,2011,t1,cantonales
1645,18,CHER,2900,1654,46,1608,2011,t1,cantonales
1646,18,CHER,11002,4110,94,4016,2011,t1,cantonales
1647,18,CHER,14888,5724,335,5389,2011,t1,cantonales
1648,18,CHER,10112,3435,164,3271,2011,t1,cantonales
1649,18,CHER,6742,2360,72,2288,2011,t1,cantonales
1650,19,CORREZE,5129,3513,108,3405,2011,t1,cantonales
1651,19,CORREZE,6933,4837,161,4676,2011,t1,cantonales
1652,19,CORREZE,3267,2403,98,2305,2011,t1,cantonales
1653,19,CORREZE,1928,1516,52,1464,2011,t1,cantonales
1654,19,CORREZE,2948,2295,69,2226,2011,t1,cantonales
1655,19,CORREZE,8673,4662,242,4420,2011,t1,cantonales
1656,19,CORREZE,2049,1472,101,1371,2011,t1,cantonales
1657,19,CORREZE,4326,2916,163,2753,2011,t1,cantonales
1658,19,CORREZE,1593,1194,43,1151,2011,t1,cantonales
1659,19,CORREZE,9067,4889,154,4735,2011,t1,cantonales
1660,19,CORREZE,3099,2132,80,2052,2011,t1,cantonales
1661,19,CORREZE,2832,2201,50,2151,2011,t1,cantonales
1662,19,CORREZE,4171,3206,124,3082,2011,t1,cantonales
1663,19,CORREZE,5061,2826,143,2683,2011,t1,cantonales
1664,19,CORREZE,5426,3529,143,3386,2011,t1,cantonales
1665,19,CORREZE,5899,2322,91,2231,2011,t1,cantonales
1666,19,CORREZE,7219,2650,180,2470,2011,t1,cantonales
1667,19,CORREZE,11511,5574,347,5227,2011,t1,cantonales
1668,19,CORREZE,4523,2498,164,2334,2011,t1,cantonales
1669,2A,CORSE SUD,6471,3332,105,3227,2011,t1,cantonales
1670,2A,CORSE SUD,2810,1961,45,1916,2011,t1,cantonales
1671,2A,CORSE SUD,2343,1600,95,1505,2011,t1,cantonales
1672,2A,CORSE SUD,3252,2013,88,1925,2011,t1,cantonales
1673,2A,CORSE SUD,4077,2182,106,2076,2011,t1,cantonales
1674,2A,CORSE SUD,2737,2070,22,2048,2011,t1,cantonales
1675,2A,CORSE SUD,10646,6879,174,6705,2011,t1,cantonales
1676,2A,CORSE SUD,1880,982,77,905,2011,t1,cantonales
1677,2A,CORSE SUD,4285,2164,72,2092,2011,t1,cantonales
1678,2A,CORSE SUD,3148,1706,37,1669,2011,t1,cantonales
1679,2A,CORSE SUD,4292,2632,53,2579,2011,t1,cantonales
1680,2B,HAUTE CORSE,3140,1953,51,1902,2011,t1,cantonales
1681,2B,HAUTE CORSE,3500,2376,36,2340,2011,t1,cantonales
1682,2B,HAUTE CORSE,3533,2381,43,2338,2011,t1,cantonales
1683,2B,HAUTE CORSE,2896,2073,43,2030,2011,t1,cantonales
1684,2B,HAUTE CORSE,2784,2174,91,2083,2011,t1,cantonales
1685,2B,HAUTE CORSE,5235,2816,198,2618,2011,t1,cantonales
1686,2B,HAUTE CORSE,3694,2244,221,2023,2011,t1,cantonales
1687,2B,HAUTE CORSE,4984,3200,120,3080,2011,t1,cantonales
1688,2B,HAUTE CORSE,3096,2195,64,2131,2011,t1,cantonales
1689,2B,HAUTE CORSE,4108,3199,30,3169,2011,t1,cantonales
1690,2B,HAUTE CORSE,5872,4427,34,4393,2011,t1,cantonales
1691,2B,HAUTE CORSE,2852,1973,37,1936,2011,t1,cantonales
1692,2B,HAUTE CORSE,1944,1389,56,1333,2011,t1,cantonales
1693,2B,HAUTE CORSE,1438,870,25,845,2011,t1,cantonales
1694,21,COTE D'OR,1360,870,38,832,2011,t1,cantonales
1695,21,COTE D'OR,4066,2448,56,2392,2011,t1,cantonales
1696,21,COTE D'OR,9922,4593,95,4498,2011,t1,cantonales
1697,21,COTE D'OR,11399,4521,94,4427,2011,t1,cantonales
1698,21,COTE D'OR,2427,1411,31,1380,2011,t1,cantonales
1699,21,COTE D'OR,10361,3838,83,3755,2011,t1,cantonales
1700,21,COTE D'OR,11351,5817,101,5716,2011,t1,cantonales
1701,21,COTE D'OR,969,745,30,715,2011,t1,cantonales
1702,21,COTE D'OR,9299,4865,55,4810,2011,t1,cantonales
1703,21,COTE D'OR,6322,3438,81,3357,2011,t1,cantonales
1704,21,COTE D'OR,8192,4233,134,4099,2011,t1,cantonales
1705,21,COTE D'OR,2138,1363,25,1338,2011,t1,cantonales
1706,21,COTE D'OR,11083,5220,105,5115,2011,t1,cantonales
1707,21,COTE D'OR,5756,3040,60,2980,2011,t1,cantonales
1708,21,COTE D'OR,7827,3463,80,3383,2011,t1,cantonales
1709,21,COTE D'OR,2547,1566,51,1515,2011,t1,cantonales
1710,21,COTE D'OR,2867,1666,30,1636,2011,t1,cantonales
1711,21,COTE D'OR,2853,1850,58,1792,2011,t1,cantonales
1712,21,COTE D'OR,16126,6690,141,6549,2011,t1,cantonales
1713,21,COTE D'OR,13385,6400,126,6274,2011,t1,cantonales
1714,21,COTE D'OR,23326,10294,303,9991,2011,t1,cantonales
1715,22,COTES D'ARMOR,3470,2019,104,1915,2011,t1,cantonales
1716,22,COTES D'ARMOR,6319,3611,91,3520,2011,t1,cantonales
1717,22,COTES D'ARMOR,6345,4005,83,3922,2011,t1,cantonales
1718,22,COTES D'ARMOR,2286,1653,34,1619,2011,t1,cantonales
1719,22,COTES D'ARMOR,19139,8279,344,7935,2011,t1,cantonales
1720,22,COTES D'ARMOR,11916,5876,127,5749,2011,t1,cantonales
1721,22,COTES D'ARMOR,4717,2875,98,2777,2011,t1,cantonales
1722,22,COTES D'ARMOR,6097,3576,140,3436,2011,t1,cantonales
1723,22,COTES D'ARMOR,11692,7087,142,6945,2011,t1,cantonales
1724,22,COTES D'ARMOR,4044,2546,149,2397,2011,t1,cantonales
1725,22,COTES D'ARMOR,11436,5522,878,4644,2011,t1,cantonales
1726,22,COTES D'ARMOR,9406,4642,189,4453,2011,t1,cantonales
1727,22,COTES D'ARMOR,15477,7278,178,7100,2011,t1,cantonales
1728,22,COTES D'ARMOR,22891,10919,314,10605,2011,t1,cantonales
1729,22,COTES D'ARMOR,4084,2521,81,2440,2011,t1,cantonales
1730,22,COTES D'ARMOR,8104,4782,116,4666,2011,t1,cantonales
1731,22,COTES D'ARMOR,4995,2883,108,2775,2011,t1,cantonales
1732,22,COTES D'ARMOR,7962,4219,122,4097,2011,t1,cantonales
1733,22,COTES D'ARMOR,5759,3130,91,3039,2011,t1,cantonales
1734,22,COTES D'ARMOR,4974,3294,64,3230,2011,t1,cantonales
1735,22,COTES D'ARMOR,4893,2484,330,2154,2011,t1,cantonales
1736,22,COTES D'ARMOR,6331,3952,79,3873,2011,t1,cantonales
1737,22,COTES D'ARMOR,2989,1927,99,1828,2011,t1,cantonales
1738,22,COTES D'ARMOR,17990,7580,459,7121,2011,t1,cantonales
1739,22,COTES D'ARMOR,15581,7549,337,7212,2011,t1,cantonales
1740,22,COTES D'ARMOR,11643,4890,83,4807,2011,t1,cantonales
1741,23,CREUSE,3498,2121,97,2024,2011,t1,cantonales
1742,23,CREUSE,5105,2572,185,2387,2011,t1,cantonales
1743,23,CREUSE,2978,1950,74,1876,2011,t1,cantonales
1744,23,CREUSE,2268,1342,91,1251,2011,t1,cantonales
1745,23,CREUSE,4281,2194,145,2049,2011,t1,cantonales
1746,23,CREUSE,4401,2580,131,2449,2011,t1,cantonales
1747,23,CREUSE,2954,1922,69,1853,2011,t1,cantonales
1748,23,CREUSE,3115,1993,78,1915,2011,t1,cantonales
1749,23,CREUSE,1279,812,84,728,2011,t1,cantonales
1750,23,CREUSE,3240,1907,68,1839,2011,t1,cantonales
1751,23,CREUSE,1604,996,45,951,2011,t1,cantonales
1752,23,CREUSE,1792,1095,73,1022,2011,t1,cantonales
1753,23,CREUSE,5501,2594,205,2389,2011,t1,cantonales
1754,24,DORDOGNE,2768,1974,94,1880,2011,t1,cantonales
1755,24,DORDOGNE,15087,7110,143,6967,2011,t1,cantonales
1756,24,DORDOGNE,5800,3078,203,2875,2011,t1,cantonales
1757,24,DORDOGNE,3723,2428,45,2383,2011,t1,cantonales
1758,24,DORDOGNE,2884,1803,93,1710,2011,t1,cantonales
1759,24,DORDOGNE,2999,1935,66,1869,2011,t1,cantonales
1760,24,DORDOGNE,3295,2541,77,2464,2011,t1,cantonales
1761,24,DORDOGNE,3792,2325,120,2205,2011,t1,cantonales
1762,24,DORDOGNE,9265,4782,133,4649,2011,t1,cantonales
1763,24,DORDOGNE,6418,3851,89,3762,2011,t1,cantonales
1764,24,DORDOGNE,4393,2849,153,2696,2011,t1,cantonales
1765,24,DORDOGNE,3849,2495,120,2375,2011,t1,cantonales
1766,24,DORDOGNE,7175,4370,143,4227,2011,t1,cantonales
1767,24,DORDOGNE,8187,4541,207,4334,2011,t1,cantonales
1768,24,DORDOGNE,6847,4323,163,4160,2011,t1,cantonales
1769,24,DORDOGNE,3139,2275,64,2211,2011,t1,cantonales
1770,24,DORDOGNE,12491,6469,169,6300,2011,t1,cantonales
1771,24,DORDOGNE,7262,4421,161,4260,2011,t1,cantonales
1772,24,DORDOGNE,7180,3704,116,3588,2011,t1,cantonales
1773,24,DORDOGNE,4672,2795,98,2697,2011,t1,cantonales
1774,24,DORDOGNE,3493,2405,73,2332,2011,t1,cantonales
1775,24,DORDOGNE,3681,2462,43,2419,2011,t1,cantonales
1776,24,DORDOGNE,1877,1343,49,1294,2011,t1,cantonales
1777,24,DORDOGNE,12070,6009,190,5819,2011,t1,cantonales
1778,24,DORDOGNE,12282,5761,243,5518,2011,t1,cantonales
1779,24,DORDOGNE,15034,6888,218,6670,2011,t1,cantonales
1780,25,DOUBS,14667,5920,188,5732,2011,t1,cantonales
1781,25,DOUBS,4912,2933,107,2826,2011,t1,cantonales
1782,25,DOUBS,13376,6160,356,5804,2011,t1,cantonales
1783,25,DOUBS,6148,3042,82,2960,2011,t1,cantonales
1784,25,DOUBS,8595,5082,146,4936,2011,t1,cantonales
1785,25,DOUBS,5584,3201,160,3041,2011,t1,cantonales
1786,25,DOUBS,22546,10454,290,10164,2011,t1,cantonales
1787,25,DOUBS,11048,5966,134,5832,2011,t1,cantonales
1788,25,DOUBS,6764,3828,101,3727,2011,t1,cantonales
1789,25,DOUBS,3249,1966,46,1920,2011,t1,cantonales
1790,25,DOUBS,6435,3540,100,3440,2011,t1,cantonales
1791,25,DOUBS,4902,3198,175,3023,2011,t1,cantonales
1792,25,DOUBS,3563,2197,79,2118,2011,t1,cantonales
1793,25,DOUBS,8406,4804,118,4686,2011,t1,cantonales
1794,25,DOUBS,13083,5153,83,5070,2011,t1,cantonales
1795,25,DOUBS,12789,6022,192,5830,2011,t1,cantonales
1796,25,DOUBS,8765,2862,92,2770,2011,t1,cantonales
1797,25,DOUBS,9543,4561,78,4483,2011,t1,cantonales
1798,26,DROME,22047,10164,164,10000,2011,t1,cantonales
1799,26,DROME,16489,7480,116,7364,2011,t1,cantonales
1800,26,DROME,1815,1052,94,958,2011,t1,cantonales
1801,26,DROME,4988,2620,114,2506,2011,t1,cantonales
1802,26,DROME,6120,3541,78,3463,2011,t1,cantonales
1803,26,DROME,6151,3355,84,3271,2011,t1,cantonales
1804,26,DROME,1588,1019,30,989,2011,t1,cantonales
1805,26,DROME,14231,5707,133,5574,2011,t1,cantonales
1806,26,DROME,929,659,28,631,2011,t1,cantonales
1807,26,DROME,10331,5429,87,5342,2011,t1,cantonales
1808,26,DROME,13911,6400,152,6248,2011,t1,cantonales
1809,26,DROME,1274,841,79,762,2011,t1,cantonales
1810,26,DROME,5257,2934,49,2885,2011,t1,cantonales
1811,26,DROME,15723,7364,124,7240,2011,t1,cantonales
1812,26,DROME,9552,4515,75,4440,2011,t1,cantonales
1813,26,DROME,17466,7991,139,7852,2011,t1,cantonales
1814,26,DROME,19186,8509,182,8327,2011,t1,cantonales
1815,26,DROME,8875,3611,87,3524,2011,t1,cantonales
1816,27,EURE,11514,5570,110,5460,2011,t1,cantonales
1817,27,EURE,13219,6003,155,5848,2011,t1,cantonales
1818,27,EURE,3875,2017,74,1943,2011,t1,cantonales
1819,27,EURE,9487,4391,147,4244,2011,t1,cantonales
1820,27,EURE,6596,3012,69,2943,2011,t1,cantonales
1821,27,EURE,8434,3767,121,3646,2011,t1,cantonales
1822,27,EURE,10320,4877,112,4765,2011,t1,cantonales
1823,27,EURE,6629,3232,62,3170,2011,t1,cantonales
1824,27,EURE,12043,5518,122,5396,2011,t1,cantonales
1825,27,EURE,3897,2040,80,1960,2011,t1,cantonales
1826,27,EURE,5638,2504,85,2419,2011,t1,cantonales
1827,27,EURE,10614,4893,65,4828,2011,t1,cantonales
1828,27,EURE,7837,3724,86,3638,2011,t1,cantonales
1829,27,EURE,17925,6875,209,6666,2011,t1,cantonales
1830,27,EURE,7119,2811,48,2763,2011,t1,cantonales
1831,27,EURE,9733,3604,100,3504,2011,t1,cantonales
1832,27,EURE,5721,2890,58,2832,2011,t1,cantonales
1833,27,EURE,8505,3301,63,3238,2011,t1,cantonales
1834,27,EURE,11915,5432,102,5330,2011,t1,cantonales
1835,27,EURE,10655,5425,105,5320,2011,t1,cantonales
1836,27,EURE,13026,5121,111,5010,2011,t1,cantonales
1837,27,EURE,7711,3670,74,3596,2011,t1,cantonales
1838,28,EURE ET LOIR,7264,3891,65,3826,2011,t1,cantonales
1839,28,EURE ET LOIR,13694,6012,145,5867,2011,t1,cantonales
1840,28,EURE ET LOIR,15769,7478,244,7234,2011,t1,cantonales
1841,28,EURE ET LOIR,7255,3424,74,3350,2011,t1,cantonales
1842,28,EURE ET LOIR,1807,892,22,870,2011,t1,cantonales
1843,28,EURE ET LOIR,7730,3592,84,3508,2011,t1,cantonales
1844,28,EURE ET LOIR,6570,3579,85,3494,2011,t1,cantonales
1845,28,EURE ET LOIR,22450,8665,257,8408,2011,t1,cantonales
1846,28,EURE ET LOIR,10970,5096,132,4964,2011,t1,cantonales
1847,28,EURE ET LOIR,3973,2300,69,2231,2011,t1,cantonales
1848,28,EURE ET LOIR,4255,2300,45,2255,2011,t1,cantonales
1849,28,EURE ET LOIR,22232,8967,212,8755,2011,t1,cantonales
1850,28,EURE ET LOIR,12502,4370,114,4256,2011,t1,cantonales
1851,28,EURE ET LOIR,13592,5486,99,5387,2011,t1,cantonales
1852,29,FINISTERE,4411,2254,70,2184,2011,t1,cantonales
1853,29,FINISTERE,7924,3278,339,2939,2011,t1,cantonales
1854,29,FINISTERE,12866,5089,154,4935,2011,t1,cantonales
1855,29,FINISTERE,8909,2941,109,2832,2011,t1,cantonales
1856,29,FINISTERE,12169,6789,147,6642,2011,t1,cantonales
1857,29,FINISTERE,22527,8724,270,8454,2011,t1,cantonales
1858,29,FINISTERE,14221,6855,177,6678,2011,t1,cantonales
1859,29,FINISTERE,21288,9248,215,9033,2011,t1,cantonales
1860,29,FINISTERE,22474,10386,285,10101,2011,t1,cantonales
1861,29,FINISTERE,10252,5018,161,4857,2011,t1,cantonales
1862,29,FINISTERE,13612,6237,145,6092,2011,t1,cantonales
1863,29,FINISTERE,14586,6357,231,6126,2011,t1,cantonales
1864,29,FINISTERE,6642,3564,105,3459,2011,t1,cantonales
1865,29,FINISTERE,13988,6504,152,6352,2011,t1,cantonales
1866,29,FINISTERE,7123,3347,148,3199,2011,t1,cantonales
1867,29,FINISTERE,7595,3696,109,3587,2011,t1,cantonales
1868,29,FINISTERE,14249,7061,149,6912,2011,t1,cantonales
1869,29,FINISTERE,15275,6943,246,6697,2011,t1,cantonales
1870,29,FINISTERE,10689,4648,382,4266,2011,t1,cantonales
1871,29,FINISTERE,15734,7083,129,6954,2011,t1,cantonales
1872,29,FINISTERE,5814,2444,211,2233,2011,t1,cantonales
1873,29,FINISTERE,14072,5918,182,5736,2011,t1,cantonales
1874,29,FINISTERE,11701,4511,161,4350,2011,t1,cantonales
1875,29,FINISTERE,9175,2838,98,2740,2011,t1,cantonales
1876,29,FINISTERE,15684,7436,291,7145,2011,t1,cantonales
1877,29,FINISTERE,9421,2642,90,2552,2011,t1,cantonales
1878,29,FINISTERE,14009,5003,142,4861,2011,t1,cantonales
1879,29,FINISTERE,9219,3210,90,3120,2011,t1,cantonales
1880,30,GARD,16134,8638,168,8470,2011,t1,cantonales
1881,30,GARD,15272,6465,148,6317,2011,t1,cantonales
1882,30,GARD,18889,8021,206,7815,2011,t1,cantonales
1883,30,GARD,1026,661,42,619,2011,t1,cantonales
1884,30,GARD,3181,2231,48,2183,2011,t1,cantonales
1885,30,GARD,4338,2450,65,2385,2011,t1,cantonales
1886,30,GARD,5221,2710,100,2610,2011,t1,cantonales
1887,30,GARD,14714,5610,104,5506,2011,t1,cantonales
1888,30,GARD,14807,7408,329,7079,2011,t1,cantonales
1889,30,GARD,16373,7765,212,7553,2011,t1,cantonales
1890,30,GARD,1090,811,14,797,2011,t1,cantonales
1891,30,GARD,10467,5483,92,5391,2011,t1,cantonales
1892,30,GARD,2815,1555,70,1485,2011,t1,cantonales
1893,30,GARD,11644,5382,175,5207,2011,t1,cantonales
1894,30,GARD,19992,8732,170,8562,2011,t1,cantonales
1895,30,GARD,2415,1313,60,1253,2011,t1,cantonales
1896,30,GARD,1125,794,17,777,2011,t1,cantonales
1897,30,GARD,15337,7537,120,7417,2011,t1,cantonales
1898,30,GARD,14538,7083,107,6976,2011,t1,cantonales
1899,30,GARD,6689,3548,81,3467,2011,t1,cantonales
1900,30,GARD,6774,4057,70,3987,2011,t1,cantonales
1901,30,GARD,10023,3879,63,3816,2011,t1,cantonales
1902,30,GARD,9590,3790,60,3730,2011,t1,cantonales
1903,31,HAUTE GARONNE,3350,2024,107,1917,2011,t1,cantonales
1904,31,HAUTE GARONNE,5281,3127,105,3022,2011,t1,cantonales
1905,31,HAUTE GARONNE,4074,2787,107,2680,2011,t1,cantonales
1906,31,HAUTE GARONNE,3650,2170,76,2094,2011,t1,cantonales
1907,31,HAUTE GARONNE,29118,14360,365,13995,2011,t1,cantonales
1908,31,HAUTE GARONNE,8942,4825,103,4722,2011,t1,cantonales
1909,31,HAUTE GARONNE,4305,2692,48,2644,2011,t1,cantonales
1910,31,HAUTE GARONNE,28833,12520,352,12168,2011,t1,cantonales
1911,31,HAUTE GARONNE,3787,2778,60,2718,2011,t1,cantonales
1912,31,HAUTE GARONNE,6797,3611,194,3417,2011,t1,cantonales
1913,31,HAUTE GARONNE,12921,6038,121,5917,2011,t1,cantonales
1914,31,HAUTE GARONNE,33744,14211,333,13878,2011,t1,cantonales
1915,31,HAUTE GARONNE,10133,5613,104,5509,2011,t1,cantonales
1916,31,HAUTE GARONNE,6894,3749,81,3668,2011,t1,cantonales
1917,31,HAUTE GARONNE,3856,2085,82,2003,2011,t1,cantonales
1918,31,HAUTE GARONNE,16182,8425,169,8256,2011,t1,cantonales
1919,31,HAUTE GARONNE,2911,1683,46,1637,2011,t1,cantonales
1920,31,HAUTE GARONNE,17238,5499,66,5433,2011,t1,cantonales
1921,31,HAUTE GARONNE,23531,8107,103,8004,2011,t1,cantonales
1922,31,HAUTE GARONNE,19595,6752,94,6658,2011,t1,cantonales
1923,31,HAUTE GARONNE,9636,5637,159,5478,2011,t1,cantonales
1924,31,HAUTE GARONNE,18617,6062,109,5953,2011,t1,cantonales
1925,31,HAUTE GARONNE,23755,7241,154,7087,2011,t1,cantonales
1926,31,HAUTE GARONNE,28964,12481,323,12158,2011,t1,cantonales
1927,31,HAUTE GARONNE,36277,14102,320,13782,2011,t1,cantonales
1928,31,HAUTE GARONNE,24571,10482,196,10286,2011,t1,cantonales
1929,31,HAUTE GARONNE,36135,15575,289,15286,2011,t1,cantonales
1930,32,GERS,5342,2349,98,2251,2011,t1,cantonales
1931,32,GERS,3753,2209,122,2087,2011,t1,cantonales
1932,32,GERS,2629,1512,59,1453,2011,t1,cantonales
1933,32,GERS,8039,4332,191,4141,2011,t1,cantonales
1934,32,GERS,2820,1691,74,1617,2011,t1,cantonales
1935,32,GERS,4347,2717,105,2612,2011,t1,cantonales
1936,32,GERS,3541,2448,61,2387,2011,t1,cantonales
1937,32,GERS,3771,2111,136,1975,2011,t1,cantonales
1938,32,GERS,1623,1098,32,1066,2011,t1,cantonales
1939,32,GERS,3859,2425,68,2357,2011,t1,cantonales
1940,32,GERS,3307,2205,70,2135,2011,t1,cantonales
1941,32,GERS,5475,2757,508,2249,2011,t1,cantonales
1942,32,GERS,2179,1571,61,1510,2011,t1,cantonales
1943,32,GERS,2464,1461,141,1320,2011,t1,cantonales
1944,32,GERS,3574,2011,125,1886,2011,t1,cantonales
1945,32,GERS,7054,3172,187,2985,2011,t1,cantonales
1946,33,GIRONDE,10273,5035,65,4970,2011,t1,cantonales
1947,33,GIRONDE,45422,18860,414,18446,2011,t1,cantonales
1948,33,GIRONDE,4127,2595,93,2502,2011,t1,cantonales
1949,33,GIRONDE,11122,5523,187,5336,2011,t1,cantonales
1950,33,GIRONDE,15323,5211,79,5132,2011,t1,cantonales
1951,33,GIRONDE,14314,4892,98,4794,2011,t1,cantonales
1952,33,GIRONDE,9377,4341,119,4222,2011,t1,cantonales
1953,33,GIRONDE,10391,4841,116,4725,2011,t1,cantonales
1954,33,GIRONDE,8973,4426,119,4307,2011,t1,cantonales
1955,33,GIRONDE,1660,1173,27,1146,2011,t1,cantonales
1956,33,GIRONDE,27156,10888,224,10664,2011,t1,cantonales
1957,33,GIRONDE,23450,10330,277,10053,2011,t1,cantonales
1958,33,GIRONDE,11334,4931,116,4815,2011,t1,cantonales
1959,33,GIRONDE,27338,12046,267,11779,2011,t1,cantonales
1960,33,GIRONDE,27464,11048,271,10777,2011,t1,cantonales
1961,33,GIRONDE,3445,1946,48,1898,2011,t1,cantonales
1962,33,GIRONDE,8386,3983,95,3888,2011,t1,cantonales
1963,33,GIRONDE,18446,6709,199,6510,2011,t1,cantonales
1964,33,GIRONDE,5685,3091,71,3020,2011,t1,cantonales
1965,33,GIRONDE,9158,4834,216,4618,2011,t1,cantonales
1966,33,GIRONDE,7359,3857,179,3678,2011,t1,cantonales
1967,33,GIRONDE,6564,3311,70,3241,2011,t1,cantonales
1968,33,GIRONDE,3464,2006,48,1958,2011,t1,cantonales
1969,33,GIRONDE,4916,3047,65,2982,2011,t1,cantonales
1970,33,GIRONDE,3564,2004,50,1954,2011,t1,cantonales
1971,33,GIRONDE,16668,6548,218,6330,2011,t1,cantonales
1972,33,GIRONDE,27609,10140,282,9858,2011,t1,cantonales
1973,33,GIRONDE,22654,8745,177,8568,2011,t1,cantonales
1974,33,GIRONDE,20349,8053,219,7834,2011,t1,cantonales
1975,33,GIRONDE,16514,5723,88,5635,2011,t1,cantonales
1976,33,GIRONDE,29142,11392,261,11131,2011,t1,cantonales
1977,34,HERAULT,14230,6364,211,6153,2011,t1,cantonales
1978,34,HERAULT,34138,15999,293,15706,2011,t1,cantonales
1979,34,HERAULT,1122,695,95,600,2011,t1,cantonales
1980,34,HERAULT,15244,7008,191,6817,2011,t1,cantonales
1981,34,HERAULT,8051,4419,129,4290,2011,t1,cantonales
1982,34,HERAULT,32543,14593,382,14211,2011,t1,cantonales
1983,34,HERAULT,24839,11808,252,11556,2011,t1,cantonales
1984,34,HERAULT,27820,11833,231,11602,2011,t1,cantonales
1985,34,HERAULT,16898,6063,112,5951,2011,t1,cantonales
1986,34,HERAULT,8839,4501,141,4360,2011,t1,cantonales
1987,34,HERAULT,3619,2165,77,2088,2011,t1,cantonales
1988,34,HERAULT,11479,5602,150,5452,2011,t1,cantonales
1989,34,HERAULT,6003,3428,127,3301,2011,t1,cantonales
1990,34,HERAULT,6314,3743,74,3669,2011,t1,cantonales
1991,34,HERAULT,1450,1113,19,1094,2011,t1,cantonales
1992,34,HERAULT,10016,4834,130,4704,2011,t1,cantonales
1993,34,HERAULT,15493,8036,203,7833,2011,t1,cantonales
1994,34,HERAULT,21393,9008,204,8804,2011,t1,cantonales
1995,34,HERAULT,26656,10515,321,10194,2011,t1,cantonales
1996,34,HERAULT,9922,3610,99,3511,2011,t1,cantonales
1997,34,HERAULT,13935,4258,104,4154,2011,t1,cantonales
1998,34,HERAULT,12805,4138,141,3997,2011,t1,cantonales
1999,34,HERAULT,25581,8878,257,8621,2011,t1,cantonales
2000,34,HERAULT,18505,7840,160,7680,2011,t1,cantonales
2001,34,HERAULT,24779,10171,247,9924,2011,t1,cantonales
2002,34,HERAULT,22360,10549,198,10351,2011,t1,cantonales
2003,35,ILLE ET VILAINE,14413,6063,250,5813,2011,t1,cantonales
2004,35,ILLE ET VILAINE,7873,4138,126,4012,2011,t1,cantonales
2005,35,ILLE ET VILAINE,13066,5445,155,5290,2011,t1,cantonales
2006,35,ILLE ET VILAINE,9589,4002,139,3863,2011,t1,cantonales
2007,35,ILLE ET VILAINE,10229,4887,172,4715,2011,t1,cantonales
2008,35,ILLE ET VILAINE,14065,6029,217,5812,2011,t1,cantonales
2009,35,ILLE ET VILAINE,3600,1911,89,1822,2011,t1,cantonales
2010,35,ILLE ET VILAINE,9672,4231,466,3765,2011,t1,cantonales
2011,35,ILLE ET VILAINE,18009,7839,455,7384,2011,t1,cantonales
2012,35,ILLE ET VILAINE,6507,3520,105,3415,2011,t1,cantonales
2013,35,ILLE ET VILAINE,9750,4120,112,4008,2011,t1,cantonales
2014,35,ILLE ET VILAINE,5949,3293,151,3142,2011,t1,cantonales
2015,35,ILLE ET VILAINE,11457,5567,157,5410,2011,t1,cantonales
2016,35,ILLE ET VILAINE,10614,3813,67,3746,2011,t1,cantonales
2017,35,ILLE ET VILAINE,12643,4460,92,4368,2011,t1,cantonales
2018,35,ILLE ET VILAINE,13539,5152,95,5057,2011,t1,cantonales
2019,35,ILLE ET VILAINE,9226,4024,88,3936,2011,t1,cantonales
2020,35,ILLE ET VILAINE,17588,7104,316,6788,2011,t1,cantonales
2021,35,ILLE ET VILAINE,8580,4622,231,4391,2011,t1,cantonales
2022,35,ILLE ET VILAINE,18867,7417,214,7203,2011,t1,cantonales
2023,35,ILLE ET VILAINE,4458,1993,92,1901,2011,t1,cantonales
2024,35,ILLE ET VILAINE,10576,4475,187,4288,2011,t1,cantonales
2025,35,ILLE ET VILAINE,9705,3553,99,3454,2011,t1,cantonales
2026,35,ILLE ET VILAINE,25342,10173,278,9895,2011,t1,cantonales
2027,35,ILLE ET VILAINE,30464,11636,486,11150,2011,t1,cantonales
2028,35,ILLE ET VILAINE,11201,3683,86,3597,2011,t1,cantonales
2029,35,ILLE ET VILAINE,17049,7554,215,7339,2011,t1,cantonales
2030,36,INDRE,5042,2855,104,2751,2011,t1,cantonales
2031,36,INDRE,9816,5388,133,5255,2011,t1,cantonales
2032,36,INDRE,2929,1751,68,1683,2011,t1,cantonales
2033,36,INDRE,3530,2279,80,2199,2011,t1,cantonales
2034,36,INDRE,9500,4497,98,4399,2011,t1,cantonales
2035,36,INDRE,2855,1783,70,1713,2011,t1,cantonales
2036,36,INDRE,5120,2821,79,2742,2011,t1,cantonales
2037,36,INDRE,3530,1870,67,1803,2011,t1,cantonales
2038,36,INDRE,2796,1595,97,1498,2011,t1,cantonales
2039,36,INDRE,3738,2258,68,2190,2011,t1,cantonales
2040,36,INDRE,6576,3881,145,3736,2011,t1,cantonales
2041,36,INDRE,12648,5267,133,5134,2011,t1,cantonales
2042,36,INDRE,10897,4548,158,4390,2011,t1,cantonales
2043,37,INDRE ET LOIRE,10255,4915,108,4807,2011,t1,cantonales
2044,37,INDRE ET LOIRE,17144,8198,205,7993,2011,t1,cantonales
2045,37,INDRE ET LOIRE,8973,4337,145,4192,2011,t1,cantonales
2046,37,INDRE ET LOIRE,7405,3660,89,3571,2011,t1,cantonales
2047,37,INDRE ET LOIRE,3248,2003,54,1949,2011,t1,cantonales
2048,37,INDRE ET LOIRE,5841,3280,64,3216,2011,t1,cantonales
2049,37,INDRE ET LOIRE,5682,3342,101,3241,2011,t1,cantonales
2050,37,INDRE ET LOIRE,17549,7902,160,7742,2011,t1,cantonales
2051,37,INDRE ET LOIRE,4287,2558,72,2486,2011,t1,cantonales
2052,37,INDRE ET LOIRE,4644,2261,85,2176,2011,t1,cantonales
2053,37,INDRE ET LOIRE,6460,3243,231,3012,2011,t1,cantonales
2054,37,INDRE ET LOIRE,11526,4423,140,4283,2011,t1,cantonales
2055,37,INDRE ET LOIRE,9745,3580,80,3500,2011,t1,cantonales
2056,37,INDRE ET LOIRE,10711,3215,100,3115,2011,t1,cantonales
2057,37,INDRE ET LOIRE,11326,4115,154,3961,2011,t1,cantonales
2058,37,INDRE ET LOIRE,10747,4098,235,3863,2011,t1,cantonales
2059,37,INDRE ET LOIRE,11676,4732,77,4655,2011,t1,cantonales
2060,37,INDRE ET LOIRE,16337,7290,178,7112,2011,t1,cantonales
2061,37,INDRE ET LOIRE,16151,7209,163,7046,2011,t1,cantonales
2062,38,ISERE,9342,3582,98,3484,2011,t1,cantonales
2063,38,ISERE,16231,6193,114,6079,2011,t1,cantonales
2064,38,ISERE,1758,1132,19,1113,2011,t1,cantonales
2065,38,ISERE,1927,1299,21,1278,2011,t1,cantonales
2066,38,ISERE,21438,8955,116,8839,2011,t1,cantonales
2067,38,ISERE,10788,5062,77,4985,2011,t1,cantonales
2068,38,ISERE,16855,5886,71,5815,2011,t1,cantonales
2069,38,ISERE,13251,4833,66,4767,2011,t1,cantonales
2070,38,ISERE,14960,6158,108,6050,2011,t1,cantonales
2071,38,ISERE,2775,1772,17,1755,2011,t1,cantonales
2072,38,ISERE,3632,2229,34,2195,2011,t1,cantonales
2073,38,ISERE,19236,7684,124,7560,2011,t1,cantonales
2074,38,ISERE,10638,4916,92,4824,2011,t1,cantonales
2075,38,ISERE,32946,13218,233,12985,2011,t1,cantonales
2076,38,ISERE,7048,2995,47,2948,2011,t1,cantonales
2077,38,ISERE,11589,5842,100,5742,2011,t1,cantonales
2078,38,ISERE,16382,7928,138,7790,2011,t1,cantonales
2079,38,ISERE,18174,6842,104,6738,2011,t1,cantonales
2080,38,ISERE,9005,4339,80,4259,2011,t1,cantonales
2081,38,ISERE,1908,920,161,759,2011,t1,cantonales
2082,38,ISERE,11976,4885,93,4792,2011,t1,cantonales
2083,38,ISERE,21822,9433,186,9247,2011,t1,cantonales
2084,38,ISERE,9469,4756,52,4704,2011,t1,cantonales
2085,38,ISERE,6528,3367,70,3297,2011,t1,cantonales
2086,38,ISERE,32451,13047,277,12770,2011,t1,cantonales
2087,38,ISERE,8129,2952,35,2917,2011,t1,cantonales
2088,38,ISERE,19020,7175,121,7054,2011,t1,cantonales
2089,38,ISERE,10598,3937,101,3836,2011,t1,cantonales
2090,38,ISERE,11407,3357,86,3271,2011,t1,cantonales
2091,39,JURA,4821,2900,78,2822,2011,t1,cantonales
2092,39,JURA,3550,1990,63,1927,2011,t1,cantonales
2093,39,JURA,4778,2757,85,2672,2011,t1,cantonales
2094,39,JURA,2038,1278,43,1235,2011,t1,cantonales
2095,39,JURA,7650,4073,85,3988,2011,t1,cantonales
2096,39,JURA,3846,2361,88,2273,2011,t1,cantonales
2097,39,JURA,4680,2448,57,2391,2011,t1,cantonales
2098,39,JURA,13470,6356,184,6172,2011,t1,cantonales
2099,39,JURA,10225,4960,102,4858,2011,t1,cantonales
2100,39,JURA,4224,2485,58,2427,2011,t1,cantonales
2101,39,JURA,3527,2241,86,2155,2011,t1,cantonales
2102,39,JURA,2386,1548,36,1512,2011,t1,cantonales
2103,39,JURA,9929,4727,121,4606,2011,t1,cantonales
2104,39,JURA,2406,1645,66,1579,2011,t1,cantonales
2105,39,JURA,1755,977,31,946,2011,t1,cantonales
2106,39,JURA,2604,1515,44,1471,2011,t1,cantonales
2107,39,JURA,2869,1838,42,1796,2011,t1,cantonales
2108,40,LANDES,5732,3320,489,2831,2011,t1,cantonales
2109,40,LANDES,8459,4717,189,4528,2011,t1,cantonales
2110,40,LANDES,15861,6704,288,6416,2011,t1,cantonales
2111,40,LANDES,2854,1953,72,1881,2011,t1,cantonales
2112,40,LANDES,3587,2345,74,2271,2011,t1,cantonales
2113,40,LANDES,7708,5171,149,5022,2011,t1,cantonales
2114,40,LANDES,2508,1426,60,1366,2011,t1,cantonales
2115,40,LANDES,8939,4609,232,4377,2011,t1,cantonales
2116,40,LANDES,12940,5817,399,5418,2011,t1,cantonales
2117,40,LANDES,7349,4203,166,4037,2011,t1,cantonales
2118,40,LANDES,8687,4430,174,4256,2011,t1,cantonales
2119,40,LANDES,2707,1400,54,1346,2011,t1,cantonales
2120,40,LANDES,22628,9640,257,9383,2011,t1,cantonales
2121,40,LANDES,4310,2623,73,2550,2011,t1,cantonales
2122,40,LANDES,25034,11191,314,10877,2011,t1,cantonales
2123,41,LOIR ET CHER,9930,4361,99,4262,2011,t1,cantonales
2124,41,LOIR ET CHER,12936,5983,139,5844,2011,t1,cantonales
2125,41,LOIR ET CHER,4654,2534,42,2492,2011,t1,cantonales
2126,41,LOIR ET CHER,4626,2610,101,2509,2011,t1,cantonales
2127,41,LOIR ET CHER,7175,3931,158,3773,2011,t1,cantonales
2128,41,LOIR ET CHER,11803,6472,117,6355,2011,t1,cantonales
2129,41,LOIR ET CHER,4672,2334,56,2278,2011,t1,cantonales
2130,41,LOIR ET CHER,3957,2209,83,2126,2011,t1,cantonales
2131,41,LOIR ET CHER,9416,4371,106,4265,2011,t1,cantonales
2132,41,LOIR ET CHER,10950,5205,135,5070,2011,t1,cantonales
2133,41,LOIR ET CHER,4750,2538,74,2464,2011,t1,cantonales
2134,41,LOIR ET CHER,10216,3924,67,3857,2011,t1,cantonales
2135,41,LOIR ET CHER,5154,1443,28,1415,2011,t1,cantonales
2136,41,LOIR ET CHER,10987,5578,130,5448,2011,t1,cantonales
2137,41,LOIR ET CHER,6733,3088,101,2987,2011,t1,cantonales
2138,42,LOIRE,4264,2132,91,2041,2011,t1,cantonales
2139,42,LOIRE,5179,3006,56,2950,2011,t1,cantonales
2140,42,LOIRE,7569,3934,99,3835,2011,t1,cantonales
2141,42,LOIRE,18896,8635,162,8473,2011,t1,cantonales
2142,42,LOIRE,21372,10072,225,9847,2011,t1,cantonales
2143,42,LOIRE,3378,1880,34,1846,2011,t1,cantonales
2144,42,LOIRE,11642,5429,110,5319,2011,t1,cantonales
2145,42,LOIRE,17452,7371,114,7257,2011,t1,cantonales
2146,42,LOIRE,20139,8196,155,8041,2011,t1,cantonales
2147,42,LOIRE,6264,3493,62,3431,2011,t1,cantonales
2148,42,LOIRE,13509,5109,146,4963,2011,t1,cantonales
2149,42,LOIRE,12266,3905,68,3837,2011,t1,cantonales
2150,42,LOIRE,6521,3656,67,3589,2011,t1,cantonales
2151,42,LOIRE,3293,2071,72,1999,2011,t1,cantonales
2152,42,LOIRE,10111,4951,112,4839,2011,t1,cantonales
2153,42,LOIRE,21089,9876,139,9737,2011,t1,cantonales
2154,42,LOIRE,4007,2330,88,2242,2011,t1,cantonales
2155,42,LOIRE,13008,4757,47,4710,2011,t1,cantonales
2156,42,LOIRE,7087,2216,28,2188,2011,t1,cantonales
2157,42,LOIRE,10136,3438,38,3400,2011,t1,cantonales
2158,42,LOIRE,11042,4038,106,3932,2011,t1,cantonales
2159,43,HAUTE LOIRE,7276,3317,102,3215,2011,t1,cantonales
2160,43,HAUTE LOIRE,1828,1296,33,1263,2011,t1,cantonales
2161,43,HAUTE LOIRE,5769,2794,113,2681,2011,t1,cantonales
2162,43,HAUTE LOIRE,1652,961,56,905,2011,t1,cantonales
2163,43,HAUTE LOIRE,2211,1341,78,1263,2011,t1,cantonales
2164,43,HAUTE LOIRE,3859,2162,145,2017,2011,t1,cantonales
2165,43,HAUTE LOIRE,10366,5331,229,5102,2011,t1,cantonales
2166,43,HAUTE LOIRE,5603,3200,139,3061,2011,t1,cantonales
2167,43,HAUTE LOIRE,2623,1758,48,1710,2011,t1,cantonales
2168,43,HAUTE LOIRE,5698,3025,119,2906,2011,t1,cantonales
2169,43,HAUTE LOIRE,4134,2459,97,2362,2011,t1,cantonales
2170,43,HAUTE LOIRE,3586,2383,58,2325,2011,t1,cantonales
2171,43,HAUTE LOIRE,4470,2736,118,2618,2011,t1,cantonales
2172,43,HAUTE LOIRE,7067,3612,101,3511,2011,t1,cantonales
2173,43,HAUTE LOIRE,8242,3808,94,3714,2011,t1,cantonales
2174,43,HAUTE LOIRE,5093,2222,48,2174,2011,t1,cantonales
2175,43,HAUTE LOIRE,6494,3096,120,2976,2011,t1,cantonales
2176,44,LOIRE ATLANTIQUE,17076,7557,228,7329,2011,t1,cantonales
2177,44,LOIRE ATLANTIQUE,17944,8337,296,8041,2011,t1,cantonales
2178,44,LOIRE ATLANTIQUE,13212,5741,243,5498,2011,t1,cantonales
2179,44,LOIRE ATLANTIQUE,30670,12638,383,12255,2011,t1,cantonales
2180,44,LOIRE ATLANTIQUE,16671,7545,179,7366,2011,t1,cantonales
2181,44,LOIRE ATLANTIQUE,6425,3026,129,2897,2011,t1,cantonales
2182,44,LOIRE ATLANTIQUE,6739,3887,92,3795,2011,t1,cantonales
2183,44,LOIRE ATLANTIQUE,10858,4546,175,4371,2011,t1,cantonales
2184,44,LOIRE ATLANTIQUE,17804,8096,252,7844,2011,t1,cantonales
2185,44,LOIRE ATLANTIQUE,17057,6820,81,6739,2011,t1,cantonales
2186,44,LOIRE ATLANTIQUE,17668,5786,69,5717,2011,t1,cantonales
2187,44,LOIRE ATLANTIQUE,15850,5310,270,5040,2011,t1,cantonales
2188,44,LOIRE ATLANTIQUE,13175,4501,115,4386,2011,t1,cantonales
2189,44,LOIRE ATLANTIQUE,18000,8101,334,7767,2011,t1,cantonales
2190,44,LOIRE ATLANTIQUE,13100,6181,106,6075,2011,t1,cantonales
2191,44,LOIRE ATLANTIQUE,22274,10362,197,10165,2011,t1,cantonales
2192,44,LOIRE ATLANTIQUE,5577,2823,114,2709,2011,t1,cantonales
2193,44,LOIRE ATLANTIQUE,3235,1598,58,1540,2011,t1,cantonales
2194,44,LOIRE ATLANTIQUE,26573,10621,514,10107,2011,t1,cantonales
2195,44,LOIRE ATLANTIQUE,14069,4553,88,4465,2011,t1,cantonales
2196,44,LOIRE ATLANTIQUE,14231,6805,143,6662,2011,t1,cantonales
2197,44,LOIRE ATLANTIQUE,16241,7219,280,6939,2011,t1,cantonales
2198,44,LOIRE ATLANTIQUE,6388,3604,153,3451,2011,t1,cantonales
2199,44,LOIRE ATLANTIQUE,22202,10104,254,9850,2011,t1,cantonales
2200,44,LOIRE ATLANTIQUE,20335,7852,153,7699,2011,t1,cantonales
2201,44,LOIRE ATLANTIQUE,16723,5984,112,5872,2011,t1,cantonales
2202,44,LOIRE ATLANTIQUE,14924,5158,134,5024,2011,t1,cantonales
2203,44,LOIRE ATLANTIQUE,25495,11204,275,10929,2011,t1,cantonales
2204,44,LOIRE ATLANTIQUE,23910,9862,178,9684,2011,t1,cantonales
2205,44,LOIRE ATLANTIQUE,11380,4193,71,4122,2011,t1,cantonales
2206,45,LOIRET,6280,3117,93,3024,2011,t1,cantonales
2207,45,LOIRET,8550,4011,102,3909,2011,t1,cantonales
2208,45,LOIRET,14514,6626,173,6453,2011,t1,cantonales
2209,45,LOIRET,7619,3661,71,3590,2011,t1,cantonales
2210,45,LOIRET,5629,2974,33,2941,2011,t1,cantonales
2211,45,LOIRET,13120,5802,163,5639,2011,t1,cantonales
2212,45,LOIRET,6610,3496,89,3407,2011,t1,cantonales
2213,45,LOIRET,7695,3114,93,3021,2011,t1,cantonales
2214,45,LOIRET,13883,5912,146,5766,2011,t1,cantonales
2215,45,LOIRET,8967,3223,88,3135,2011,t1,cantonales
2216,45,LOIRET,9087,3582,48,3534,2011,t1,cantonales
2217,45,LOIRET,10466,4320,72,4248,2011,t1,cantonales
2218,45,LOIRET,4234,2195,82,2113,2011,t1,cantonales
2219,45,LOIRET,15610,6968,162,6806,2011,t1,cantonales
2220,45,LOIRET,5015,2316,52,2264,2011,t1,cantonales
2221,45,LOIRET,8292,4079,70,4009,2011,t1,cantonales
2222,45,LOIRET,13879,6322,150,6172,2011,t1,cantonales
2223,45,LOIRET,13770,5738,135,5603,2011,t1,cantonales
2224,45,LOIRET,14779,6117,155,5962,2011,t1,cantonales
2225,45,LOIRET,13658,6132,143,5989,2011,t1,cantonales
2226,46,LOT,5350,2415,157,2258,2011,t1,cantonales
2227,46,LOT,7817,3519,216,3303,2011,t1,cantonales
2228,46,LOT,2651,1795,105,1690,2011,t1,cantonales
2229,46,LOT,2144,1434,36,1398,2011,t1,cantonales
2230,46,LOT,6724,3573,186,3387,2011,t1,cantonales
2231,46,LOT,7771,4016,236,3780,2011,t1,cantonales
2232,46,LOT,5781,3053,254,2799,2011,t1,cantonales
2233,46,LOT,5215,3115,175,2940,2011,t1,cantonales
2234,46,LOT,1432,970,67,903,2011,t1,cantonales
2235,46,LOT,5388,3290,117,3173,2011,t1,cantonales
2236,46,LOT,4395,2569,116,2453,2011,t1,cantonales
2237,46,LOT,2040,1219,82,1137,2011,t1,cantonales
2238,46,LOT,1816,1162,46,1116,2011,t1,cantonales
2239,46,LOT,5974,3665,159,3506,2011,t1,cantonales
2240,46,LOT,1229,775,91,684,2011,t1,cantonales
2241,46,LOT,8539,3946,191,3755,2011,t1,cantonales
2242,47,LOT ET GARONNE,7173,3350,107,3243,2011,t1,cantonales
2243,47,LOT ET GARONNE,1964,1318,33,1285,2011,t1,cantonales
2244,47,LOT ET GARONNE,2300,1685,50,1635,2011,t1,cantonales
2245,47,LOT ET GARONNE,4427,2522,84,2438,2011,t1,cantonales
2246,47,LOT ET GARONNE,3860,2296,82,2214,2011,t1,cantonales
2247,47,LOT ET GARONNE,3561,2325,78,2247,2011,t1,cantonales
2248,47,LOT ET GARONNE,8118,4982,134,4848,2011,t1,cantonales
2249,47,LOT ET GARONNE,1297,882,32,850,2011,t1,cantonales
2250,47,LOT ET GARONNE,3197,1905,31,1874,2011,t1,cantonales
2251,47,LOT ET GARONNE,11411,5007,199,4808,2011,t1,cantonales
2252,47,LOT ET GARONNE,3734,2136,117,2019,2011,t1,cantonales
2253,47,LOT ET GARONNE,3024,1991,73,1918,2011,t1,cantonales
2254,47,LOT ET GARONNE,4676,2946,78,2868,2011,t1,cantonales
2255,47,LOT ET GARONNE,3405,2315,41,2274,2011,t1,cantonales
2256,47,LOT ET GARONNE,5948,3300,82,3218,2011,t1,cantonales
2257,47,LOT ET GARONNE,9925,4849,145,4704,2011,t1,cantonales
2258,47,LOT ET GARONNE,12040,5333,138,5195,2011,t1,cantonales
2259,47,LOT ET GARONNE,8734,3962,184,3778,2011,t1,cantonales
2260,47,LOT ET GARONNE,12500,6044,121,5923,2011,t1,cantonales
2261,47,LOT ET GARONNE,9738,4658,193,4465,2011,t1,cantonales
2262,48,LOZERE,1986,1436,40,1396,2011,t1,cantonales
2263,48,LOZERE,1997,1241,74,1167,2011,t1,cantonales
2264,48,LOZERE,1326,861,61,800,2011,t1,cantonales
2265,48,LOZERE,1262,955,58,897,2011,t1,cantonales
2266,48,LOZERE,3696,1889,251,1638,2011,t1,cantonales
2267,48,LOZERE,2104,1559,36,1523,2011,t1,cantonales
2268,48,LOZERE,1035,847,38,809,2011,t1,cantonales
2269,48,LOZERE,1277,759,49,710,2011,t1,cantonales
2270,48,LOZERE,1856,1318,37,1281,2011,t1,cantonales
2271,48,LOZERE,1185,795,28,767,2011,t1,cantonales
2272,48,LOZERE,2610,1248,210,1038,2011,t1,cantonales
2273,48,LOZERE,1536,996,32,964,2011,t1,cantonales
2274,49,MAINE ET LOIRE,8227,4367,105,4262,2011,t1,cantonales
2275,49,MAINE ET LOIRE,5274,2436,103,2333,2011,t1,cantonales
2276,49,MAINE ET LOIRE,8904,4744,163,4581,2011,t1,cantonales
2277,49,MAINE ET LOIRE,18919,6727,259,6468,2011,t1,cantonales
2278,49,MAINE ET LOIRE,10643,5569,149,5420,2011,t1,cantonales
2279,49,MAINE ET LOIRE,7417,3316,140,3176,2011,t1,cantonales
2280,49,MAINE ET LOIRE,5308,2866,53,2813,2011,t1,cantonales
2281,49,MAINE ET LOIRE,11673,5383,178,5205,2011,t1,cantonales
2282,49,MAINE ET LOIRE,29488,12942,589,12353,2011,t1,cantonales
2283,49,MAINE ET LOIRE,7584,3481,294,3187,2011,t1,cantonales
2284,49,MAINE ET LOIRE,13306,6440,336,6104,2011,t1,cantonales
2285,49,MAINE ET LOIRE,12161,5808,196,5612,2011,t1,cantonales
2286,49,MAINE ET LOIRE,8287,3621,127,3494,2011,t1,cantonales
2287,49,MAINE ET LOIRE,7880,3668,140,3528,2011,t1,cantonales
2288,49,MAINE ET LOIRE,21654,9755,231,9524,2011,t1,cantonales
2289,49,MAINE ET LOIRE,12371,5417,266,5151,2011,t1,cantonales
2290,49,MAINE ET LOIRE,18137,6362,279,6083,2011,t1,cantonales
2291,49,MAINE ET LOIRE,20696,8738,246,8492,2011,t1,cantonales
2292,49,MAINE ET LOIRE,14796,5458,164,5294,2011,t1,cantonales
2293,49,MAINE ET LOIRE,22232,8271,343,7928,2011,t1,cantonales
2294,50,MANCHE,6280,2972,90,2882,2011,t1,cantonales
2295,50,MANCHE,8841,4222,116,4106,2011,t1,cantonales
2296,50,MANCHE,4646,2417,142,2275,2011,t1,cantonales
2297,50,MANCHE,9181,3928,120,3808,2011,t1,cantonales
2298,50,MANCHE,8519,3376,87,3289,2011,t1,cantonales
2299,50,MANCHE,9006,4130,159,3971,2011,t1,cantonales
2300,50,MANCHE,8571,4221,85,4136,2011,t1,cantonales
2301,50,MANCHE,6358,3221,99,3122,2011,t1,cantonales
2302,50,MANCHE,2329,1618,45,1573,2011,t1,cantonales
2303,50,MANCHE,1885,992,132,860,2011,t1,cantonales
2304,50,MANCHE,3828,2172,79,2093,2011,t1,cantonales
2305,50,MANCHE,4609,1717,280,1437,2011,t1,cantonales
2306,50,MANCHE,5090,2673,199,2474,2011,t1,cantonales
2307,50,MANCHE,5191,3248,135,3113,2011,t1,cantonales
2308,50,MANCHE,4949,2266,98,2168,2011,t1,cantonales
2309,50,MANCHE,8567,4240,158,4082,2011,t1,cantonales
2310,50,MANCHE,5948,3029,141,2888,2011,t1,cantonales
2311,50,MANCHE,6790,3009,82,2927,2011,t1,cantonales
2312,50,MANCHE,3684,2541,74,2467,2011,t1,cantonales
2313,50,MANCHE,2441,1438,54,1384,2011,t1,cantonales
2314,50,MANCHE,9448,4594,180,4414,2011,t1,cantonales
2315,50,MANCHE,10610,4476,124,4352,2011,t1,cantonales
2316,50,MANCHE,6318,2932,112,2820,2011,t1,cantonales
2317,50,MANCHE,7120,2283,57,2226,2011,t1,cantonales
2318,50,MANCHE,18444,6420,283,6137,2011,t1,cantonales
2319,50,MANCHE,9891,4437,112,4325,2011,t1,cantonales
2320,51,MARNE,7543,3393,106,3287,2011,t1,cantonales
2321,51,MARNE,7146,3258,61,3197,2011,t1,cantonales
2322,51,MARNE,3306,1608,65,1543,2011,t1,cantonales
2323,51,MARNE,5385,2473,89,2384,2011,t1,cantonales
2324,51,MARNE,8532,3211,157,3054,2011,t1,cantonales
2325,51,MARNE,4147,2252,52,2200,2011,t1,cantonales
2326,51,MARNE,3283,1724,46,1678,2011,t1,cantonales
2327,51,MARNE,18634,6403,72,6331,2011,t1,cantonales
2328,51,MARNE,8955,3021,37,2984,2011,t1,cantonales
2329,51,MARNE,6020,3259,109,3150,2011,t1,cantonales
2330,51,MARNE,3612,1885,74,1811,2011,t1,cantonales
2331,51,MARNE,7742,3235,102,3133,2011,t1,cantonales
2332,51,MARNE,8886,3761,121,3640,2011,t1,cantonales
2333,51,MARNE,8743,3820,98,3722,2011,t1,cantonales
2334,51,MARNE,10108,4564,136,4428,2011,t1,cantonales
2335,51,MARNE,9111,3606,94,3512,2011,t1,cantonales
2336,51,MARNE,10767,3961,147,3814,2011,t1,cantonales
2337,51,MARNE,14107,5327,131,5196,2011,t1,cantonales
2338,51,MARNE,13810,4537,81,4456,2011,t1,cantonales
2339,51,MARNE,9122,3467,54,3413,2011,t1,cantonales
2340,51,MARNE,13249,3467,53,3414,2011,t1,cantonales
2341,51,MARNE,11033,3829,91,3738,2011,t1,cantonales
2342,52,HAUTE MARNE,2192,1273,36,1237,2011,t1,cantonales
2343,52,HAUTE MARNE,1487,996,23,973,2011,t1,cantonales
2344,52,HAUTE MARNE,3321,1781,70,1711,2011,t1,cantonales
2345,52,HAUTE MARNE,9531,3874,142,3732,2011,t1,cantonales
2346,52,HAUTE MARNE,2048,1225,50,1175,2011,t1,cantonales
2347,52,HAUTE MARNE,3483,1964,68,1896,2011,t1,cantonales
2348,52,HAUTE MARNE,2513,1408,40,1368,2011,t1,cantonales
2349,52,HAUTE MARNE,9701,4719,106,4613,2011,t1,cantonales
2350,52,HAUTE MARNE,5557,2964,125,2839,2011,t1,cantonales
2351,52,HAUTE MARNE,4238,2264,69,2195,2011,t1,cantonales
2352,52,HAUTE MARNE,3058,1806,72,1734,2011,t1,cantonales
2353,52,HAUTE MARNE,8442,2736,98,2638,2011,t1,cantonales
2354,52,HAUTE MARNE,4333,2397,86,2311,2011,t1,cantonales
2355,52,HAUTE MARNE,5838,2798,50,2748,2011,t1,cantonales
2356,52,HAUTE MARNE,4510,1884,39,1845,2011,t1,cantonales
2357,52,HAUTE MARNE,8043,3187,87,3100,2011,t1,cantonales
2358,53,MAYENNE,3989,2107,91,2016,2011,t1,cantonales
2359,53,MAYENNE,7082,3335,211,3124,2011,t1,cantonales
2360,53,MAYENNE,6587,2758,190,2568,2011,t1,cantonales
2361,53,MAYENNE,7800,3529,104,3425,2011,t1,cantonales
2362,53,MAYENNE,8067,3907,200,3707,2011,t1,cantonales
2363,53,MAYENNE,5345,2986,93,2893,2011,t1,cantonales
2364,53,MAYENNE,5147,2834,307,2527,2011,t1,cantonales
2365,53,MAYENNE,11167,5274,230,5044,2011,t1,cantonales
2366,53,MAYENNE,8111,3202,174,3028,2011,t1,cantonales
2367,53,MAYENNE,11698,5159,215,4944,2011,t1,cantonales
2368,53,MAYENNE,11720,5394,228,5166,2011,t1,cantonales
2369,53,MAYENNE,10357,4295,616,3679,2011,t1,cantonales
2370,53,MAYENNE,5981,2864,120,2744,2011,t1,cantonales
2371,53,MAYENNE,8630,3536,235,3301,2011,t1,cantonales
2372,53,MAYENNE,4500,1775,57,1718,2011,t1,cantonales
2373,53,MAYENNE,7683,3323,136,3187,2011,t1,cantonales
2374,53,MAYENNE,12504,5591,259,5332,2011,t1,cantonales
2375,54,MEURTHE ET MOSELLE,1158,768,17,751,2011,t1,cantonales
2376,54,MEURTHE ET MOSELLE,15225,5797,167,5630,2011,t1,cantonales
2377,54,MEURTHE ET MOSELLE,2490,1532,45,1487,2011,t1,cantonales
2378,54,MEURTHE ET MOSELLE,4455,2597,116,2481,2011,t1,cantonales
2379,54,MEURTHE ET MOSELLE,5717,3098,150,2948,2011,t1,cantonales
2380,54,MEURTHE ET MOSELLE,14791,6481,239,6242,2011,t1,cantonales
2381,54,MEURTHE ET MOSELLE,6550,3550,97,3453,2011,t1,cantonales
2382,54,MEURTHE ET MOSELLE,9580,4089,186,3903,2011,t1,cantonales
2383,54,MEURTHE ET MOSELLE,12120,3550,114,3436,2011,t1,cantonales
2384,54,MEURTHE ET MOSELLE,12239,4134,87,4047,2011,t1,cantonales
2385,54,MEURTHE ET MOSELLE,12370,4035,104,3931,2011,t1,cantonales
2386,54,MEURTHE ET MOSELLE,7565,3674,95,3579,2011,t1,cantonales
2387,54,MEURTHE ET MOSELLE,13908,5699,158,5541,2011,t1,cantonales
2388,54,MEURTHE ET MOSELLE,20317,8015,119,7896,2011,t1,cantonales
2389,54,MEURTHE ET MOSELLE,3401,1830,48,1782,2011,t1,cantonales
2390,54,MEURTHE ET MOSELLE,10002,4716,119,4597,2011,t1,cantonales
2391,54,MEURTHE ET MOSELLE,12040,3703,158,3545,2011,t1,cantonales
2392,54,MEURTHE ET MOSELLE,12124,4070,244,3826,2011,t1,cantonales
2393,54,MEURTHE ET MOSELLE,11173,4052,185,3867,2011,t1,cantonales
2394,54,MEURTHE ET MOSELLE,17834,7390,138,7252,2011,t1,cantonales
2395,54,MEURTHE ET MOSELLE,17428,7302,172,7130,2011,t1,cantonales
2396,54,MEURTHE ET MOSELLE,13433,5692,223,5469,2011,t1,cantonales
2397,55,MEUSE,7785,3588,108,3480,2011,t1,cantonales
2398,55,MEUSE,8143,3549,99,3450,2011,t1,cantonales
2399,55,MEUSE,6568,3436,55,3381,2011,t1,cantonales
2400,55,MEUSE,2471,1626,40,1586,2011,t1,cantonales
2401,55,MEUSE,3677,2072,59,2013,2011,t1,cantonales
2402,55,MEUSE,1782,1155,36,1119,2011,t1,cantonales
2403,55,MEUSE,2853,1572,77,1495,2011,t1,cantonales
2404,55,MEUSE,5602,3054,75,2979,2011,t1,cantonales
2405,55,MEUSE,5771,2973,67,2906,2011,t1,cantonales
2406,55,MEUSE,1574,979,143,836,2011,t1,cantonales
2407,55,MEUSE,1246,816,58,758,2011,t1,cantonales
2408,55,MEUSE,2359,1324,54,1270,2011,t1,cantonales
2409,55,MEUSE,3728,1975,67,1908,2011,t1,cantonales
2410,55,MEUSE,2997,1700,63,1637,2011,t1,cantonales
2411,55,MEUSE,7046,2489,42,2447,2011,t1,cantonales
2412,56,MORBIHAN,6798,4276,166,4110,2011,t1,cantonales
2413,56,MORBIHAN,5248,3189,68,3121,2011,t1,cantonales
2414,56,MORBIHAN,11559,6075,177,5898,2011,t1,cantonales
2415,56,MORBIHAN,14592,4932,222,4710,2011,t1,cantonales
2416,56,MORBIHAN,10779,5688,83,5605,2011,t1,cantonales
2417,56,MORBIHAN,11746,5395,291,5104,2011,t1,cantonales
2418,56,MORBIHAN,15954,7738,223,7515,2011,t1,cantonales
2419,56,MORBIHAN,18886,9115,264,8851,2011,t1,cantonales
2420,56,MORBIHAN,22287,11155,171,10984,2011,t1,cantonales
2421,56,MORBIHAN,12304,6346,144,6202,2011,t1,cantonales
2422,56,MORBIHAN,15071,6841,103,6738,2011,t1,cantonales
2423,56,MORBIHAN,11861,5379,186,5193,2011,t1,cantonales
2424,56,MORBIHAN,6589,3556,111,3445,2011,t1,cantonales
2425,56,MORBIHAN,7040,4546,77,4469,2011,t1,cantonales
2426,56,MORBIHAN,7894,4580,82,4498,2011,t1,cantonales
2427,56,MORBIHAN,12196,6743,92,6651,2011,t1,cantonales
2428,56,MORBIHAN,4019,2111,121,1990,2011,t1,cantonales
2429,56,MORBIHAN,23695,10627,208,10419,2011,t1,cantonales
2430,56,MORBIHAN,16623,7296,94,7202,2011,t1,cantonales
2431,56,MORBIHAN,16402,7039,180,6859,2011,t1,cantonales
2432,56,MORBIHAN,23530,9619,269,9350,2011,t1,cantonales
2433,57,MOSELLE,9949,4456,174,4282,2011,t1,cantonales
2434,57,MOSELLE,15221,6547,228,6319,2011,t1,cantonales
2435,57,MOSELLE,17271,5989,140,5849,2011,t1,cantonales
2436,57,MOSELLE,4897,2716,69,2647,2011,t1,cantonales
2437,57,MOSELLE,4228,2374,51,2323,2011,t1,cantonales
2438,57,MOSELLE,16725,5575,93,5482,2011,t1,cantonales
2439,57,MOSELLE,14161,4315,107,4208,2011,t1,cantonales
2440,57,MOSELLE,16469,6438,187,6251,2011,t1,cantonales
2441,57,MOSELLE,5398,3032,80,2952,2011,t1,cantonales
2442,57,MOSELLE,12615,4138,79,4059,2011,t1,cantonales
2443,57,MOSELLE,15859,5240,92,5148,2011,t1,cantonales
2444,57,MOSELLE,21555,7827,136,7691,2011,t1,cantonales
2445,57,MOSELLE,19907,8743,251,8492,2011,t1,cantonales
2446,57,MOSELLE,15029,4898,168,4730,2011,t1,cantonales
2447,57,MOSELLE,2919,1629,48,1581,2011,t1,cantonales
2448,57,MOSELLE,23197,9297,203,9094,2011,t1,cantonales
2449,57,MOSELLE,22056,8011,100,7911,2011,t1,cantonales
2450,57,MOSELLE,18690,6505,148,6357,2011,t1,cantonales
2451,57,MOSELLE,14303,4956,189,4767,2011,t1,cantonales
2452,57,MOSELLE,21637,8230,187,8043,2011,t1,cantonales
2453,57,MOSELLE,12733,4138,99,4039,2011,t1,cantonales
2454,57,MOSELLE,14026,4811,121,4690,2011,t1,cantonales
2455,57,MOSELLE,17708,7368,161,7207,2011,t1,cantonales
2456,57,MOSELLE,16015,6077,116,5961,2011,t1,cantonales
2457,57,MOSELLE,20606,8237,269,7968,2011,t1,cantonales
2458,57,MOSELLE,19523,6949,151,6798,2011,t1,cantonales
2459,58,NIEVRE,8116,3673,111,3562,2011,t1,cantonales
2460,58,NIEVRE,3879,2261,51,2210,2011,t1,cantonales
2461,58,NIEVRE,6208,2788,110,2678,2011,t1,cantonales
2462,58,NIEVRE,3275,1845,38,1807,2011,t1,cantonales
2463,58,NIEVRE,3604,2039,77,1962,2011,t1,cantonales
2464,58,NIEVRE,3599,2317,79,2238,2011,t1,cantonales
2465,58,NIEVRE,3357,1673,71,1602,2011,t1,cantonales
2466,58,NIEVRE,3363,1902,31,1871,2011,t1,cantonales
2467,58,NIEVRE,2685,1531,63,1468,2011,t1,cantonales
2468,58,NIEVRE,2440,1569,41,1528,2011,t1,cantonales
2469,58,NIEVRE,3325,1837,39,1798,2011,t1,cantonales
2470,58,NIEVRE,5804,2574,96,2478,2011,t1,cantonales
2471,58,NIEVRE,8912,3450,208,3242,2011,t1,cantonales
2472,58,NIEVRE,5860,2094,81,2013,2011,t1,cantonales
2473,58,NIEVRE,12510,4888,167,4721,2011,t1,cantonales
2474,58,NIEVRE,6030,2636,107,2529,2011,t1,cantonales
2475,59,NORD,13889,7196,156,7040,2011,t1,cantonales
2476,59,NORD,38200,15211,418,14793,2011,t1,cantonales
2477,59,NORD,6529,2779,84,2695,2011,t1,cantonales
2478,59,NORD,14184,6452,283,6169,2011,t1,cantonales
2479,59,NORD,14304,7545,200,7345,2011,t1,cantonales
2480,59,NORD,19108,9235,493,8742,2011,t1,cantonales
2481,59,NORD,16970,7369,199,7170,2011,t1,cantonales
2482,59,NORD,14292,7298,175,7123,2011,t1,cantonales
2483,59,NORD,7684,4321,93,4228,2011,t1,cantonales
2484,59,NORD,12136,6241,207,6034,2011,t1,cantonales
2485,59,NORD,30877,11265,303,10962,2011,t1,cantonales
2486,59,NORD,21384,9838,232,9606,2011,t1,cantonales
2487,59,NORD,36278,14519,352,14167,2011,t1,cantonales
2488,59,NORD,28666,12758,340,12418,2011,t1,cantonales
2489,59,NORD,18795,9003,255,8748,2011,t1,cantonales
2490,59,NORD,18509,8378,254,8124,2011,t1,cantonales
2491,59,NORD,8198,4209,154,4055,2011,t1,cantonales
2492,59,NORD,48783,19496,425,19071,2011,t1,cantonales
2493,59,NORD,18398,6325,150,6175,2011,t1,cantonales
2494,59,NORD,29928,10319,191,10128,2011,t1,cantonales
2495,59,NORD,30821,11922,256,11666,2011,t1,cantonales
2496,59,NORD,20941,6500,114,6386,2011,t1,cantonales
2497,59,NORD,24053,9041,215,8826,2011,t1,cantonales
2498,59,NORD,29096,12249,260,11989,2011,t1,cantonales
2499,59,NORD,8947,4133,92,4041,2011,t1,cantonales
2500,59,NORD,19750,5366,139,5227,2011,t1,cantonales
2501,59,NORD,23700,8647,218,8429,2011,t1,cantonales
2502,59,NORD,12785,6576,203,6373,2011,t1,cantonales
2503,59,NORD,6598,3062,96,2966,2011,t1,cantonales
2504,59,NORD,45432,15607,389,15218,2011,t1,cantonales
2505,59,NORD,34958,9499,237,9262,2011,t1,cantonales
2506,59,NORD,35408,13581,268,13313,2011,t1,cantonales
2507,59,NORD,22402,8772,187,8585,2011,t1,cantonales
2508,59,NORD,12148,6476,166,6310,2011,t1,cantonales
2509,59,NORD,33563,14328,444,13884,2011,t1,cantonales
2510,59,NORD,23123,8748,318,8430,2011,t1,cantonales
2511,59,NORD,20340,5734,127,5607,2011,t1,cantonales
2512,59,NORD,20162,7313,132,7181,2011,t1,cantonales
2513,59,NORD,22673,9272,230,9042,2011,t1,cantonales
2514,59,NORD,24781,10869,167,10702,2011,t1,cantonales
2515,60,OISE,10503,4420,100,4320,2011,t1,cantonales
2516,60,OISE,14633,6332,160,6172,2011,t1,cantonales
2517,60,OISE,12592,5623,131,5492,2011,t1,cantonales
2518,60,OISE,17130,6419,108,6311,2011,t1,cantonales
2519,60,OISE,21227,8947,252,8695,2011,t1,cantonales
2520,60,OISE,5678,3109,111,2998,2011,t1,cantonales
2521,60,OISE,6261,3823,65,3758,2011,t1,cantonales
2522,60,OISE,4989,3182,77,3105,2011,t1,cantonales
2523,60,OISE,5493,2852,50,2802,2011,t1,cantonales
2524,60,OISE,6657,3442,90,3352,2011,t1,cantonales
2525,60,OISE,6166,3350,90,3260,2011,t1,cantonales
2526,60,OISE,10374,4658,100,4558,2011,t1,cantonales
2527,60,OISE,15249,6867,146,6721,2011,t1,cantonales
2528,60,OISE,15183,6684,406,6278,2011,t1,cantonales
2529,60,OISE,19184,7688,145,7543,2011,t1,cantonales
2530,60,OISE,18017,8457,158,8299,2011,t1,cantonales
2531,60,OISE,12965,6854,166,6688,2011,t1,cantonales
2532,60,OISE,23422,9249,136,9113,2011,t1,cantonales
2533,60,OISE,5766,3426,90,3336,2011,t1,cantonales
2534,60,OISE,26747,9769,154,9615,2011,t1,cantonales
2535,61,ORNE,4637,2263,82,2181,2011,t1,cantonales
2536,61,ORNE,3557,2018,91,1927,2011,t1,cantonales
2537,61,ORNE,3933,2260,51,2209,2011,t1,cantonales
2538,61,ORNE,8109,3842,157,3685,2011,t1,cantonales
2539,61,ORNE,2132,1165,51,1114,2011,t1,cantonales
2540,61,ORNE,9752,4493,155,4338,2011,t1,cantonales
2541,61,ORNE,5543,2829,80,2749,2011,t1,cantonales
2542,61,ORNE,3350,1736,31,1705,2011,t1,cantonales
2543,61,ORNE,3266,1718,164,1554,2011,t1,cantonales
2544,61,ORNE,3233,1890,62,1828,2011,t1,cantonales
2545,61,ORNE,3138,1719,34,1685,2011,t1,cantonales
2546,61,ORNE,2762,1643,88,1555,2011,t1,cantonales
2547,61,ORNE,3007,1450,44,1406,2011,t1,cantonales
2548,61,ORNE,5407,2755,51,2704,2011,t1,cantonales
2549,61,ORNE,6349,3420,200,3220,2011,t1,cantonales
2550,61,ORNE,5375,2845,107,2738,2011,t1,cantonales
2551,61,ORNE,6302,3104,78,3026,2011,t1,cantonales
2552,61,ORNE,9457,4190,104,4086,2011,t1,cantonales
2553,61,ORNE,6955,3119,133,2986,2011,t1,cantonales
2554,61,ORNE,10048,4707,118,4589,2011,t1,cantonales
2555,62,PAS DE CALAIS,15039,8628,185,8443,2011,t1,cantonales
2556,62,PAS DE CALAIS,13727,6399,203,6196,2011,t1,cantonales
2557,62,PAS DE CALAIS,23074,11330,433,10897,2011,t1,cantonales
2558,62,PAS DE CALAIS,18794,9446,228,9218,2011,t1,cantonales
2559,62,PAS DE CALAIS,6956,3949,170,3779,2011,t1,cantonales
2560,62,PAS DE CALAIS,9578,5687,159,5528,2011,t1,cantonales
2561,62,PAS DE CALAIS,17290,7354,177,7177,2011,t1,cantonales
2562,62,PAS DE CALAIS,20718,9074,207,8867,2011,t1,cantonales
2563,62,PAS DE CALAIS,20857,8292,306,7986,2011,t1,cantonales
2564,62,PAS DE CALAIS,14876,6908,365,6543,2011,t1,cantonales
2565,62,PAS DE CALAIS,8517,5549,117,5432,2011,t1,cantonales
2566,62,PAS DE CALAIS,18006,7214,231,6983,2011,t1,cantonales
2567,62,PAS DE CALAIS,11413,6691,233,6458,2011,t1,cantonales
2568,62,PAS DE CALAIS,15135,6654,290,6364,2011,t1,cantonales
2569,62,PAS DE CALAIS,7382,4755,398,4357,2011,t1,cantonales
2570,62,PAS DE CALAIS,15146,6277,196,6081,2011,t1,cantonales
2571,62,PAS DE CALAIS,17108,8888,298,8590,2011,t1,cantonales
2572,62,PAS DE CALAIS,5754,3339,247,3092,2011,t1,cantonales
2573,62,PAS DE CALAIS,11352,6278,234,6044,2011,t1,cantonales
2574,62,PAS DE CALAIS,18247,9451,386,9065,2011,t1,cantonales
2575,62,PAS DE CALAIS,21601,10229,480,9749,2011,t1,cantonales
2576,62,PAS DE CALAIS,15508,5762,179,5583,2011,t1,cantonales
2577,62,PAS DE CALAIS,15812,6808,182,6626,2011,t1,cantonales
2578,62,PAS DE CALAIS,14867,6425,182,6243,2011,t1,cantonales
2579,62,PAS DE CALAIS,17777,7752,270,7482,2011,t1,cantonales
2580,62,PAS DE CALAIS,13656,5940,159,5781,2011,t1,cantonales
2581,62,PAS DE CALAIS,18060,8073,187,7886,2011,t1,cantonales
2582,62,PAS DE CALAIS,15085,7277,161,7116,2011,t1,cantonales
2583,62,PAS DE CALAIS,13853,5818,250,5568,2011,t1,cantonales
2584,62,PAS DE CALAIS,13623,5097,106,4991,2011,t1,cantonales
2585,62,PAS DE CALAIS,14657,5819,222,5597,2011,t1,cantonales
2586,62,PAS DE CALAIS,14902,6479,149,6330,2011,t1,cantonales
2587,62,PAS DE CALAIS,18583,9155,259,8896,2011,t1,cantonales
2588,62,PAS DE CALAIS,16169,6439,189,6250,2011,t1,cantonales
2589,62,PAS DE CALAIS,14967,7784,201,7583,2011,t1,cantonales
2590,62,PAS DE CALAIS,14790,6433,286,6147,2011,t1,cantonales
2591,62,PAS DE CALAIS,14079,5792,126,5666,2011,t1,cantonales
2592,62,PAS DE CALAIS,13308,5269,113,5156,2011,t1,cantonales
2593,63,PUY DE DOME,8594,4348,194,4154,2011,t1,cantonales
2594,63,PUY DE DOME,7613,3774,241,3533,2011,t1,cantonales
2595,63,PUY DE DOME,2810,1868,156,1712,2011,t1,cantonales
2596,63,PUY DE DOME,5306,3114,99,3015,2011,t1,cantonales
2597,63,PUY DE DOME,9563,3840,149,3691,2011,t1,cantonales
2598,63,PUY DE DOME,5607,2873,92,2781,2011,t1,cantonales
2599,63,PUY DE DOME,1978,1213,82,1131,2011,t1,cantonales
2600,63,PUY DE DOME,15888,7731,247,7484,2011,t1,cantonales
2601,63,PUY DE DOME,2619,1783,98,1685,2011,t1,cantonales
2602,63,PUY DE DOME,10647,5491,154,5337,2011,t1,cantonales
2603,63,PUY DE DOME,7983,4187,94,4093,2011,t1,cantonales
2604,63,PUY DE DOME,6554,3642,167,3475,2011,t1,cantonales
2605,63,PUY DE DOME,2207,1557,68,1489,2011,t1,cantonales
2606,63,PUY DE DOME,16227,6835,334,6501,2011,t1,cantonales
2607,63,PUY DE DOME,4732,2585,151,2434,2011,t1,cantonales
2608,63,PUY DE DOME,13598,6431,188,6243,2011,t1,cantonales
2609,63,PUY DE DOME,1256,771,28,743,2011,t1,cantonales
2610,63,PUY DE DOME,2158,1261,60,1201,2011,t1,cantonales
2611,63,PUY DE DOME,3587,2299,71,2228,2011,t1,cantonales
2612,63,PUY DE DOME,6796,3666,109,3557,2011,t1,cantonales
2613,63,PUY DE DOME,5167,2652,132,2520,2011,t1,cantonales
2614,63,PUY DE DOME,9783,4373,267,4106,2011,t1,cantonales
2615,63,PUY DE DOME,18901,8639,572,8067,2011,t1,cantonales
2616,63,PUY DE DOME,10489,4828,212,4616,2011,t1,cantonales
2617,63,PUY DE DOME,9796,4149,168,3981,2011,t1,cantonales
2618,63,PUY DE DOME,5917,2329,77,2252,2011,t1,cantonales
2619,63,PUY DE DOME,7353,2891,59,2832,2011,t1,cantonales
2620,63,PUY DE DOME,15731,6392,261,6131,2011,t1,cantonales
2621,63,PUY DE DOME,11809,5188,187,5001,2011,t1,cantonales
2622,63,PUY DE DOME,12825,5933,193,5740,2011,t1,cantonales
2623,64,PYRENEES ATLANTIQUES,2843,2167,48,2119,2011,t1,cantonales
2624,64,PYRENEES ATLANTIQUES,8171,4699,197,4502,2011,t1,cantonales
2625,64,PYRENEES ATLANTIQUES,4970,3337,72,3265,2011,t1,cantonales
2626,64,PYRENEES ATLANTIQUES,7448,2853,93,2760,2011,t1,cantonales
2627,64,PYRENEES ATLANTIQUES,12972,5042,120,4922,2011,t1,cantonales
2628,64,PYRENEES ATLANTIQUES,6862,4124,177,3947,2011,t1,cantonales
2629,64,PYRENEES ATLANTIQUES,3600,2799,44,2755,2011,t1,cantonales
2630,64,PYRENEES ATLANTIQUES,5170,2937,84,2853,2011,t1,cantonales
2631,64,PYRENEES ATLANTIQUES,10974,5501,172,5329,2011,t1,cantonales
2632,64,PYRENEES ATLANTIQUES,2964,2225,69,2156,2011,t1,cantonales
2633,64,PYRENEES ATLANTIQUES,2436,1678,62,1616,2011,t1,cantonales
2634,64,PYRENEES ATLANTIQUES,4294,2813,69,2744,2011,t1,cantonales
2635,64,PYRENEES ATLANTIQUES,25497,12039,348,11691,2011,t1,cantonales
2636,64,PYRENEES ATLANTIQUES,6935,3751,308,3443,2011,t1,cantonales
2637,64,PYRENEES ATLANTIQUES,4663,3105,81,3024,2011,t1,cantonales
2638,64,PYRENEES ATLANTIQUES,12556,6421,278,6143,2011,t1,cantonales
2639,64,PYRENEES ATLANTIQUES,9751,5336,209,5127,2011,t1,cantonales
2640,64,PYRENEES ATLANTIQUES,13038,4733,116,4617,2011,t1,cantonales
2641,64,PYRENEES ATLANTIQUES,5358,3659,109,3550,2011,t1,cantonales
2642,64,PYRENEES ATLANTIQUES,2886,2007,40,1967,2011,t1,cantonales
2643,64,PYRENEES ATLANTIQUES,12775,5719,83,5636,2011,t1,cantonales
2644,64,PYRENEES ATLANTIQUES,12793,5025,110,4915,2011,t1,cantonales
2645,64,PYRENEES ATLANTIQUES,10450,3581,64,3517,2011,t1,cantonales
2646,64,PYRENEES ATLANTIQUES,15486,7750,210,7540,2011,t1,cantonales
2647,64,PYRENEES ATLANTIQUES,10847,4982,102,4880,2011,t1,cantonales
2648,64,PYRENEES ATLANTIQUES,10554,4538,97,4441,2011,t1,cantonales
2649,65,HAUTES PYRENEES,2996,1836,69,1767,2011,t1,cantonales
2650,65,HAUTES PYRENEES,1960,1331,71,1260,2011,t1,cantonales
2651,65,HAUTES PYRENEES,1245,883,48,835,2011,t1,cantonales
2652,65,HAUTES PYRENEES,3852,2140,99,2041,2011,t1,cantonales
2653,65,HAUTES PYRENEES,2371,1497,89,1408,2011,t1,cantonales
2654,65,HAUTES PYRENEES,9758,5217,206,5011,2011,t1,cantonales
2655,65,HAUTES PYRENEES,3844,2279,40,2239,2011,t1,cantonales
2656,65,HAUTES PYRENEES,3747,2219,127,2092,2011,t1,cantonales
2657,65,HAUTES PYRENEES,1751,1132,21,1111,2011,t1,cantonales
2658,65,HAUTES PYRENEES,7994,4017,105,3912,2011,t1,cantonales
2659,65,HAUTES PYRENEES,2883,1935,102,1833,2011,t1,cantonales
2660,65,HAUTES PYRENEES,7689,3803,130,3673,2011,t1,cantonales
2661,65,HAUTES PYRENEES,2262,1654,70,1584,2011,t1,cantonales
2662,65,HAUTES PYRENEES,5925,2433,48,2385,2011,t1,cantonales
2663,65,HAUTES PYRENEES,6793,2635,42,2593,2011,t1,cantonales
2664,65,HAUTES PYRENEES,5192,2199,36,2163,2011,t1,cantonales
2665,65,HAUTES PYRENEES,9107,5046,146,4900,2011,t1,cantonales
2666,66,PYRENEES ORIENTALES,21635,11413,211,11202,2011,t1,cantonales
2667,66,PYRENEES ORIENTALES,3695,1930,59,1871,2011,t1,cantonales
2668,66,PYRENEES ORIENTALES,7601,3126,102,3024,2011,t1,cantonales
2669,66,PYRENEES ORIENTALES,5561,2247,56,2191,2011,t1,cantonales
2670,66,PYRENEES ORIENTALES,10259,5905,146,5759,2011,t1,cantonales
2671,66,PYRENEES ORIENTALES,2129,1435,26,1409,2011,t1,cantonales
2672,66,PYRENEES ORIENTALES,18285,8846,191,8655,2011,t1,cantonales
2673,66,PYRENEES ORIENTALES,18574,10075,242,9833,2011,t1,cantonales
2674,66,PYRENEES ORIENTALES,3320,2050,67,1983,2011,t1,cantonales
2675,66,PYRENEES ORIENTALES,1151,877,11,866,2011,t1,cantonales
2676,66,PYRENEES ORIENTALES,16154,8113,238,7875,2011,t1,cantonales
2677,66,PYRENEES ORIENTALES,10588,6103,146,5957,2011,t1,cantonales
2678,66,PYRENEES ORIENTALES,12187,5032,104,4928,2011,t1,cantonales
2679,66,PYRENEES ORIENTALES,14661,6473,124,6349,2011,t1,cantonales
2680,66,PYRENEES ORIENTALES,8147,3204,75,3129,2011,t1,cantonales
2681,66,PYRENEES ORIENTALES,17942,8904,154,8750,2011,t1,cantonales
2682,67,BAS RHIN,24801,10242,206,10036,2011,t1,cantonales
2683,67,BAS RHIN,9644,4853,166,4687,2011,t1,cantonales
2684,67,BAS RHIN,21491,8809,330,8479,2011,t1,cantonales
2685,67,BAS RHIN,15856,6999,175,6824,2011,t1,cantonales
2686,67,BAS RHIN,2988,1594,73,1521,2011,t1,cantonales
2687,67,BAS RHIN,11453,4818,358,4460,2011,t1,cantonales
2688,67,BAS RHIN,17636,8079,187,7892,2011,t1,cantonales
2689,67,BAS RHIN,16955,6015,93,5922,2011,t1,cantonales
2690,67,BAS RHIN,10400,5336,105,5231,2011,t1,cantonales
2691,67,BAS RHIN,22603,10385,296,10089,2011,t1,cantonales
2692,67,BAS RHIN,9969,3008,80,2928,2011,t1,cantonales
2693,67,BAS RHIN,17714,8611,231,8380,2011,t1,cantonales
2694,67,BAS RHIN,8900,4507,200,4307,2011,t1,cantonales
2695,67,BAS RHIN,17199,8079,235,7844,2011,t1,cantonales
2696,67,BAS RHIN,13043,6421,227,6194,2011,t1,cantonales
2697,67,BAS RHIN,10089,4980,150,4830,2011,t1,cantonales
2698,67,BAS RHIN,20374,5819,89,5730,2011,t1,cantonales
2699,67,BAS RHIN,13586,4670,57,4613,2011,t1,cantonales
2700,67,BAS RHIN,14751,5194,87,5107,2011,t1,cantonales
2701,67,BAS RHIN,15207,5010,81,4929,2011,t1,cantonales
2702,67,BAS RHIN,11538,3908,63,3845,2011,t1,cantonales
2703,67,BAS RHIN,37013,13708,208,13500,2011,t1,cantonales
2704,67,BAS RHIN,35017,13375,331,13044,2011,t1,cantonales
2705,68,HAUT RHIN,18511,7991,295,7696,2011,t1,cantonales
2706,68,HAUT RHIN,19045,9342,269,9073,2011,t1,cantonales
2707,68,HAUT RHIN,9874,4921,132,4789,2011,t1,cantonales
2708,68,HAUT RHIN,20002,9039,258,8781,2011,t1,cantonales
2709,68,HAUT RHIN,15212,6757,188,6569,2011,t1,cantonales
2710,68,HAUT RHIN,25216,9419,278,9141,2011,t1,cantonales
2711,68,HAUT RHIN,32272,11447,703,10744,2011,t1,cantonales
2712,68,HAUT RHIN,12996,6687,212,6475,2011,t1,cantonales
2713,68,HAUT RHIN,17169,6839,307,6532,2011,t1,cantonales
2714,68,HAUT RHIN,9111,5261,118,5143,2011,t1,cantonales
2715,68,HAUT RHIN,12993,6307,231,6076,2011,t1,cantonales
2716,68,HAUT RHIN,10260,6474,270,6204,2011,t1,cantonales
2717,68,HAUT RHIN,7159,3481,108,3373,2011,t1,cantonales
2718,68,HAUT RHIN,15585,7434,274,7160,2011,t1,cantonales
2719,69,RHONE,17795,7495,142,7353,2011,t1,cantonales
2720,69,RHONE,27150,11573,225,11348,2011,t1,cantonales
2721,69,RHONE,9414,4395,94,4301,2011,t1,cantonales
2722,69,RHONE,11804,5655,58,5597,2011,t1,cantonales
2723,69,RHONE,24427,9017,180,8837,2011,t1,cantonales
2724,69,RHONE,4917,2318,41,2277,2011,t1,cantonales
2725,69,RHONE,24362,9228,105,9123,2011,t1,cantonales
2726,69,RHONE,30457,10917,111,10806,2011,t1,cantonales
2727,69,RHONE,16299,6201,199,6002,2011,t1,cantonales
2728,69,RHONE,16729,6180,70,6110,2011,t1,cantonales
2729,69,RHONE,19433,6790,54,6736,2011,t1,cantonales
2730,69,RHONE,21312,6378,82,6296,2011,t1,cantonales
2731,69,RHONE,9303,5135,151,4984,2011,t1,cantonales
2732,69,RHONE,8212,4235,103,4132,2011,t1,cantonales
2733,69,RHONE,35283,15122,164,14958,2011,t1,cantonales
2734,69,RHONE,23175,7796,122,7674,2011,t1,cantonales
2735,69,RHONE,24682,7752,127,7625,2011,t1,cantonales
2736,69,RHONE,36789,13727,146,13581,2011,t1,cantonales
2737,69,RHONE,21367,7435,123,7312,2011,t1,cantonales
2738,69,RHONE,16258,6479,98,6381,2011,t1,cantonales
2739,69,RHONE,24691,8321,145,8176,2011,t1,cantonales
2740,69,RHONE,19673,5400,105,5295,2011,t1,cantonales
2741,69,RHONE,26913,8680,137,8543,2011,t1,cantonales
2742,69,RHONE,18187,7471,84,7387,2011,t1,cantonales
2743,69,RHONE,21865,7705,158,7547,2011,t1,cantonales
2744,69,RHONE,19334,6432,167,6265,2011,t1,cantonales
2745,69,RHONE,19389,5774,85,5689,2011,t1,cantonales
2746,70,HAUTE SAONE,3257,1882,127,1755,2011,t1,cantonales
2747,70,HAUTE SAONE,4070,2560,80,2480,2011,t1,cantonales
2748,70,HAUTE SAONE,9483,4380,217,4163,2011,t1,cantonales
2749,70,HAUTE SAONE,2271,1458,71,1387,2011,t1,cantonales
2750,70,HAUTE SAONE,2713,1790,148,1642,2011,t1,cantonales
2751,70,HAUTE SAONE,4139,2858,116,2742,2011,t1,cantonales
2752,70,HAUTE SAONE,3566,2641,102,2539,2011,t1,cantonales
2753,70,HAUTE SAONE,3432,2077,65,2012,2011,t1,cantonales
2754,70,HAUTE SAONE,7268,3735,176,3559,2011,t1,cantonales
2755,70,HAUTE SAONE,4657,2741,81,2660,2011,t1,cantonales
2756,70,HAUTE SAONE,5073,2336,136,2200,2011,t1,cantonales
2757,70,HAUTE SAONE,4499,2760,76,2684,2011,t1,cantonales
2758,70,HAUTE SAONE,3594,2478,141,2337,2011,t1,cantonales
2759,70,HAUTE SAONE,12929,6604,302,6302,2011,t1,cantonales
2760,70,HAUTE SAONE,7700,3720,150,3570,2011,t1,cantonales
2761,70,HAUTE SAONE,6851,3397,130,3267,2011,t1,cantonales
2762,71,SAONE ET LOIRE,7440,3730,188,3542,2011,t1,cantonales
2763,71,SAONE ET LOIRE,3571,1791,79,1712,2011,t1,cantonales
2764,71,SAONE ET LOIRE,18277,7582,281,7301,2011,t1,cantonales
2765,71,SAONE ET LOIRE,6013,3158,115,3043,2011,t1,cantonales
2766,71,SAONE ET LOIRE,7126,3806,93,3713,2011,t1,cantonales
2767,71,SAONE ET LOIRE,4942,2712,57,2655,2011,t1,cantonales
2768,71,SAONE ET LOIRE,5483,2631,74,2557,2011,t1,cantonales
2769,71,SAONE ET LOIRE,7824,3824,121,3703,2011,t1,cantonales
2770,71,SAONE ET LOIRE,3713,2034,69,1965,2011,t1,cantonales
2771,71,SAONE ET LOIRE,9718,4750,136,4614,2011,t1,cantonales
2772,71,SAONE ET LOIRE,2646,1443,59,1384,2011,t1,cantonales
2773,71,SAONE ET LOIRE,1738,1167,24,1143,2011,t1,cantonales
2774,71,SAONE ET LOIRE,3434,1964,80,1884,2011,t1,cantonales
2775,71,SAONE ET LOIRE,6589,3178,79,3099,2011,t1,cantonales
2776,71,SAONE ET LOIRE,9771,3905,79,3826,2011,t1,cantonales
2777,71,SAONE ET LOIRE,4962,2719,73,2646,2011,t1,cantonales
2778,71,SAONE ET LOIRE,2899,1832,59,1773,2011,t1,cantonales
2779,71,SAONE ET LOIRE,3280,1852,88,1764,2011,t1,cantonales
2780,71,SAONE ET LOIRE,11897,3783,80,3703,2011,t1,cantonales
2781,71,SAONE ET LOIRE,2562,1618,42,1576,2011,t1,cantonales
2782,71,SAONE ET LOIRE,11363,5244,152,5092,2011,t1,cantonales
2783,71,SAONE ET LOIRE,4885,2953,61,2892,2011,t1,cantonales
2784,71,SAONE ET LOIRE,6476,3151,88,3063,2011,t1,cantonales
2785,71,SAONE ET LOIRE,2999,1801,44,1757,2011,t1,cantonales
2786,71,SAONE ET LOIRE,4229,2194,83,2111,2011,t1,cantonales
2787,71,SAONE ET LOIRE,7124,3659,114,3545,2011,t1,cantonales
2788,71,SAONE ET LOIRE,13267,4590,153,4437,2011,t1,cantonales
2789,71,SAONE ET LOIRE,11385,4689,81,4608,2011,t1,cantonales
2790,72,SARTHE,6181,3535,95,3440,2011,t1,cantonales
2791,72,SARTHE,5409,3046,65,2981,2011,t1,cantonales
2792,72,SARTHE,7742,4123,90,4033,2011,t1,cantonales
2793,72,SARTHE,4173,2454,82,2372,2011,t1,cantonales
2794,72,SARTHE,6818,3359,90,3269,2011,t1,cantonales
2795,72,SARTHE,7693,3882,120,3762,2011,t1,cantonales
2796,72,SARTHE,8935,4469,110,4359,2011,t1,cantonales
2797,72,SARTHE,12951,4699,128,4571,2011,t1,cantonales
2798,72,SARTHE,4982,2676,99,2577,2011,t1,cantonales
2799,72,SARTHE,15435,7541,161,7380,2011,t1,cantonales
2800,72,SARTHE,18703,7972,249,7723,2011,t1,cantonales
2801,72,SARTHE,7691,4077,109,3968,2011,t1,cantonales
2802,72,SARTHE,8631,4088,71,4017,2011,t1,cantonales
2803,72,SARTHE,5652,2879,109,2770,2011,t1,cantonales
2804,72,SARTHE,23729,9391,471,8920,2011,t1,cantonales
2805,72,SARTHE,16123,6057,235,5822,2011,t1,cantonales
2806,72,SARTHE,22349,10255,563,9692,2011,t1,cantonales
2807,72,SARTHE,14492,6547,211,6336,2011,t1,cantonales
2808,72,SARTHE,12787,5631,178,5453,2011,t1,cantonales
2809,73,SAVOIE,11938,4444,89,4355,2011,t1,cantonales
2810,73,SAVOIE,10138,4167,83,4084,2011,t1,cantonales
2811,73,SAVOIE,11438,4278,160,4118,2011,t1,cantonales
2812,73,SAVOIE,7505,3044,91,2953,2011,t1,cantonales
2813,73,SAVOIE,8657,3113,71,3042,2011,t1,cantonales
2814,73,SAVOIE,5917,2858,51,2807,2011,t1,cantonales
2815,73,SAVOIE,3900,2165,39,2126,2011,t1,cantonales
2816,73,SAVOIE,3890,2097,26,2071,2011,t1,cantonales
2817,73,SAVOIE,6257,3334,56,3278,2011,t1,cantonales
2818,73,SAVOIE,2511,1319,65,1254,2011,t1,cantonales
2819,73,SAVOIE,10515,4837,94,4743,2011,t1,cantonales
2820,73,SAVOIE,7066,3295,87,3208,2011,t1,cantonales
2821,73,SAVOIE,4649,2041,106,1935,2011,t1,cantonales
2822,73,SAVOIE,5251,2799,56,2743,2011,t1,cantonales
2823,73,SAVOIE,12822,4943,130,4813,2011,t1,cantonales
2824,73,SAVOIE,9699,3425,115,3310,2011,t1,cantonales
2825,73,SAVOIE,12018,4931,97,4834,2011,t1,cantonales
2826,73,SAVOIE,15217,6240,171,6069,2011,t1,cantonales
2827,73,SAVOIE,12969,5045,127,4918,2011,t1,cantonales
2828,74,HAUTE SAVOIE,3986,2455,41,2414,2011,t1,cantonales
2829,74,HAUTE SAVOIE,8748,4155,176,3979,2011,t1,cantonales
2830,74,HAUTE SAVOIE,11043,3658,71,3587,2011,t1,cantonales
2831,74,HAUTE SAVOIE,22201,6993,116,6877,2011,t1,cantonales
2832,74,HAUTE SAVOIE,14254,5323,82,5241,2011,t1,cantonales
2833,74,HAUTE SAVOIE,16468,6095,106,5989,2011,t1,cantonales
2834,74,HAUTE SAVOIE,10213,4704,94,4610,2011,t1,cantonales
2835,74,HAUTE SAVOIE,5662,2834,25,2809,2011,t1,cantonales
2836,74,HAUTE SAVOIE,12739,5465,76,5389,2011,t1,cantonales
2837,74,HAUTE SAVOIE,15407,7595,661,6934,2011,t1,cantonales
2838,74,HAUTE SAVOIE,13237,5764,93,5671,2011,t1,cantonales
2839,74,HAUTE SAVOIE,7782,3554,82,3472,2011,t1,cantonales
2840,74,HAUTE SAVOIE,21052,7621,95,7526,2011,t1,cantonales
2841,74,HAUTE SAVOIE,3684,2051,43,2008,2011,t1,cantonales
2842,74,HAUTE SAVOIE,31931,11960,210,11750,2011,t1,cantonales
2843,74,HAUTE SAVOIE,30486,12018,233,11785,2011,t1,cantonales
2844,74,HAUTE SAVOIE,24915,8996,211,8785,2011,t1,cantonales
2845,76,SEINE MARITIME,5331,2931,78,2853,2011,t1,cantonales
2846,76,SEINE MARITIME,8690,4635,124,4511,2011,t1,cantonales
2847,76,SEINE MARITIME,5664,2800,93,2707,2011,t1,cantonales
2848,76,SEINE MARITIME,7962,4520,145,4375,2011,t1,cantonales
2849,76,SEINE MARITIME,7115,4059,106,3953,2011,t1,cantonales
2850,76,SEINE MARITIME,11929,6410,140,6270,2011,t1,cantonales
2851,76,SEINE MARITIME,19599,8716,178,8538,2011,t1,cantonales
2852,76,SEINE MARITIME,13797,6466,135,6331,2011,t1,cantonales
2853,76,SEINE MARITIME,19514,9394,256,9138,2011,t1,cantonales
2854,76,SEINE MARITIME,6385,3643,75,3568,2011,t1,cantonales
2855,76,SEINE MARITIME,21400,9443,169,9274,2011,t1,cantonales
2856,76,SEINE MARITIME,3770,2252,55,2197,2011,t1,cantonales
2857,76,SEINE MARITIME,20469,9214,235,8979,2011,t1,cantonales
2858,76,SEINE MARITIME,15097,4894,169,4725,2011,t1,cantonales
2859,76,SEINE MARITIME,10059,3271,88,3183,2011,t1,cantonales
2860,76,SEINE MARITIME,20936,8950,183,8767,2011,t1,cantonales
2861,76,SEINE MARITIME,3941,2205,85,2120,2011,t1,cantonales
2862,76,SEINE MARITIME,6065,3261,107,3154,2011,t1,cantonales
2863,76,SEINE MARITIME,16564,7049,150,6899,2011,t1,cantonales
2864,76,SEINE MARITIME,8982,5174,94,5080,2011,t1,cantonales
2865,76,SEINE MARITIME,3552,1961,43,1918,2011,t1,cantonales
2866,76,SEINE MARITIME,22756,10219,292,9927,2011,t1,cantonales
2867,76,SEINE MARITIME,5747,2393,61,2332,2011,t1,cantonales
2868,76,SEINE MARITIME,7595,2948,48,2900,2011,t1,cantonales
2869,76,SEINE MARITIME,12087,4499,88,4411,2011,t1,cantonales
2870,76,SEINE MARITIME,7310,3488,106,3382,2011,t1,cantonales
2871,76,SEINE MARITIME,9404,4883,135,4748,2011,t1,cantonales
2872,76,SEINE MARITIME,8499,4384,92,4292,2011,t1,cantonales
2873,76,SEINE MARITIME,12735,3683,105,3578,2011,t1,cantonales
2874,76,SEINE MARITIME,13776,5890,129,5761,2011,t1,cantonales
2875,76,SEINE MARITIME,20525,8585,136,8449,2011,t1,cantonales
2876,76,SEINE MARITIME,7170,2991,65,2926,2011,t1,cantonales
2877,76,SEINE MARITIME,14787,6480,106,6374,2011,t1,cantonales
2878,76,SEINE MARITIME,13804,5575,295,5280,2011,t1,cantonales
2879,77,SEINE ET MARNE,10888,4724,115,4609,2011,t1,cantonales
2880,77,SEINE ET MARNE,17633,7323,146,7177,2011,t1,cantonales
2881,77,SEINE ET MARNE,19288,7475,104,7371,2011,t1,cantonales
2882,77,SEINE ET MARNE,10895,5072,137,4935,2011,t1,cantonales
2883,77,SEINE ET MARNE,24789,9377,230,9147,2011,t1,cantonales
2884,77,SEINE ET MARNE,11779,4746,90,4656,2011,t1,cantonales
2885,77,SEINE ET MARNE,20274,8119,334,7785,2011,t1,cantonales
2886,77,SEINE ET MARNE,24256,10242,190,10052,2011,t1,cantonales
2887,77,SEINE ET MARNE,15454,6003,161,5842,2011,t1,cantonales
2888,77,SEINE ET MARNE,20074,8160,185,7975,2011,t1,cantonales
2889,77,SEINE ET MARNE,13301,5406,101,5305,2011,t1,cantonales
2890,77,SEINE ET MARNE,9381,4039,66,3973,2011,t1,cantonales
2891,77,SEINE ET MARNE,16742,6745,169,6576,2011,t1,cantonales
2892,77,SEINE ET MARNE,16520,6671,134,6537,2011,t1,cantonales
2893,77,SEINE ET MARNE,5690,2741,83,2658,2011,t1,cantonales
2894,77,SEINE ET MARNE,27678,10142,145,9997,2011,t1,cantonales
2895,77,SEINE ET MARNE,30380,9202,189,9013,2011,t1,cantonales
2896,77,SEINE ET MARNE,20536,7576,135,7441,2011,t1,cantonales
2897,77,SEINE ET MARNE,18849,6310,108,6202,2011,t1,cantonales
2898,77,SEINE ET MARNE,20241,7155,160,6995,2011,t1,cantonales
2899,77,SEINE ET MARNE,30579,9725,262,9463,2011,t1,cantonales
2900,77,SEINE ET MARNE,23800,9261,159,9102,2011,t1,cantonales
2901,77,SEINE ET MARNE,31240,11081,306,10775,2011,t1,cantonales
2902,78,YVELINES,21395,7714,180,7534,2011,t1,cantonales
2903,78,YVELINES,20512,7104,108,6996,2011,t1,cantonales
2904,78,YVELINES,23595,9110,150,8960,2011,t1,cantonales
2905,78,YVELINES,13776,5653,125,5528,2011,t1,cantonales
2906,78,YVELINES,18345,7927,151,7776,2011,t1,cantonales
2907,78,YVELINES,27909,10328,261,10067,2011,t1,cantonales
2908,78,YVELINES,20433,8435,112,8323,2011,t1,cantonales
2909,78,YVELINES,31531,13789,224,13565,2011,t1,cantonales
2910,78,YVELINES,14138,5176,82,5094,2011,t1,cantonales
2911,78,YVELINES,15948,6839,132,6707,2011,t1,cantonales
2912,78,YVELINES,18565,6196,87,6109,2011,t1,cantonales
2913,78,YVELINES,28527,10065,110,9955,2011,t1,cantonales
2914,78,YVELINES,19091,7623,67,7556,2011,t1,cantonales
2915,78,YVELINES,27426,10381,138,10243,2011,t1,cantonales
2916,78,YVELINES,22016,8645,119,8526,2011,t1,cantonales
2917,78,YVELINES,23140,8870,100,8770,2011,t1,cantonales
2918,78,YVELINES,16973,6292,83,6209,2011,t1,cantonales
2919,78,YVELINES,26327,10054,207,9847,2011,t1,cantonales
2920,78,YVELINES,30579,10968,215,10753,2011,t1,cantonales
2921,78,YVELINES,16466,6304,92,6212,2011,t1,cantonales
2922,79,DEUX SEVRES,8565,3594,138,3456,2011,t1,cantonales
2923,79,DEUX SEVRES,10386,4646,472,4174,2011,t1,cantonales
2924,79,DEUX SEVRES,4274,2287,63,2224,2011,t1,cantonales
2925,79,DEUX SEVRES,7829,3884,91,3793,2011,t1,cantonales
2926,79,DEUX SEVRES,4480,2244,162,2082,2011,t1,cantonales
2927,79,DEUX SEVRES,3682,2390,61,2329,2011,t1,cantonales
2928,79,DEUX SEVRES,8405,4215,188,4027,2011,t1,cantonales
2929,79,DEUX SEVRES,3943,2169,70,2099,2011,t1,cantonales
2930,79,DEUX SEVRES,17526,5974,177,5797,2011,t1,cantonales
2931,79,DEUX SEVRES,10768,4281,156,4125,2011,t1,cantonales
2932,79,DEUX SEVRES,6926,3244,84,3160,2011,t1,cantonales
2933,79,DEUX SEVRES,4237,2242,89,2153,2011,t1,cantonales
2934,79,DEUX SEVRES,4175,2251,125,2126,2011,t1,cantonales
2935,79,DEUX SEVRES,3294,1669,112,1557,2011,t1,cantonales
2936,79,DEUX SEVRES,8574,3512,169,3343,2011,t1,cantonales
2937,79,DEUX SEVRES,12551,4168,151,4017,2011,t1,cantonales
2938,80,SOMME,13029,5593,175,5418,2011,t1,cantonales
2939,80,SOMME,5018,2953,111,2842,2011,t1,cantonales
2940,80,SOMME,5857,3693,109,3584,2011,t1,cantonales
2941,80,SOMME,13295,7211,219,6992,2011,t1,cantonales
2942,80,SOMME,15955,6275,346,5929,2011,t1,cantonales
2943,80,SOMME,8506,4783,152,4631,2011,t1,cantonales
2944,80,SOMME,3228,2058,33,2025,2011,t1,cantonales
2945,80,SOMME,7145,3941,197,3744,2011,t1,cantonales
2946,80,SOMME,15840,8416,279,8137,2011,t1,cantonales
2947,80,SOMME,9932,4932,199,4733,2011,t1,cantonales
2948,80,SOMME,9669,5641,208,5433,2011,t1,cantonales
2949,80,SOMME,8056,4496,127,4369,2011,t1,cantonales
2950,80,SOMME,9075,4711,167,4544,2011,t1,cantonales
2951,80,SOMME,7471,4101,198,3903,2011,t1,cantonales
2952,80,SOMME,6052,3261,81,3180,2011,t1,cantonales
2953,80,SOMME,5914,3522,61,3461,2011,t1,cantonales
2954,80,SOMME,9629,5014,133,4881,2011,t1,cantonales
2955,80,SOMME,9942,4933,205,4728,2011,t1,cantonales
2956,80,SOMME,10149,5545,108,5437,2011,t1,cantonales
2957,80,SOMME,14556,5466,187,5279,2011,t1,cantonales
2958,80,SOMME,10209,4351,119,4232,2011,t1,cantonales
2959,80,SOMME,11373,4343,130,4213,2011,t1,cantonales
2960,80,SOMME,9515,5438,158,5280,2011,t1,cantonales
2961,81,TARN,2362,1630,66,1564,2011,t1,cantonales
2962,81,TARN,7223,3617,70,3547,2011,t1,cantonales
2963,81,TARN,695,553,42,511,2011,t1,cantonales
2964,81,TARN,3002,1712,59,1653,2011,t1,cantonales
2965,81,TARN,3055,1954,63,1891,2011,t1,cantonales
2966,81,TARN,1920,1260,32,1228,2011,t1,cantonales
2967,81,TARN,12141,6400,494,5906,2011,t1,cantonales
2968,81,TARN,9797,4949,161,4788,2011,t1,cantonales
2969,81,TARN,3715,2354,83,2271,2011,t1,cantonales
2970,81,TARN,4311,2552,70,2482,2011,t1,cantonales
2971,81,TARN,10753,5316,134,5182,2011,t1,cantonales
2972,81,TARN,2119,1534,88,1446,2011,t1,cantonales
2973,81,TARN,1618,1242,62,1180,2011,t1,cantonales
2974,81,TARN,7116,4398,139,4259,2011,t1,cantonales
2975,81,TARN,5202,2938,101,2837,2011,t1,cantonales
2976,81,TARN,3388,1877,109,1768,2011,t1,cantonales
2977,81,TARN,2227,1348,45,1303,2011,t1,cantonales
2978,81,TARN,2717,1730,81,1649,2011,t1,cantonales
2979,81,TARN,9292,4700,160,4540,2011,t1,cantonales
2980,81,TARN,9654,4568,181,4387,2011,t1,cantonales
2981,81,TARN,9193,4509,149,4360,2011,t1,cantonales
2982,81,TARN,9002,4550,129,4421,2011,t1,cantonales
2983,81,TARN,7345,3761,106,3655,2011,t1,cantonales
2984,82,TARN ET GARONNE,5002,3349,67,3282,2011,t1,cantonales
2985,82,TARN ET GARONNE,4766,2231,49,2182,2011,t1,cantonales
2986,82,TARN ET GARONNE,10718,6297,152,6145,2011,t1,cantonales
2987,82,TARN ET GARONNE,11110,5798,138,5660,2011,t1,cantonales
2988,82,TARN ET GARONNE,4000,2399,61,2338,2011,t1,cantonales
2989,82,TARN ET GARONNE,3661,2501,47,2454,2011,t1,cantonales
2990,82,TARN ET GARONNE,2900,1686,50,1636,2011,t1,cantonales
2991,82,TARN ET GARONNE,1834,1252,34,1218,2011,t1,cantonales
2992,82,TARN ET GARONNE,7573,3806,100,3706,2011,t1,cantonales
2993,82,TARN ET GARONNE,2607,1555,70,1485,2011,t1,cantonales
2994,82,TARN ET GARONNE,3997,2402,80,2322,2011,t1,cantonales
2995,82,TARN ET GARONNE,7488,4092,101,3991,2011,t1,cantonales
2996,82,TARN ET GARONNE,5777,2748,73,2675,2011,t1,cantonales
2997,82,TARN ET GARONNE,6985,3232,71,3161,2011,t1,cantonales
2998,83,VAR,11045,5661,104,5557,2011,t1,cantonales
2999,83,VAR,19805,8544,183,8361,2011,t1,cantonales
3000,83,VAR,5451,2702,57,2645,2011,t1,cantonales
3001,83,VAR,37921,16132,446,15686,2011,t1,cantonales
3002,83,VAR,17652,7128,149,6979,2011,t1,cantonales
3003,83,VAR,14279,7390,124,7266,2011,t1,cantonales
3004,83,VAR,16419,8095,173,7922,2011,t1,cantonales
3005,83,VAR,33614,13357,192,13165,2011,t1,cantonales
3006,83,VAR,10350,4907,116,4791,2011,t1,cantonales
3007,83,VAR,24659,11585,225,11360,2011,t1,cantonales
3008,83,VAR,18087,7003,161,6842,2011,t1,cantonales
3009,83,VAR,24494,8512,211,8301,2011,t1,cantonales
3010,83,VAR,4467,2536,42,2494,2011,t1,cantonales
3011,83,VAR,15021,5339,134,5205,2011,t1,cantonales
3012,83,VAR,6224,1803,36,1767,2011,t1,cantonales
3013,83,VAR,9362,3190,63,3127,2011,t1,cantonales
3014,83,VAR,21235,10643,170,10473,2011,t1,cantonales
3015,83,VAR,28963,12371,242,12129,2011,t1,cantonales
3016,83,VAR,28686,11726,195,11531,2011,t1,cantonales
3017,83,VAR,19852,8131,161,7970,2011,t1,cantonales
3018,83,VAR,27614,11829,211,11618,2011,t1,cantonales
3019,83,VAR,19929,8188,205,7983,2011,t1,cantonales
3020,84,VAUCLUSE,15089,7388,123,7265,2011,t1,cantonales
3021,84,VAUCLUSE,11446,4782,231,4551,2011,t1,cantonales
3022,84,VAUCLUSE,4195,2301,49,2252,2011,t1,cantonales
3023,84,VAUCLUSE,26201,12665,519,12146,2011,t1,cantonales
3024,84,VAUCLUSE,3731,2131,73,2058,2011,t1,cantonales
3025,84,VAUCLUSE,14047,6454,147,6307,2011,t1,cantonales
3026,84,VAUCLUSE,21001,9264,211,9053,2011,t1,cantonales
3027,84,VAUCLUSE,30941,14556,344,14212,2011,t1,cantonales
3028,84,VAUCLUSE,3948,2656,77,2579,2011,t1,cantonales
3029,84,VAUCLUSE,7679,4312,90,4222,2011,t1,cantonales
3030,84,VAUCLUSE,20139,8876,239,8637,2011,t1,cantonales
3031,84,VAUCLUSE,23120,9470,199,9271,2011,t1,cantonales
3032,85,VENDEE,7610,3877,81,3796,2011,t1,cantonales
3033,85,VENDEE,6211,3208,116,3092,2011,t1,cantonales
3034,85,VENDEE,23663,9995,251,9744,2011,t1,cantonales
3035,85,VENDEE,11998,5475,220,5255,2011,t1,cantonales
3036,85,VENDEE,15672,6986,171,6815,2011,t1,cantonales
3037,85,VENDEE,20186,10014,296,9718,2011,t1,cantonales
3038,85,VENDEE,6997,3610,134,3476,2011,t1,cantonales
3039,85,VENDEE,4284,2048,58,1990,2011,t1,cantonales
3040,85,VENDEE,8665,4699,79,4620,2011,t1,cantonales
3041,85,VENDEE,20916,9567,319,9248,2011,t1,cantonales
3042,85,VENDEE,8467,4450,148,4302,2011,t1,cantonales
3043,85,VENDEE,22825,9060,340,8720,2011,t1,cantonales
3044,85,VENDEE,38344,16752,415,16337,2011,t1,cantonales
3045,85,VENDEE,12013,6217,187,6030,2011,t1,cantonales
3046,85,VENDEE,6325,3010,91,2919,2011,t1,cantonales
3047,85,VENDEE,15077,7432,194,7238,2011,t1,cantonales
3048,86,VIENNE,2877,1647,90,1557,2011,t1,cantonales
3049,86,VIENNE,8702,4993,108,4885,2011,t1,cantonales
3050,86,VIENNE,6501,3607,126,3481,2011,t1,cantonales
3051,86,VIENNE,5956,2997,108,2889,2011,t1,cantonales
3052,86,VIENNE,4047,2101,60,2041,2011,t1,cantonales
3053,86,VIENNE,9346,4438,207,4231,2011,t1,cantonales
3054,86,VIENNE,8193,4089,222,3867,2011,t1,cantonales
3055,86,VIENNE,6591,3534,102,3432,2011,t1,cantonales
3056,86,VIENNE,5004,2410,119,2291,2011,t1,cantonales
3057,86,VIENNE,3672,2316,79,2237,2011,t1,cantonales
3058,86,VIENNE,12369,5431,195,5236,2011,t1,cantonales
3059,86,VIENNE,5331,3136,57,3079,2011,t1,cantonales
3060,86,VIENNE,10071,4756,168,4588,2011,t1,cantonales
3061,86,VIENNE,2372,1384,41,1343,2011,t1,cantonales
3062,86,VIENNE,3818,1956,64,1892,2011,t1,cantonales
3063,86,VIENNE,11395,5689,159,5530,2011,t1,cantonales
3064,86,VIENNE,10632,3971,132,3839,2011,t1,cantonales
3065,86,VIENNE,11203,4557,74,4483,2011,t1,cantonales
3066,86,VIENNE,10828,3876,210,3666,2011,t1,cantonales
3067,87,HAUTE VIENNE,14808,8049,229,7820,2011,t1,cantonales
3068,87,HAUTE VIENNE,12570,6442,280,6162,2011,t1,cantonales
3069,87,HAUTE VIENNE,5347,3126,101,3025,2011,t1,cantonales
3070,87,HAUTE VIENNE,3248,1840,120,1720,2011,t1,cantonales
3071,87,HAUTE VIENNE,4717,3008,150,2858,2011,t1,cantonales
3072,87,HAUTE VIENNE,4785,1957,67,1890,2011,t1,cantonales
3073,87,HAUTE VIENNE,5265,2047,105,1942,2011,t1,cantonales
3074,87,HAUTE VIENNE,2745,1795,41,1754,2011,t1,cantonales
3075,87,HAUTE VIENNE,5948,3442,125,3317,2011,t1,cantonales
3076,87,HAUTE VIENNE,5178,3320,93,3227,2011,t1,cantonales
3077,87,HAUTE VIENNE,8769,4365,209,4156,2011,t1,cantonales
3078,87,HAUTE VIENNE,3723,2196,114,2082,2011,t1,cantonales
3079,87,HAUTE VIENNE,7808,4222,236,3986,2011,t1,cantonales
3080,87,HAUTE VIENNE,3420,1742,133,1609,2011,t1,cantonales
3081,87,HAUTE VIENNE,8354,3406,84,3322,2011,t1,cantonales
3082,87,HAUTE VIENNE,9698,4989,238,4751,2011,t1,cantonales
3083,87,HAUTE VIENNE,8086,4326,181,4145,2011,t1,cantonales
3084,87,HAUTE VIENNE,8382,4090,156,3934,2011,t1,cantonales
3085,87,HAUTE VIENNE,16524,7706,495,7211,2011,t1,cantonales
3086,87,HAUTE VIENNE,5623,2330,161,2169,2011,t1,cantonales
3087,87,HAUTE VIENNE,6781,2852,105,2747,2011,t1,cantonales
3088,88,VOSGES,2092,1260,39,1221,2011,t1,cantonales
3089,88,VOSGES,11586,5963,225,5738,2011,t1,cantonales
3090,88,VOSGES,15166,6464,383,6081,2011,t1,cantonales
3091,88,VOSGES,5186,2992,85,2907,2011,t1,cantonales
3092,88,VOSGES,4624,2847,175,2672,2011,t1,cantonales
3093,88,VOSGES,18653,7708,228,7480,2011,t1,cantonales
3094,88,VOSGES,9587,4576,145,4431,2011,t1,cantonales
3095,88,VOSGES,8283,4262,150,4112,2011,t1,cantonales
3096,88,VOSGES,8576,4932,140,4792,2011,t1,cantonales
3097,88,VOSGES,2034,1366,35,1331,2011,t1,cantonales
3098,88,VOSGES,9939,5493,154,5339,2011,t1,cantonales
3099,88,VOSGES,14098,6775,166,6609,2011,t1,cantonales
3100,88,VOSGES,15677,8079,264,7815,2011,t1,cantonales
3101,88,VOSGES,12143,6345,244,6101,2011,t1,cantonales
3102,88,VOSGES,8175,4131,149,3982,2011,t1,cantonales
3103,89,YONNE,10152,4184,206,3978,2011,t1,cantonales
3104,89,YONNE,8671,4469,159,4310,2011,t1,cantonales
3105,89,YONNE,3673,2144,42,2102,2011,t1,cantonales
3106,89,YONNE,2283,1316,43,1273,2011,t1,cantonales
3107,89,YONNE,3552,1868,49,1819,2011,t1,cantonales
3108,89,YONNE,4701,2721,63,2658,2011,t1,cantonales
3109,89,YONNE,2394,1426,33,1393,2011,t1,cantonales
3110,89,YONNE,3785,1768,76,1692,2011,t1,cantonales
3111,89,YONNE,2466,1425,38,1387,2011,t1,cantonales
3112,89,YONNE,3881,1961,44,1917,2011,t1,cantonales
3113,89,YONNE,11529,4954,111,4843,2011,t1,cantonales
3114,89,YONNE,1901,1178,33,1145,2011,t1,cantonales
3115,89,YONNE,4981,2329,39,2290,2011,t1,cantonales
3116,89,YONNE,8535,3547,300,3247,2011,t1,cantonales
3117,89,YONNE,8789,3364,80,3284,2011,t1,cantonales
3118,89,YONNE,5757,2845,79,2766,2011,t1,cantonales
3119,89,YONNE,3704,2187,57,2130,2011,t1,cantonales
3120,89,YONNE,3573,2107,99,2008,2011,t1,cantonales
3121,89,YONNE,6558,2684,79,2605,2011,t1,cantonales
3122,89,YONNE,11331,4053,111,3942,2011,t1,cantonales
3123,89,YONNE,8211,3568,87,3481,2011,t1,cantonales
3124,89,YONNE,8743,3461,98,3363,2011,t1,cantonales
3125,90,TERRITOIRE DE BELFORT,5627,2418,62,2356,2011,t1,cantonales
3126,90,TERRITOIRE DE BELFORT,7480,3729,291,3438,2011,t1,cantonales
3127,90,TERRITOIRE DE BELFORT,7502,2962,131,2831,2011,t1,cantonales
3128,90,TERRITOIRE DE BELFORT,4803,2032,67,1965,2011,t1,cantonales
3129,90,TERRITOIRE DE BELFORT,4243,1694,76,1618,2011,t1,cantonales
3130,90,TERRITOIRE DE BELFORT,7737,4012,137,3875,2011,t1,cantonales
3131,90,TERRITOIRE DE BELFORT,7775,4003,135,3868,2011,t1,cantonales
3132,90,TERRITOIRE DE BELFORT,4445,2252,69,2183,2011,t1,cantonales
3133,91,ESSONNE,26852,11041,421,10620,2011,t1,cantonales
3134,91,ESSONNE,21624,8243,153,8090,2011,t1,cantonales
3135,91,ESSONNE,13174,4366,102,4264,2011,t1,cantonales
3136,91,ESSONNE,11091,5148,97,5051,2011,t1,cantonales
3137,91,ESSONNE,14876,6748,163,6585,2011,t1,cantonales
3138,91,ESSONNE,24367,8518,550,7968,2011,t1,cantonales
3139,91,ESSONNE,13334,5442,101,5341,2011,t1,cantonales
3140,91,ESSONNE,10630,5106,98,5008,2011,t1,cantonales
3141,91,ESSONNE,10416,4763,97,4666,2011,t1,cantonales
3142,91,ESSONNE,25424,10096,184,9912,2011,t1,cantonales
3143,91,ESSONNE,17294,8174,116,8058,2011,t1,cantonales
3144,91,ESSONNE,20930,8523,188,8335,2011,t1,cantonales
3145,91,ESSONNE,23133,8934,150,8784,2011,t1,cantonales
3146,91,ESSONNE,18154,7809,151,7658,2011,t1,cantonales
3147,91,ESSONNE,16452,7208,77,7131,2011,t1,cantonales
3148,91,ESSONNE,16445,6356,127,6229,2011,t1,cantonales
3149,91,ESSONNE,15959,6556,156,6400,2011,t1,cantonales
3150,91,ESSONNE,17686,6693,135,6558,2011,t1,cantonales
3151,91,ESSONNE,11187,3725,89,3636,2011,t1,cantonales
3152,91,ESSONNE,13941,5699,99,5600,2011,t1,cantonales
3153,91,ESSONNE,11051,4469,95,4374,2011,t1,cantonales
3154,92,HAUTS DE SEINE,22926,8055,162,7893,2011,t1,cantonales
3155,92,HAUTS DE SEINE,21651,7213,215,6998,2011,t1,cantonales
3156,92,HAUTS DE SEINE,22882,10233,146,10087,2011,t1,cantonales
3157,92,HAUTS DE SEINE,20909,8909,155,8754,2011,t1,cantonales
3158,92,HAUTS DE SEINE,26793,11045,233,10812,2011,t1,cantonales
3159,92,HAUTS DE SEINE,12899,4483,110,4373,2011,t1,cantonales
3160,92,HAUTS DE SEINE,29513,10722,309,10413,2011,t1,cantonales
3161,92,HAUTS DE SEINE,17045,6937,115,6822,2011,t1,cantonales
3162,92,HAUTS DE SEINE,11040,4280,97,4183,2011,t1,cantonales
3163,92,HAUTS DE SEINE,19095,7375,197,7178,2011,t1,cantonales
3164,92,HAUTS DE SEINE,26772,10366,246,10120,2011,t1,cantonales
3165,92,HAUTS DE SEINE,19536,8024,145,7879,2011,t1,cantonales
3166,92,HAUTS DE SEINE,25505,11054,154,10900,2011,t1,cantonales
3167,92,HAUTS DE SEINE,26490,11043,135,10908,2011,t1,cantonales
3168,92,HAUTS DE SEINE,9963,3147,95,3052,2011,t1,cantonales
3169,92,HAUTS DE SEINE,20398,8380,76,8304,2011,t1,cantonales
3170,92,HAUTS DE SEINE,30502,14680,230,14450,2011,t1,cantonales
3171,92,HAUTS DE SEINE,28117,13294,460,12834,2011,t1,cantonales
3172,92,HAUTS DE SEINE,35525,14131,199,13932,2011,t1,cantonales
3173,92,HAUTS DE SEINE,19033,7387,137,7250,2011,t1,cantonales
3174,92,HAUTS DE SEINE,16615,7226,99,7127,2011,t1,cantonales
3175,92,HAUTS DE SEINE,17286,7949,108,7841,2011,t1,cantonales
3176,92,HAUTS DE SEINE,16043,7055,187,6868,2011,t1,cantonales
3177,92,HAUTS DE SEINE,16307,5944,125,5819,2011,t1,cantonales
3178,93,SEINE SAINT-DENIS,15162,4202,89,4113,2011,t1,cantonales
3179,93,SEINE SAINT-DENIS,26519,8103,181,7922,2011,t1,cantonales
3180,93,SEINE SAINT-DENIS,14054,5148,96,5052,2011,t1,cantonales
3181,93,SEINE SAINT-DENIS,19592,6953,145,6808,2011,t1,cantonales
3182,93,SEINE SAINT-DENIS,23602,7377,118,7259,2011,t1,cantonales
3183,93,SEINE SAINT-DENIS,21902,7861,139,7722,2011,t1,cantonales
3184,93,SEINE SAINT-DENIS,20236,6411,114,6297,2011,t1,cantonales
3185,93,SEINE SAINT-DENIS,17296,6015,109,5906,2011,t1,cantonales
3186,93,SEINE SAINT-DENIS,38605,12267,314,11953,2011,t1,cantonales
3187,93,SEINE SAINT-DENIS,11216,4220,67,4153,2011,t1,cantonales
3188,93,SEINE SAINT-DENIS,21915,7484,375,7109,2011,t1,cantonales
3189,93,SEINE SAINT-DENIS,20091,6467,121,6346,2011,t1,cantonales
3190,93,SEINE SAINT-DENIS,12693,4083,78,4005,2011,t1,cantonales
3191,93,SEINE SAINT-DENIS,22083,7701,220,7481,2011,t1,cantonales
3192,93,SEINE SAINT-DENIS,12228,3493,81,3412,2011,t1,cantonales
3193,93,SEINE SAINT-DENIS,12478,4096,114,3982,2011,t1,cantonales
3194,93,SEINE SAINT-DENIS,22002,6559,194,6365,2011,t1,cantonales
3195,93,SEINE SAINT-DENIS,10310,3894,72,3822,2011,t1,cantonales
3196,93,SEINE SAINT-DENIS,16640,4678,130,4548,2011,t1,cantonales
3197,93,SEINE SAINT-DENIS,18216,6213,143,6070,2011,t1,cantonales
3198,94,VAL DE MARNE,8840,3400,81,3319,2011,t1,cantonales
3199,94,VAL DE MARNE,15781,6088,126,5962,2011,t1,cantonales
3200,94,VAL DE MARNE,27601,10379,158,10221,2011,t1,cantonales
3201,94,VAL DE MARNE,9736,3494,62,3432,2011,t1,cantonales
3202,94,VAL DE MARNE,18533,7049,133,6916,2011,t1,cantonales
3203,94,VAL DE MARNE,15753,5883,119,5764,2011,t1,cantonales
3204,94,VAL DE MARNE,13140,4909,92,4817,2011,t1,cantonales
3205,94,VAL DE MARNE,14056,4543,97,4446,2011,t1,cantonales
3206,94,VAL DE MARNE,16741,6845,110,6735,2011,t1,cantonales
3207,94,VAL DE MARNE,17899,6957,195,6762,2011,t1,cantonales
3208,94,VAL DE MARNE,21441,7711,101,7610,2011,t1,cantonales
3209,94,VAL DE MARNE,21840,7591,98,7493,2011,t1,cantonales
3210,94,VAL DE MARNE,20214,8182,172,8010,2011,t1,cantonales
3211,94,VAL DE MARNE,16192,6517,101,6416,2011,t1,cantonales
3212,94,VAL DE MARNE,12483,4437,69,4368,2011,t1,cantonales
3213,94,VAL DE MARNE,9894,3059,55,3004,2011,t1,cantonales
3214,94,VAL DE MARNE,15339,5409,187,5222,2011,t1,cantonales
3215,94,VAL DE MARNE,19525,5469,177,5292,2011,t1,cantonales
3216,94,VAL DE MARNE,16308,6535,131,6404,2011,t1,cantonales
3217,94,VAL DE MARNE,9458,3479,88,3391,2011,t1,cantonales
3218,94,VAL DE MARNE,13805,4732,69,4663,2011,t1,cantonales
3219,94,VAL DE MARNE,13891,5614,108,5506,2011,t1,cantonales
3220,94,VAL DE MARNE,14223,4237,118,4119,2011,t1,cantonales
3221,94,VAL DE MARNE,10062,2886,73,2813,2011,t1,cantonales
3222,94,VAL DE MARNE,15310,5441,101,5340,2011,t1,cantonales
3223,95,VAL D'OISE,13999,5894,186,5708,2011,t1,cantonales
3224,95,VAL D'OISE,19225,7311,101,7210,2011,t1,cantonales
3225,95,VAL D'OISE,16049,6259,124,6135,2011,t1,cantonales
3226,95,VAL D'OISE,20409,7252,119,7133,2011,t1,cantonales
3227,95,VAL D'OISE,21303,7368,140,7228,2011,t1,cantonales
3228,95,VAL D'OISE,20332,6470,76,6394,2011,t1,cantonales
3229,95,VAL D'OISE,11435,5176,104,5072,2011,t1,cantonales
3230,95,VAL D'OISE,8283,4126,86,4040,2011,t1,cantonales
3231,95,VAL D'OISE,18389,6961,113,6848,2011,t1,cantonales
3232,95,VAL D'OISE,17518,5891,99,5792,2011,t1,cantonales
3233,95,VAL D'OISE,16209,5995,114,5881,2011,t1,cantonales
3234,95,VAL D'OISE,14532,4096,116,3980,2011,t1,cantonales
3235,95,VAL D'OISE,14892,6218,120,6098,2011,t1,cantonales
3236,95,VAL D'OISE,16101,6302,93,6209,2011,t1,cantonales
3237,95,VAL D'OISE,20185,7955,134,7821,2011,t1,cantonales
3238,95,VAL D'OISE,13187,2708,56,2652,2011,t1,cantonales
3239,95,VAL D'OISE,12922,6259,87,6172,2011,t1,cantonales
3240,95,VAL D'OISE,17738,6492,279,6213,2011,t1,cantonales
3241,95,VAL D'OISE,9939,3272,63,3209,2011,t1,cantonales
3242,971,GUADELOUPE,7299,3451,293,3158,2011,t1,cantonales
3243,971,GUADELOUPE,9868,4813,247,4566,2011,t1,cantonales
3244,971,GUADELOUPE,18668,6837,534,6303,2011,t1,cantonales
3245,971,GUADELOUPE,6117,2445,207,2238,2011,t1,cantonales
3246,971,GUADELOUPE,1583,749,89,660,2011,t1,cantonales
3247,971,GUADELOUPE,11613,6052,265,5787,2011,t1,cantonales
3248,971,GUADELOUPE,6950,3051,179,2872,2011,t1,cantonales
3249,971,GUADELOUPE,6370,3071,158,2913,2011,t1,cantonales
3250,971,GUADELOUPE,10830,3957,256,3701,2011,t1,cantonales
3251,971,GUADELOUPE,5841,2568,216,2352,2011,t1,cantonales
3252,971,GUADELOUPE,13374,4974,400,4574,2011,t1,cantonales
3253,971,GUADELOUPE,4167,1346,121,1225,2011,t1,cantonales
3254,971,GUADELOUPE,4216,1485,117,1368,2011,t1,cantonales
3255,971,GUADELOUPE,5785,1923,221,1702,2011,t1,cantonales
3256,971,GUADELOUPE,6917,3434,211,3223,2011,t1,cantonales
3257,971,GUADELOUPE,7759,2834,138,2696,2011,t1,cantonales
3258,971,GUADELOUPE,8557,2734,275,2459,2011,t1,cantonales
3259,971,GUADELOUPE,8871,4052,329,3723,2011,t1,cantonales
3260,971,GUADELOUPE,6756,2457,197,2260,2011,t1,cantonales
3261,972,MARTINIQUE,11699,4154,303,3851,2011,t1,cantonales
3262,972,MARTINIQUE,3525,865,41,824,2011,t1,cantonales
3263,972,MARTINIQUE,4859,1266,92,1174,2011,t1,cantonales
3264,972,MARTINIQUE,6663,4272,192,4080,2011,t1,cantonales
3265,972,MARTINIQUE,1979,1220,26,1194,2011,t1,cantonales
3266,972,MARTINIQUE,3236,1714,80,1634,2011,t1,cantonales
3267,972,MARTINIQUE,1481,1227,26,1201,2011,t1,cantonales
3268,972,MARTINIQUE,10762,3768,191,3577,2011,t1,cantonales
3269,972,MARTINIQUE,9137,3542,182,3360,2011,t1,cantonales
3270,972,MARTINIQUE,7876,2011,312,1699,2011,t1,cantonales
3271,972,MARTINIQUE,7004,3201,255,2946,2011,t1,cantonales
3272,972,MARTINIQUE,7582,1996,211,1785,2011,t1,cantonales
3273,972,MARTINIQUE,9941,3126,251,2875,2011,t1,cantonales
3274,972,MARTINIQUE,5229,2009,111,1898,2011,t1,cantonales
3275,972,MARTINIQUE,8017,2918,167,2751,2011,t1,cantonales
3276,972,MARTINIQUE,9084,2285,255,2030,2011,t1,cantonales
3277,972,MARTINIQUE,9499,2650,210,2440,2011,t1,cantonales
3278,972,MARTINIQUE,7255,1961,208,1753,2011,t1,cantonales
3279,972,MARTINIQUE,7525,3245,139,3106,2011,t1,cantonales
3280,972,MARTINIQUE,10388,3069,267,2802,2011,t1,cantonales
3281,972,MARTINIQUE,9386,3560,235,3325,2011,t1,cantonales
3282,972,MARTINIQUE,9899,3982,216,3766,2011,t1,cantonales
3283,972,MARTINIQUE,7906,2280,200,2080,2011,t1,cantonales
3284,973,GUYANE,620,382,2,380,2011,t1,cantonales
3285,973,GUYANE,2843,610,50,560,2011,t1,cantonales
3286,973,GUYANE,930,557,15,542,2011,t1,cantonales
3287,973,GUYANE,7795,2786,147,2639,2011,t1,cantonales
3288,973,GUYANE,2004,635,33,602,2011,t1,cantonales
3289,973,GUYANE,9210,2384,123,2261,2011,t1,cantonales
3290,973,GUYANE,1653,912,28,884,2011,t1,cantonales
3291,973,GUYANE,1951,1161,28,1133,2011,t1,cantonales
3292,973,GUYANE,4197,1716,41,1675,2011,t1,cantonales
3293,974,LA REUNION,7398,4871,212,4659,2011,t1,cantonales
3294,974,LA REUNION,10199,5872,372,5500,2011,t1,cantonales
3295,974,LA REUNION,11021,4860,526,4334,2011,t1,cantonales
3296,974,LA REUNION,18670,8541,473,8068,2011,t1,cantonales
3297,974,LA REUNION,10499,5272,307,4965,2011,t1,cantonales
3298,974,LA REUNION,11362,5736,287,5449,2011,t1,cantonales
3299,974,LA REUNION,13768,5211,338,4873,2011,t1,cantonales
3300,974,LA REUNION,13881,7783,598,7185,2011,t1,cantonales
3301,974,LA REUNION,13017,7120,660,6460,2011,t1,cantonales
3302,974,LA REUNION,19852,10838,463,10375,2011,t1,cantonales
3303,974,LA REUNION,17649,8243,609,7634,2011,t1,cantonales
3304,974,LA REUNION,4801,2999,113,2886,2011,t1,cantonales
3305,974,LA REUNION,9928,4727,283,4444,2011,t1,cantonales
3306,974,LA REUNION,16748,6918,635,6283,2011,t1,cantonales
3307,974,LA REUNION,4454,2957,173,2784,2011,t1,cantonales
3308,974,LA REUNION,21314,9249,494,8755,2011,t1,cantonales
3309,974,LA REUNION,15894,8261,788,7473,2011,t1,cantonales
3310,974,LA REUNION,5540,3613,178,3435,2011,t1,cantonales
3311,974,LA REUNION,10565,6212,328,5884,2011,t1,cantonales
3312,974,LA REUNION,12343,5471,564,4907,2011,t1,cantonales
3313,974,LA REUNION,9295,4744,220,4524,2011,t1,cantonales
3314,974,LA REUNION,11797,5374,398,4976,2011,t1,cantonales
3315,974,LA REUNION,13363,6542,456,6086,2011,t1,cantonales
3316,974,LA REUNION,17597,6868,481,6387,2011,t1,cantonales
3317,974,LA REUNION,15873,7004,575,6429,2011,t1,cantonales
3318,985,MAYOTTE,3875,2694,49,2645,2011,t1,cantonales
3319,985,MAYOTTE,3639,2288,35,2253,2011,t1,cantonales
3320,985,MAYOTTE,3908,2729,129,2600,2011,t1,cantonales
3321,985,MAYOTTE,3757,2393,94,2299,2011,t1,cantonales
3322,985,MAYOTTE,3570,2243,43,2200,2011,t1,cantonales
3323,985,MAYOTTE,4495,2113,59,2054,2011,t1,cantonales
3324,985,MAYOTTE,4267,2571,46,2525,2011,t1,cantonales
3325,985,MAYOTTE,3412,1992,40,1952,2011,t1,cantonales
3326,985,MAYOTTE,3566,1778,49,1729,2011,t1,cantonales
3327,985,MAYOTTE,4696,3030,52,2978,2011,t1,cantonales
3328,1,AIN,12513,7995,285,7710,2001,t1,cantonales
3329,1,AIN,8358,4331,159,4172,2001,t1,cantonales
3330,1,AIN,2619,2063,93,1970,2001,t1,cantonales
3331,1,AIN,5830,4414,145,4269,2001,t1,cantonales
3332,1,AIN,3649,2620,90,2530,2001,t1,cantonales
3333,1,AIN,3592,2715,129,2586,2001,t1,cantonales
3334,1,AIN,5383,3469,208,3261,2001,t1,cantonales
3335,1,AIN,13208,7739,314,7425,2001,t1,cantonales
3336,1,AIN,3095,2339,82,2257,2001,t1,cantonales
3337,1,AIN,11363,7610,327,7283,2001,t1,cantonales
3338,1,AIN,11722,7770,279,7491,2001,t1,cantonales
3339,1,AIN,9438,6316,563,5753,2001,t1,cantonales
3340,1,AIN,9137,5362,223,5139,2001,t1,cantonales
3341,1,AIN,5835,4141,219,3922,2001,t1,cantonales
3342,1,AIN,3420,2433,89,2344,2001,t1,cantonales
3343,1,AIN,8078,5387,277,5110,2001,t1,cantonales
3344,1,AIN,5275,3890,114,3776,2001,t1,cantonales
3345,1,AIN,6613,3456,111,3345,2001,t1,cantonales
3346,1,AIN,7296,3988,149,3839,2001,t1,cantonales
3347,1,AIN,9263,5285,237,5048,2001,t1,cantonales
3348,1,AIN,12946,8189,290,7899,2001,t1,cantonales
3349,2,AISNE,2654,2207,104,2103,2001,t1,cantonales
3350,2,AISNE,6176,5261,227,5034,2001,t1,cantonales
3351,2,AISNE,9396,6534,257,6277,2001,t1,cantonales
3352,2,AISNE,6055,4582,254,4328,2001,t1,cantonales
3353,2,AISNE,8144,6186,365,5821,2001,t1,cantonales
3354,2,AISNE,5420,4352,225,4127,2001,t1,cantonales
3355,2,AISNE,8249,5860,302,5558,2001,t1,cantonales
3356,2,AISNE,8005,5892,352,5540,2001,t1,cantonales
3357,2,AISNE,14406,8990,578,8412,2001,t1,cantonales
3358,2,AISNE,5989,4906,295,4611,2001,t1,cantonales
3359,2,AISNE,6689,4549,229,4320,2001,t1,cantonales
3360,2,AISNE,3919,3131,108,3023,2001,t1,cantonales
3361,2,AISNE,5934,4734,296,4438,2001,t1,cantonales
3362,2,AISNE,8104,6149,293,5856,2001,t1,cantonales
3363,2,AISNE,14490,8790,429,8361,2001,t1,cantonales
3364,2,AISNE,9535,6539,274,6265,2001,t1,cantonales
3365,2,AISNE,5049,4070,280,3790,2001,t1,cantonales
3366,2,AISNE,15378,9795,442,9353,2001,t1,cantonales
3367,2,AISNE,17018,11204,562,10642,2001,t1,cantonales
3368,2,AISNE,15960,9497,393,9104,2001,t1,cantonales
3369,2,AISNE,13044,7387,421,6966,2001,t1,cantonales
3370,3,ALLIER,5565,4034,255,3779,2001,t1,cantonales
3371,3,ALLIER,6340,4269,189,4080,2001,t1,cantonales
3372,3,ALLIER,4347,3361,132,3229,2001,t1,cantonales
3373,3,ALLIER,3564,2854,130,2724,2001,t1,cantonales
3374,3,ALLIER,7231,5341,266,5075,2001,t1,cantonales
3375,3,ALLIER,5926,4503,253,4250,2001,t1,cantonales
3376,3,ALLIER,7406,5484,313,5171,2001,t1,cantonales
3377,3,ALLIER,3857,2970,181,2789,2001,t1,cantonales
3378,3,ALLIER,11015,7397,405,6992,2001,t1,cantonales
3379,3,ALLIER,6010,4605,162,4443,2001,t1,cantonales
3380,3,ALLIER,10190,6027,251,5776,2001,t1,cantonales
3381,3,ALLIER,3832,2904,131,2773,2001,t1,cantonales
3382,3,ALLIER,7986,5807,238,5569,2001,t1,cantonales
3383,3,ALLIER,10838,7878,369,7509,2001,t1,cantonales
3384,3,ALLIER,9063,5351,250,5101,2001,t1,cantonales
3385,3,ALLIER,7456,5060,247,4813,2001,t1,cantonales
3386,3,ALLIER,12145,8439,463,7976,2001,t1,cantonales
3387,4,ALPES DE HAUTE PROVENCE,1884,1564,27,1537,2001,t1,cantonales
3388,4,ALPES DE HAUTE PROVENCE,6490,4052,170,3882,2001,t1,cantonales
3389,4,ALPES DE HAUTE PROVENCE,1202,1076,40,1036,2001,t1,cantonales
3390,4,ALPES DE HAUTE PROVENCE,1054,913,22,891,2001,t1,cantonales
3391,4,ALPES DE HAUTE PROVENCE,6790,5019,378,4641,2001,t1,cantonales
3392,4,ALPES DE HAUTE PROVENCE,1711,1489,58,1431,2001,t1,cantonales
3393,4,ALPES DE HAUTE PROVENCE,996,810,24,786,2001,t1,cantonales
3394,4,ALPES DE HAUTE PROVENCE,2579,2105,105,2000,2001,t1,cantonales
3395,4,ALPES DE HAUTE PROVENCE,2191,1888,52,1836,2001,t1,cantonales
3396,4,ALPES DE HAUTE PROVENCE,2304,1957,46,1911,2001,t1,cantonales
3397,4,ALPES DE HAUTE PROVENCE,5837,4582,176,4406,2001,t1,cantonales
3398,4,ALPES DE HAUTE PROVENCE,941,808,30,778,2001,t1,cantonales
3399,4,ALPES DE HAUTE PROVENCE,8446,5879,324,5555,2001,t1,cantonales
3400,4,ALPES DE HAUTE PROVENCE,7752,5123,220,4903,2001,t1,cantonales
3401,5,HAUTES ALPES,1664,1385,76,1309,2001,t1,cantonales
3402,5,HAUTES ALPES,289,260,2,258,2001,t1,cantonales
3403,5,HAUTES ALPES,7273,5573,176,5397,2001,t1,cantonales
3404,5,HAUTES ALPES,3115,2576,90,2486,2001,t1,cantonales
3405,5,HAUTES ALPES,699,532,112,420,2001,t1,cantonales
3406,5,HAUTES ALPES,4359,3440,90,3350,2001,t1,cantonales
3407,5,HAUTES ALPES,4147,3382,232,3150,2001,t1,cantonales
3408,5,HAUTES ALPES,1549,1284,63,1221,2001,t1,cantonales
3409,5,HAUTES ALPES,925,750,112,638,2001,t1,cantonales
3410,5,HAUTES ALPES,1254,988,54,934,2001,t1,cantonales
3411,5,HAUTES ALPES,833,698,37,661,2001,t1,cantonales
3412,5,HAUTES ALPES,6589,4575,204,4371,2001,t1,cantonales
3413,5,HAUTES ALPES,4013,2667,165,2502,2001,t1,cantonales
3414,5,HAUTES ALPES,2713,1853,85,1768,2001,t1,cantonales
3415,5,HAUTES ALPES,6278,4146,219,3927,2001,t1,cantonales
3416,6,ALPES MARITIMES,22568,13126,541,12585,2001,t1,cantonales
3417,6,ALPES MARITIMES,20179,13238,448,12790,2001,t1,cantonales
3418,6,ALPES MARITIMES,8205,4552,121,4431,2001,t1,cantonales
3419,6,ALPES MARITIMES,2641,2002,67,1935,2001,t1,cantonales
3420,6,ALPES MARITIMES,17772,10042,263,9779,2001,t1,cantonales
3421,6,ALPES MARITIMES,10921,7715,366,7349,2001,t1,cantonales
3422,6,ALPES MARITIMES,17066,9886,424,9462,2001,t1,cantonales
3423,6,ALPES MARITIMES,13981,6413,240,6173,2001,t1,cantonales
3424,6,ALPES MARITIMES,13052,6008,239,5769,2001,t1,cantonales
3425,6,ALPES MARITIMES,13915,5854,156,5698,2001,t1,cantonales
3426,6,ALPES MARITIMES,3644,2898,133,2765,2001,t1,cantonales
3427,6,ALPES MARITIMES,2517,2197,46,2151,2001,t1,cantonales
3428,6,ALPES MARITIMES,2245,1862,85,1777,2001,t1,cantonales
3429,6,ALPES MARITIMES,2725,2229,47,2182,2001,t1,cantonales
3430,6,ALPES MARITIMES,2776,2132,162,1970,2001,t1,cantonales
3431,6,ALPES MARITIMES,17210,10756,371,10385,2001,t1,cantonales
3432,6,ALPES MARITIMES,2419,1921,65,1856,2001,t1,cantonales
3433,6,ALPES MARITIMES,17712,8372,321,8051,2001,t1,cantonales
3434,6,ALPES MARITIMES,18253,10311,329,9982,2001,t1,cantonales
3435,6,ALPES MARITIMES,19158,9495,391,9104,2001,t1,cantonales
3436,6,ALPES MARITIMES,16687,9406,351,9055,2001,t1,cantonales
3437,6,ALPES MARITIMES,23876,13456,376,13080,2001,t1,cantonales
3438,6,ALPES MARITIMES,26951,16331,525,15806,2001,t1,cantonales
3439,6,ALPES MARITIMES,18912,10745,399,10346,2001,t1,cantonales
3440,6,ALPES MARITIMES,9932,6743,315,6428,2001,t1,cantonales
3441,6,ALPES MARITIMES,13397,7557,313,7244,2001,t1,cantonales
3442,7,ARDECHE,12890,8821,407,8414,2001,t1,cantonales
3443,7,ARDECHE,10359,7819,235,7584,2001,t1,cantonales
3444,7,ARDECHE,1261,1082,20,1062,2001,t1,cantonales
3445,7,ARDECHE,6323,4828,157,4671,2001,t1,cantonales
3446,7,ARDECHE,1996,1779,81,1698,2001,t1,cantonales
3447,7,ARDECHE,5380,4053,130,3923,2001,t1,cantonales
3448,7,ARDECHE,4884,3642,122,3520,2001,t1,cantonales
3449,7,ARDECHE,3489,2611,120,2491,2001,t1,cantonales
3450,7,ARDECHE,18176,12559,413,12146,2001,t1,cantonales
3451,7,ARDECHE,5785,4667,167,4500,2001,t1,cantonales
3452,7,ARDECHE,7313,5612,296,5316,2001,t1,cantonales
3453,7,ARDECHE,5857,4641,172,4469,2001,t1,cantonales
3454,7,ARDECHE,15516,11416,468,10948,2001,t1,cantonales
3455,7,ARDECHE,5905,4695,166,4529,2001,t1,cantonales
3456,7,ARDECHE,2943,2363,189,2174,2001,t1,cantonales
3457,7,ARDECHE,6332,5122,166,4956,2001,t1,cantonales
3458,7,ARDECHE,8419,6258,266,5992,2001,t1,cantonales
3459,8,ARDENNES,3899,3013,133,2880,2001,t1,cantonales
3460,8,ARDENNES,2339,1823,80,1743,2001,t1,cantonales
3461,8,ARDENNES,1754,1502,39,1463,2001,t1,cantonales
3462,8,ARDENNES,7261,5333,341,4992,2001,t1,cantonales
3463,8,ARDENNES,8215,5090,185,4905,2001,t1,cantonales
3464,8,ARDENNES,2867,2288,124,2164,2001,t1,cantonales
3465,8,ARDENNES,2124,1857,81,1776,2001,t1,cantonales
3466,8,ARDENNES,2005,1636,71,1565,2001,t1,cantonales
3467,8,ARDENNES,7479,5632,305,5327,2001,t1,cantonales
3468,8,ARDENNES,10045,6959,170,6789,2001,t1,cantonales
3469,8,ARDENNES,1806,1528,55,1473,2001,t1,cantonales
3470,8,ARDENNES,8621,4894,252,4642,2001,t1,cantonales
3471,8,ARDENNES,4476,3212,188,3024,2001,t1,cantonales
3472,8,ARDENNES,5479,4251,186,4065,2001,t1,cantonales
3473,8,ARDENNES,8201,4634,173,4461,2001,t1,cantonales
3474,8,ARDENNES,8849,4255,220,4035,2001,t1,cantonales
3475,8,ARDENNES,5325,3185,163,3022,2001,t1,cantonales
3476,8,ARDENNES,9822,6409,329,6080,2001,t1,cantonales
3477,8,ARDENNES,9337,6168,178,5990,2001,t1,cantonales
3478,9,ARIEGE,2598,2070,64,2006,2001,t1,cantonales
3479,9,ARIEGE,1716,1391,78,1313,2001,t1,cantonales
3480,9,ARIEGE,2501,2053,68,1985,2001,t1,cantonales
3481,9,ARIEGE,3036,2512,156,2356,2001,t1,cantonales
3482,9,ARIEGE,5988,4052,176,3876,2001,t1,cantonales
3483,9,ARIEGE,1952,1609,27,1582,2001,t1,cantonales
3484,9,ARIEGE,9749,7622,389,7233,2001,t1,cantonales
3485,9,ARIEGE,5608,4574,231,4343,2001,t1,cantonales
3486,9,ARIEGE,6765,5648,242,5406,2001,t1,cantonales
3487,9,ARIEGE,6431,4790,306,4484,2001,t1,cantonales
3488,9,ARIEGE,7876,6082,551,5531,2001,t1,cantonales
3489,10,AUBE,3585,2610,91,2519,2001,t1,cantonales
3490,10,AUBE,8506,5769,304,5465,2001,t1,cantonales
3491,10,AUBE,6796,4908,252,4656,2001,t1,cantonales
3492,10,AUBE,3805,3070,193,2877,2001,t1,cantonales
3493,10,AUBE,1850,1509,75,1434,2001,t1,cantonales
3494,10,AUBE,3307,2608,145,2463,2001,t1,cantonales
3495,10,AUBE,6178,4150,175,3975,2001,t1,cantonales
3496,10,AUBE,6854,5117,307,4810,2001,t1,cantonales
3497,10,AUBE,3384,2626,150,2476,2001,t1,cantonales
3498,10,AUBE,1933,1456,104,1352,2001,t1,cantonales
3499,10,AUBE,6277,4275,271,4004,2001,t1,cantonales
3500,10,AUBE,7635,4008,150,3858,2001,t1,cantonales
3501,10,AUBE,3865,2691,230,2461,2001,t1,cantonales
3502,10,AUBE,10300,6240,373,5867,2001,t1,cantonales
3503,10,AUBE,9614,5755,237,5518,2001,t1,cantonales
3504,10,AUBE,12270,6929,260,6669,2001,t1,cantonales
3505,11,AUDE,1881,1613,65,1548,2001,t1,cantonales
3506,11,AUDE,9363,7309,385,6924,2001,t1,cantonales
3507,11,AUDE,9567,6289,353,5936,2001,t1,cantonales
3508,11,AUDE,10280,7895,451,7444,2001,t1,cantonales
3509,11,AUDE,7123,5278,282,4996,2001,t1,cantonales
3510,11,AUDE,4473,3761,154,3607,2001,t1,cantonales
3511,11,AUDE,9693,7813,413,7400,2001,t1,cantonales
3512,11,AUDE,11677,8388,579,7809,2001,t1,cantonales
3513,11,AUDE,4523,3634,181,3453,2001,t1,cantonales
3514,11,AUDE,1270,1110,195,915,2001,t1,cantonales
3515,11,AUDE,7037,5516,439,5077,2001,t1,cantonales
3516,11,AUDE,2292,1868,109,1759,2001,t1,cantonales
3517,11,AUDE,2292,1902,199,1703,2001,t1,cantonales
3518,11,AUDE,13983,10375,461,9914,2001,t1,cantonales
3519,11,AUDE,7455,4413,250,4163,2001,t1,cantonales
3520,11,AUDE,15341,10465,540,9925,2001,t1,cantonales
3521,11,AUDE,11248,6685,299,6386,2001,t1,cantonales
3522,12,AVEYRON,8264,6176,376,5800,2001,t1,cantonales
3523,12,AVEYRON,2241,1786,75,1711,2001,t1,cantonales
3524,12,AVEYRON,6761,5391,249,5142,2001,t1,cantonales
3525,12,AVEYRON,4536,4000,127,3873,2001,t1,cantonales
3526,12,AVEYRON,2476,2188,54,2134,2001,t1,cantonales
3527,12,AVEYRON,1644,1464,42,1422,2001,t1,cantonales
3528,12,AVEYRON,8534,6179,308,5871,2001,t1,cantonales
3529,12,AVEYRON,5741,4572,133,4439,2001,t1,cantonales
3530,12,AVEYRON,6471,4575,273,4302,2001,t1,cantonales
3531,12,AVEYRON,1897,1658,56,1602,2001,t1,cantonales
3532,12,AVEYRON,4486,3992,122,3870,2001,t1,cantonales
3533,12,AVEYRON,3882,3267,229,3038,2001,t1,cantonales
3534,12,AVEYRON,4191,3574,1011,2563,2001,t1,cantonales
3535,12,AVEYRON,1959,1684,44,1640,2001,t1,cantonales
3536,12,AVEYRON,747,646,11,635,2001,t1,cantonales
3537,12,AVEYRON,2043,1767,58,1709,2001,t1,cantonales
3538,12,AVEYRON,2946,2418,98,2320,2001,t1,cantonales
3539,12,AVEYRON,2759,2495,88,2407,2001,t1,cantonales
3540,12,AVEYRON,2367,2121,238,1883,2001,t1,cantonales
3541,12,AVEYRON,6810,5820,179,5641,2001,t1,cantonales
3542,12,AVEYRON,3280,2774,188,2586,2001,t1,cantonales
3543,12,AVEYRON,3643,2918,177,2741,2001,t1,cantonales
3544,12,AVEYRON,13475,9545,587,8958,2001,t1,cantonales
3545,12,AVEYRON,10712,7553,349,7204,2001,t1,cantonales
3546,13,BOUCHES DU RHONE,34532,20374,814,19560,2001,t1,cantonales
3547,13,BOUCHES DU RHONE,27867,18273,852,17421,2001,t1,cantonales
3548,13,BOUCHES DU RHONE,39196,23914,1157,22757,2001,t1,cantonales
3549,13,BOUCHES DU RHONE,22262,16215,663,15552,2001,t1,cantonales
3550,13,BOUCHES DU RHONE,28932,18426,1031,17395,2001,t1,cantonales
3551,13,BOUCHES DU RHONE,21205,13665,911,12754,2001,t1,cantonales
3552,13,BOUCHES DU RHONE,4633,2509,118,2391,2001,t1,cantonales
3553,13,BOUCHES DU RHONE,3944,2332,84,2248,2001,t1,cantonales
3554,13,BOUCHES DU RHONE,7354,3641,160,3481,2001,t1,cantonales
3555,13,BOUCHES DU RHONE,14598,6515,285,6230,2001,t1,cantonales
3556,13,BOUCHES DU RHONE,17122,8296,304,7992,2001,t1,cantonales
3557,13,BOUCHES DU RHONE,27200,13854,434,13420,2001,t1,cantonales
3558,13,BOUCHES DU RHONE,22917,14102,642,13460,2001,t1,cantonales
3559,13,BOUCHES DU RHONE,14906,10703,482,10221,2001,t1,cantonales
3560,13,BOUCHES DU RHONE,27733,18481,852,17629,2001,t1,cantonales
3561,13,BOUCHES DU RHONE,2492,2270,67,2203,2001,t1,cantonales
3562,13,BOUCHES DU RHONE,25655,17590,933,16657,2001,t1,cantonales
3563,13,BOUCHES DU RHONE,23873,12320,471,11849,2001,t1,cantonales
3564,13,BOUCHES DU RHONE,11319,5498,181,5317,2001,t1,cantonales
3565,13,BOUCHES DU RHONE,21444,10736,447,10289,2001,t1,cantonales
3566,13,BOUCHES DU RHONE,23846,11454,485,10969,2001,t1,cantonales
3567,13,BOUCHES DU RHONE,27912,13975,571,13404,2001,t1,cantonales
3568,13,BOUCHES DU RHONE,23734,11971,488,11483,2001,t1,cantonales
3569,13,BOUCHES DU RHONE,30733,16357,575,15782,2001,t1,cantonales
3570,13,BOUCHES DU RHONE,20524,11193,447,10746,2001,t1,cantonales
3571,13,BOUCHES DU RHONE,34089,23019,1436,21583,2001,t1,cantonales
3572,13,BOUCHES DU RHONE,17601,10233,476,9757,2001,t1,cantonales
3573,14,CALVADOS,5072,3672,202,3470,2001,t1,cantonales
3574,14,CALVADOS,14728,8146,503,7643,2001,t1,cantonales
3575,14,CALVADOS,16111,10446,390,10056,2001,t1,cantonales
3576,14,CALVADOS,13234,9418,440,8978,2001,t1,cantonales
3577,14,CALVADOS,11117,7466,227,7239,2001,t1,cantonales
3578,14,CALVADOS,7769,5643,360,5283,2001,t1,cantonales
3579,14,CALVADOS,7331,5307,250,5057,2001,t1,cantonales
3580,14,CALVADOS,3485,2687,130,2557,2001,t1,cantonales
3581,14,CALVADOS,6585,4568,236,4332,2001,t1,cantonales
3582,14,CALVADOS,8369,5976,328,5648,2001,t1,cantonales
3583,14,CALVADOS,5557,3963,173,3790,2001,t1,cantonales
3584,14,CALVADOS,5557,4373,225,4148,2001,t1,cantonales
3585,14,CALVADOS,6684,5019,306,4713,2001,t1,cantonales
3586,14,CALVADOS,10358,7647,485,7162,2001,t1,cantonales
3587,14,CALVADOS,5100,3845,224,3621,2001,t1,cantonales
3588,14,CALVADOS,15259,9959,694,9265,2001,t1,cantonales
3589,14,CALVADOS,15450,9897,381,9516,2001,t1,cantonales
3590,14,CALVADOS,4136,3122,331,2791,2001,t1,cantonales
3591,14,CALVADOS,6909,5151,316,4835,2001,t1,cantonales
3592,14,CALVADOS,13608,9993,393,9600,2001,t1,cantonales
3593,14,CALVADOS,8530,4436,208,4228,2001,t1,cantonales
3594,14,CALVADOS,9938,5723,204,5519,2001,t1,cantonales
3595,14,CALVADOS,11388,5875,323,5552,2001,t1,cantonales
3596,14,CALVADOS,8795,4231,132,4099,2001,t1,cantonales
3597,14,CALVADOS,14593,9597,494,9103,2001,t1,cantonales
3598,14,CALVADOS,15818,9709,451,9258,2001,t1,cantonales
3599,15,CANTAL,2565,2173,77,2096,2001,t1,cantonales
3600,15,CANTAL,7558,5488,555,4933,2001,t1,cantonales
3601,15,CANTAL,3749,3264,208,3056,2001,t1,cantonales
3602,15,CANTAL,3711,3001,214,2787,2001,t1,cantonales
3603,15,CANTAL,2450,2082,197,1885,2001,t1,cantonales
3604,15,CANTAL,3307,2882,100,2782,2001,t1,cantonales
3605,15,CANTAL,5499,3779,67,3712,2001,t1,cantonales
3606,15,CANTAL,2794,2448,94,2354,2001,t1,cantonales
3607,15,CANTAL,5376,4503,163,4340,2001,t1,cantonales
3608,15,CANTAL,4706,3964,209,3755,2001,t1,cantonales
3609,15,CANTAL,6726,4498,168,4330,2001,t1,cantonales
3610,15,CANTAL,7645,5706,274,5432,2001,t1,cantonales
3611,15,CANTAL,4414,3436,148,3288,2001,t1,cantonales
3612,16,CHARENTE,7385,5406,289,5117,2001,t1,cantonales
3613,16,CHARENTE,6201,4332,170,4162,2001,t1,cantonales
3614,16,CHARENTE,1944,1537,68,1469,2001,t1,cantonales
3615,16,CHARENTE,6521,5079,329,4750,2001,t1,cantonales
3616,16,CHARENTE,3848,2841,157,2684,2001,t1,cantonales
3617,16,CHARENTE,2359,1832,99,1733,2001,t1,cantonales
3618,16,CHARENTE,5939,4438,293,4145,2001,t1,cantonales
3619,16,CHARENTE,6921,5465,247,5218,2001,t1,cantonales
3620,16,CHARENTE,3303,2722,152,2570,2001,t1,cantonales
3621,16,CHARENTE,13125,9632,635,8997,2001,t1,cantonales
3622,16,CHARENTE,5610,4301,207,4094,2001,t1,cantonales
3623,16,CHARENTE,4602,3752,206,3546,2001,t1,cantonales
3624,16,CHARENTE,17112,10577,472,10105,2001,t1,cantonales
3625,16,CHARENTE,13653,8439,475,7964,2001,t1,cantonales
3626,16,CHARENTE,9372,6064,312,5752,2001,t1,cantonales
3627,16,CHARENTE,12239,7052,348,6704,2001,t1,cantonales
3628,16,CHARENTE,14071,8832,460,8372,2001,t1,cantonales
3629,17,CHARENTE MARITIME,4187,2990,177,2813,2001,t1,cantonales
3630,17,CHARENTE MARITIME,5406,4089,158,3931,2001,t1,cantonales
3631,17,CHARENTE MARITIME,6961,5109,160,4949,2001,t1,cantonales
3632,17,CHARENTE MARITIME,6668,4889,196,4693,2001,t1,cantonales
3633,17,CHARENTE MARITIME,8189,5863,249,5614,2001,t1,cantonales
3634,17,CHARENTE MARITIME,8202,5838,350,5488,2001,t1,cantonales
3635,17,CHARENTE MARITIME,13405,8435,510,7925,2001,t1,cantonales
3636,17,CHARENTE MARITIME,7718,5441,323,5118,2001,t1,cantonales
3637,17,CHARENTE MARITIME,7383,5442,276,5166,2001,t1,cantonales
3638,17,CHARENTE MARITIME,5920,4532,185,4347,2001,t1,cantonales
3639,17,CHARENTE MARITIME,7690,5683,251,5432,2001,t1,cantonales
3640,17,CHARENTE MARITIME,4766,2363,114,2249,2001,t1,cantonales
3641,17,CHARENTE MARITIME,8435,5925,220,5705,2001,t1,cantonales
3642,17,CHARENTE MARITIME,3419,2534,151,2383,2001,t1,cantonales
3643,17,CHARENTE MARITIME,8454,5945,305,5640,2001,t1,cantonales
3644,17,CHARENTE MARITIME,4982,3774,140,3634,2001,t1,cantonales
3645,17,CHARENTE MARITIME,11454,6935,418,6517,2001,t1,cantonales
3646,17,CHARENTE MARITIME,8490,5748,264,5484,2001,t1,cantonales
3647,17,CHARENTE MARITIME,9923,6861,323,6538,2001,t1,cantonales
3648,17,CHARENTE MARITIME,12754,8082,276,7806,2001,t1,cantonales
3649,17,CHARENTE MARITIME,7158,4061,147,3914,2001,t1,cantonales
3650,17,CHARENTE MARITIME,6244,3236,147,3089,2001,t1,cantonales
3651,17,CHARENTE MARITIME,9054,5206,401,4805,2001,t1,cantonales
3652,17,CHARENTE MARITIME,12058,7510,284,7226,2001,t1,cantonales
3653,17,CHARENTE MARITIME,9912,6441,346,6095,2001,t1,cantonales
3654,18,CHER,9256,6636,329,6307,2001,t1,cantonales
3655,18,CHER,5529,4085,149,3936,2001,t1,cantonales
3656,18,CHER,6678,3398,132,3266,2001,t1,cantonales
3657,18,CHER,4613,3333,170,3163,2001,t1,cantonales
3658,18,CHER,3646,2847,91,2756,2001,t1,cantonales
3659,18,CHER,4766,3454,172,3282,2001,t1,cantonales
3660,18,CHER,2715,2055,109,1946,2001,t1,cantonales
3661,18,CHER,6655,4742,151,4591,2001,t1,cantonales
3662,18,CHER,4728,3382,237,3145,2001,t1,cantonales
3663,18,CHER,4455,3064,165,2899,2001,t1,cantonales
3664,18,CHER,9116,6317,284,6033,2001,t1,cantonales
3665,18,CHER,5956,4407,215,4192,2001,t1,cantonales
3666,18,CHER,7820,5801,300,5501,2001,t1,cantonales
3667,18,CHER,2765,2190,130,2060,2001,t1,cantonales
3668,18,CHER,7892,4437,180,4257,2001,t1,cantonales
3669,18,CHER,14060,8289,299,7990,2001,t1,cantonales
3670,18,CHER,10565,7080,244,6836,2001,t1,cantonales
3671,19,CORREZE,2862,2480,80,2400,2001,t1,cantonales
3672,19,CORREZE,4160,3380,183,3197,2001,t1,cantonales
3673,19,CORREZE,7378,4585,272,4313,2001,t1,cantonales
3674,19,CORREZE,5189,4274,186,4088,2001,t1,cantonales
3675,19,CORREZE,6270,5227,212,5015,2001,t1,cantonales
3676,19,CORREZE,2446,2111,83,2028,2001,t1,cantonales
3677,19,CORREZE,3875,3173,120,3053,2001,t1,cantonales
3678,19,CORREZE,4161,3648,114,3534,2001,t1,cantonales
3679,19,CORREZE,3277,2976,99,2877,2001,t1,cantonales
3680,19,CORREZE,5697,4771,232,4539,2001,t1,cantonales
3681,19,CORREZE,1981,1672,57,1615,2001,t1,cantonales
3682,19,CORREZE,5794,4243,162,4081,2001,t1,cantonales
3683,19,CORREZE,4588,3388,187,3201,2001,t1,cantonales
3684,19,CORREZE,3038,2716,115,2601,2001,t1,cantonales
3685,19,CORREZE,8697,5464,375,5089,2001,t1,cantonales
3686,19,CORREZE,7754,5329,324,5005,2001,t1,cantonales
3687,19,CORREZE,6231,5141,216,4925,2001,t1,cantonales
3688,19,CORREZE,7252,5999,280,5719,2001,t1,cantonales
3689,2A,CORSE SUD,5517,3738,301,3437,2001,t1,cantonales
3690,2A,CORSE SUD,1867,1576,58,1518,2001,t1,cantonales
3691,2A,CORSE SUD,6540,4837,178,4659,2001,t1,cantonales
3692,2A,CORSE SUD,2273,1982,40,1942,2001,t1,cantonales
3693,2A,CORSE SUD,2890,2375,122,2253,2001,t1,cantonales
3694,2A,CORSE SUD,1667,1434,23,1411,2001,t1,cantonales
3695,2A,CORSE SUD,3113,2303,121,2182,2001,t1,cantonales
3696,2A,CORSE SUD,2147,1513,70,1443,2001,t1,cantonales
3697,2A,CORSE SUD,2636,2254,90,2164,2001,t1,cantonales
3698,2A,CORSE SUD,8124,5058,278,4780,2001,t1,cantonales
3699,2A,CORSE SUD,8331,6938,222,6716,2001,t1,cantonales
3700,2B,HAUTE CORSE,4674,3270,363,2907,2001,t1,cantonales
3701,2B,HAUTE CORSE,8211,5527,328,5199,2001,t1,cantonales
3702,2B,HAUTE CORSE,2439,1920,65,1855,2001,t1,cantonales
3703,2B,HAUTE CORSE,3712,2892,127,2765,2001,t1,cantonales
3704,2B,HAUTE CORSE,2825,2434,49,2385,2001,t1,cantonales
3705,2B,HAUTE CORSE,3394,2818,51,2767,2001,t1,cantonales
3706,2B,HAUTE CORSE,2474,2005,103,1902,2001,t1,cantonales
3707,2B,HAUTE CORSE,1684,1454,30,1424,2001,t1,cantonales
3708,2B,HAUTE CORSE,3158,2274,178,2096,2001,t1,cantonales
3709,2B,HAUTE CORSE,5019,3528,260,3268,2001,t1,cantonales
3710,2B,HAUTE CORSE,2496,2029,50,1979,2001,t1,cantonales
3711,2B,HAUTE CORSE,5010,3873,136,3737,2001,t1,cantonales
3712,2B,HAUTE CORSE,1701,1351,38,1313,2001,t1,cantonales
3713,2B,HAUTE CORSE,1117,841,52,789,2001,t1,cantonales
3714,2B,HAUTE CORSE,4383,2911,228,2683,2001,t1,cantonales
3715,2B,HAUTE CORSE,6633,4642,333,4309,2001,t1,cantonales
3716,21,COTE D'OR,1366,1109,67,1042,2001,t1,cantonales
3717,21,COTE D'OR,13600,8726,543,8183,2001,t1,cantonales
3718,21,COTE D'OR,8188,5830,204,5626,2001,t1,cantonales
3719,21,COTE D'OR,16121,9595,365,9230,2001,t1,cantonales
3720,21,COTE D'OR,21527,12662,603,12059,2001,t1,cantonales
3721,21,COTE D'OR,10270,5696,166,5530,2001,t1,cantonales
3722,21,COTE D'OR,2112,1650,90,1560,2001,t1,cantonales
3723,21,COTE D'OR,13559,9263,506,8757,2001,t1,cantonales
3724,21,COTE D'OR,2865,2320,100,2220,2001,t1,cantonales
3725,21,COTE D'OR,2241,1743,80,1663,2001,t1,cantonales
3726,21,COTE D'OR,4890,3732,156,3576,2001,t1,cantonales
3727,21,COTE D'OR,4060,3284,377,2907,2001,t1,cantonales
3728,21,COTE D'OR,2250,1895,126,1769,2001,t1,cantonales
3729,21,COTE D'OR,1903,1519,58,1461,2001,t1,cantonales
3730,21,COTE D'OR,4694,3535,86,3449,2001,t1,cantonales
3731,21,COTE D'OR,6831,5530,223,5307,2001,t1,cantonales
3732,21,COTE D'OR,6233,4558,279,4279,2001,t1,cantonales
3733,21,COTE D'OR,4914,3730,203,3527,2001,t1,cantonales
3734,21,COTE D'OR,5905,4519,188,4331,2001,t1,cantonales
3735,21,COTE D'OR,16766,9732,412,9320,2001,t1,cantonales
3736,21,COTE D'OR,10910,6074,191,5883,2001,t1,cantonales
3737,21,COTE D'OR,8308,4156,136,4020,2001,t1,cantonales
3738,22,COTES D'ARMOR,6247,4984,210,4774,2001,t1,cantonales
3739,22,COTES D'ARMOR,4462,3829,162,3667,2001,t1,cantonales
3740,22,COTES D'ARMOR,6701,5622,159,5463,2001,t1,cantonales
3741,22,COTES D'ARMOR,5378,4663,220,4443,2001,t1,cantonales
3742,22,COTES D'ARMOR,4355,3691,141,3550,2001,t1,cantonales
3743,22,COTES D'ARMOR,3365,2866,76,2790,2001,t1,cantonales
3744,22,COTES D'ARMOR,11372,7846,409,7437,2001,t1,cantonales
3745,22,COTES D'ARMOR,2978,2517,78,2439,2001,t1,cantonales
3746,22,COTES D'ARMOR,15889,11426,615,10811,2001,t1,cantonales
3747,22,COTES D'ARMOR,14040,10745,345,10400,2001,t1,cantonales
3748,22,COTES D'ARMOR,18405,11526,519,11007,2001,t1,cantonales
3749,22,COTES D'ARMOR,6022,4920,369,4551,2001,t1,cantonales
3750,22,COTES D'ARMOR,7062,5660,156,5504,2001,t1,cantonales
3751,22,COTES D'ARMOR,5955,5105,238,4867,2001,t1,cantonales
3752,22,COTES D'ARMOR,2804,2437,100,2337,2001,t1,cantonales
3753,22,COTES D'ARMOR,8924,6983,986,5997,2001,t1,cantonales
3754,22,COTES D'ARMOR,10032,7886,309,7577,2001,t1,cantonales
3755,22,COTES D'ARMOR,6619,5319,206,5113,2001,t1,cantonales
3756,22,COTES D'ARMOR,7740,6397,216,6181,2001,t1,cantonales
3757,22,COTES D'ARMOR,5201,4326,147,4179,2001,t1,cantonales
3758,22,COTES D'ARMOR,6453,5252,134,5118,2001,t1,cantonales
3759,22,COTES D'ARMOR,9567,5138,241,4897,2001,t1,cantonales
3760,22,COTES D'ARMOR,10114,5458,233,5225,2001,t1,cantonales
3761,22,COTES D'ARMOR,9466,7456,243,7213,2001,t1,cantonales
3762,22,COTES D'ARMOR,3046,2653,107,2546,2001,t1,cantonales
3763,22,COTES D'ARMOR,15586,10869,499,10370,2001,t1,cantonales
3764,23,CREUSE,3195,2464,283,2181,2001,t1,cantonales
3765,23,CREUSE,4642,3502,175,3327,2001,t1,cantonales
3766,23,CREUSE,3703,2815,219,2596,2001,t1,cantonales
3767,23,CREUSE,1613,1338,55,1283,2001,t1,cantonales
3768,23,CREUSE,3157,2567,110,2457,2001,t1,cantonales
3769,23,CREUSE,6067,4566,243,4323,2001,t1,cantonales
3770,23,CREUSE,2631,2197,70,2127,2001,t1,cantonales
3771,23,CREUSE,3495,2720,130,2590,2001,t1,cantonales
3772,23,CREUSE,6204,4322,275,4047,2001,t1,cantonales
3773,23,CREUSE,2755,2222,124,2098,2001,t1,cantonales
3774,23,CREUSE,2560,2073,70,2003,2001,t1,cantonales
3775,23,CREUSE,5692,3989,254,3735,2001,t1,cantonales
3776,23,CREUSE,8578,5932,316,5616,2001,t1,cantonales
3777,23,CREUSE,3549,2356,172,2184,2001,t1,cantonales
3778,24,DORDOGNE,3255,2728,106,2622,2001,t1,cantonales
3779,24,DORDOGNE,3876,3175,132,3043,2001,t1,cantonales
3780,24,DORDOGNE,2545,2155,138,2017,2001,t1,cantonales
3781,24,DORDOGNE,5225,4416,417,3999,2001,t1,cantonales
3782,24,DORDOGNE,4529,3999,269,3730,2001,t1,cantonales
3783,24,DORDOGNE,3252,2746,110,2636,2001,t1,cantonales
3784,24,DORDOGNE,3340,2700,141,2559,2001,t1,cantonales
3785,24,DORDOGNE,2807,2343,133,2210,2001,t1,cantonales
3786,24,DORDOGNE,1768,1551,42,1509,2001,t1,cantonales
3787,24,DORDOGNE,7354,5605,365,5240,2001,t1,cantonales
3788,24,DORDOGNE,5583,4688,271,4417,2001,t1,cantonales
3789,24,DORDOGNE,10976,6983,390,6593,2001,t1,cantonales
3790,24,DORDOGNE,6432,5121,284,4837,2001,t1,cantonales
3791,24,DORDOGNE,2111,1889,55,1834,2001,t1,cantonales
3792,24,DORDOGNE,13039,10046,668,9378,2001,t1,cantonales
3793,24,DORDOGNE,5379,4223,252,3971,2001,t1,cantonales
3794,24,DORDOGNE,5530,4491,252,4239,2001,t1,cantonales
3795,24,DORDOGNE,4062,3413,131,3282,2001,t1,cantonales
3796,24,DORDOGNE,13273,10218,630,9588,2001,t1,cantonales
3797,24,DORDOGNE,10274,8056,401,7655,2001,t1,cantonales
3798,24,DORDOGNE,3543,3061,98,2963,2001,t1,cantonales
3799,24,DORDOGNE,5978,4990,219,4771,2001,t1,cantonales
3800,24,DORDOGNE,7439,5659,372,5287,2001,t1,cantonales
3801,24,DORDOGNE,4140,3422,316,3106,2001,t1,cantonales
3802,25,DOUBS,2959,2585,73,2512,2001,t1,cantonales
3803,25,DOUBS,17471,12933,712,12221,2001,t1,cantonales
3804,25,DOUBS,11624,6960,362,6598,2001,t1,cantonales
3805,25,DOUBS,6376,4949,311,4638,2001,t1,cantonales
3806,25,DOUBS,13012,6879,309,6570,2001,t1,cantonales
3807,25,DOUBS,12931,7990,462,7528,2001,t1,cantonales
3808,25,DOUBS,11450,8433,469,7964,2001,t1,cantonales
3809,25,DOUBS,4617,3795,183,3612,2001,t1,cantonales
3810,25,DOUBS,11524,7979,304,7675,2001,t1,cantonales
3811,25,DOUBS,8238,6664,273,6391,2001,t1,cantonales
3812,25,DOUBS,5863,4843,191,4652,2001,t1,cantonales
3813,25,DOUBS,9993,7609,294,7315,2001,t1,cantonales
3814,25,DOUBS,13433,9885,465,9420,2001,t1,cantonales
3815,25,DOUBS,14977,8086,284,7802,2001,t1,cantonales
3816,25,DOUBS,8355,5427,279,5148,2001,t1,cantonales
3817,25,DOUBS,8638,4115,185,3930,2001,t1,cantonales
3818,25,DOUBS,13424,8109,415,7694,2001,t1,cantonales
3819,26,DROME,1056,889,13,876,2001,t1,cantonales
3820,26,DROME,4147,3291,138,3153,2001,t1,cantonales
3821,26,DROME,1651,1369,45,1324,2001,t1,cantonales
3822,26,DROME,11030,7895,282,7613,2001,t1,cantonales
3823,26,DROME,5736,4205,170,4035,2001,t1,cantonales
3824,26,DROME,6425,4822,185,4637,2001,t1,cantonales
3825,26,DROME,11086,7100,310,6790,2001,t1,cantonales
3826,26,DROME,8156,5957,223,5734,2001,t1,cantonales
3827,26,DROME,18086,10824,449,10375,2001,t1,cantonales
3828,26,DROME,1603,1309,43,1266,2001,t1,cantonales
3829,26,DROME,5129,3783,134,3649,2001,t1,cantonales
3830,26,DROME,12018,8787,430,8357,2001,t1,cantonales
3831,26,DROME,16407,11639,548,11091,2001,t1,cantonales
3832,26,DROME,1898,1607,52,1555,2001,t1,cantonales
3833,26,DROME,10307,5713,164,5549,2001,t1,cantonales
3834,26,DROME,9373,5409,207,5202,2001,t1,cantonales
3835,26,DROME,13912,9088,680,8408,2001,t1,cantonales
3836,26,DROME,11496,7143,286,6857,2001,t1,cantonales
3837,27,EURE,7717,5658,320,5338,2001,t1,cantonales
3838,27,EURE,4768,3501,194,3307,2001,t1,cantonales
3839,27,EURE,10440,7187,391,6796,2001,t1,cantonales
3840,27,EURE,10553,6250,303,5947,2001,t1,cantonales
3841,27,EURE,12190,8525,755,7770,2001,t1,cantonales
3842,27,EURE,11945,7584,326,7258,2001,t1,cantonales
3843,27,EURE,3518,2543,134,2409,2001,t1,cantonales
3844,27,EURE,7839,5449,386,5063,2001,t1,cantonales
3845,27,EURE,12458,8068,463,7605,2001,t1,cantonales
3846,27,EURE,4199,3084,133,2951,2001,t1,cantonales
3847,27,EURE,10098,6952,358,6594,2001,t1,cantonales
3848,27,EURE,5777,4025,161,3864,2001,t1,cantonales
3849,27,EURE,16485,10599,817,9782,2001,t1,cantonales
3850,27,EURE,3300,2438,164,2274,2001,t1,cantonales
3851,27,EURE,5131,3701,160,3541,2001,t1,cantonales
3852,27,EURE,8127,5281,318,4963,2001,t1,cantonales
3853,27,EURE,11049,6761,267,6494,2001,t1,cantonales
3854,27,EURE,11737,7192,339,6853,2001,t1,cantonales
3855,27,EURE,11043,7013,472,6541,2001,t1,cantonales
3856,27,EURE,10506,6184,254,5930,2001,t1,cantonales
3857,27,EURE,9557,6770,361,6409,2001,t1,cantonales
3858,27,EURE,10781,5675,294,5381,2001,t1,cantonales
3859,28,EURE ET LOIR,12096,8142,344,7798,2001,t1,cantonales
3860,28,EURE ET LOIR,9724,6716,377,6339,2001,t1,cantonales
3861,28,EURE ET LOIR,4728,3523,164,3359,2001,t1,cantonales
3862,28,EURE ET LOIR,7931,5983,270,5713,2001,t1,cantonales
3863,28,EURE ET LOIR,9137,6081,363,5718,2001,t1,cantonales
3864,28,EURE ET LOIR,7300,5579,361,5218,2001,t1,cantonales
3865,28,EURE ET LOIR,9086,6315,337,5978,2001,t1,cantonales
3866,28,EURE ET LOIR,11235,6145,285,5860,2001,t1,cantonales
3867,28,EURE ET LOIR,7084,5134,234,4900,2001,t1,cantonales
3868,28,EURE ET LOIR,10986,7136,254,6882,2001,t1,cantonales
3869,28,EURE ET LOIR,4166,2988,80,2908,2001,t1,cantonales
3870,28,EURE ET LOIR,6540,4874,288,4586,2001,t1,cantonales
3871,28,EURE ET LOIR,13790,7847,433,7414,2001,t1,cantonales
3872,28,EURE ET LOIR,8252,4426,355,4071,2001,t1,cantonales
3873,28,EURE ET LOIR,12938,6835,374,6461,2001,t1,cantonales
3874,29,FINISTERE,10748,5813,142,5671,2001,t1,cantonales
3875,29,FINISTERE,6961,5304,135,5169,2001,t1,cantonales
3876,29,FINISTERE,13466,9952,442,9510,2001,t1,cantonales
3877,29,FINISTERE,10373,8318,238,8080,2001,t1,cantonales
3878,29,FINISTERE,19024,12302,402,11900,2001,t1,cantonales
3879,29,FINISTERE,4928,3773,106,3667,2001,t1,cantonales
3880,29,FINISTERE,4606,3684,143,3541,2001,t1,cantonales
3881,29,FINISTERE,17991,12317,301,12016,2001,t1,cantonales
3882,29,FINISTERE,12124,8594,593,8001,2001,t1,cantonales
3883,29,FINISTERE,16898,12349,482,11867,2001,t1,cantonales
3884,29,FINISTERE,18067,11565,364,11201,2001,t1,cantonales
3885,29,FINISTERE,959,801,28,773,2001,t1,cantonales
3886,29,FINISTERE,13874,10546,320,10226,2001,t1,cantonales
3887,29,FINISTERE,3181,2496,73,2423,2001,t1,cantonales
3888,29,FINISTERE,8139,6297,182,6115,2001,t1,cantonales
3889,29,FINISTERE,13417,9045,321,8724,2001,t1,cantonales
3890,29,FINISTERE,16592,10410,335,10075,2001,t1,cantonales
3891,29,FINISTERE,15516,10215,298,9917,2001,t1,cantonales
3892,29,FINISTERE,21877,15114,364,14750,2001,t1,cantonales
3893,29,FINISTERE,6532,4952,159,4793,2001,t1,cantonales
3894,29,FINISTERE,3101,2479,57,2422,2001,t1,cantonales
3895,29,FINISTERE,7682,5672,174,5498,2001,t1,cantonales
3896,29,FINISTERE,8070,4038,146,3892,2001,t1,cantonales
3897,29,FINISTERE,19201,12442,397,12045,2001,t1,cantonales
3898,29,FINISTERE,17494,11426,288,11138,2001,t1,cantonales
3899,29,FINISTERE,16225,10197,405,9792,2001,t1,cantonales
3900,30,GARD,7816,5648,351,5297,2001,t1,cantonales
3901,30,GARD,9742,7451,355,7096,2001,t1,cantonales
3902,30,GARD,22900,15838,710,15128,2001,t1,cantonales
3903,30,GARD,16305,11761,575,11186,2001,t1,cantonales
3904,30,GARD,3412,2749,157,2592,2001,t1,cantonales
3905,30,GARD,8393,6046,406,5640,2001,t1,cantonales
3906,30,GARD,2400,2010,77,1933,2001,t1,cantonales
3907,30,GARD,3025,2555,69,2486,2001,t1,cantonales
3908,30,GARD,17884,12389,636,11753,2001,t1,cantonales
3909,30,GARD,18892,11070,369,10701,2001,t1,cantonales
3910,30,GARD,17239,9302,345,8957,2001,t1,cantonales
3911,30,GARD,3789,3141,88,3053,2001,t1,cantonales
3912,30,GARD,5816,4584,205,4379,2001,t1,cantonales
3913,30,GARD,10202,7649,329,7320,2001,t1,cantonales
3914,30,GARD,9467,6522,223,6299,2001,t1,cantonales
3915,30,GARD,3587,2732,161,2571,2001,t1,cantonales
3916,30,GARD,2429,2007,90,1917,2001,t1,cantonales
3917,30,GARD,1682,1330,115,1215,2001,t1,cantonales
3918,30,GARD,21689,14641,532,14109,2001,t1,cantonales
3919,30,GARD,18760,12315,475,11840,2001,t1,cantonales
3920,30,GARD,9514,4642,208,4434,2001,t1,cantonales
3921,30,GARD,14577,9881,452,9429,2001,t1,cantonales
3922,30,GARD,13805,9979,447,9532,2001,t1,cantonales
3923,31,HAUTE GARONNE,4517,3772,151,3621,2001,t1,cantonales
3924,31,HAUTE GARONNE,11473,8212,372,7840,2001,t1,cantonales
3925,31,HAUTE GARONNE,5193,4039,437,3602,2001,t1,cantonales
3926,31,HAUTE GARONNE,4842,3973,148,3825,2001,t1,cantonales
3927,31,HAUTE GARONNE,9439,7129,431,6698,2001,t1,cantonales
3928,31,HAUTE GARONNE,3831,3090,160,2930,2001,t1,cantonales
3929,31,HAUTE GARONNE,16428,11985,604,11381,2001,t1,cantonales
3930,31,HAUTE GARONNE,25688,16642,720,15922,2001,t1,cantonales
3931,31,HAUTE GARONNE,2976,2325,125,2200,2001,t1,cantonales
3932,31,HAUTE GARONNE,14612,10849,835,10014,2001,t1,cantonales
3933,31,HAUTE GARONNE,6121,4951,189,4762,2001,t1,cantonales
3934,31,HAUTE GARONNE,3746,2952,221,2731,2001,t1,cantonales
3935,31,HAUTE GARONNE,3900,3131,250,2881,2001,t1,cantonales
3936,31,HAUTE GARONNE,13875,9768,407,9361,2001,t1,cantonales
3937,31,HAUTE GARONNE,7050,5316,374,4942,2001,t1,cantonales
3938,31,HAUTE GARONNE,13591,7892,249,7643,2001,t1,cantonales
3939,31,HAUTE GARONNE,4475,3706,121,3585,2001,t1,cantonales
3940,31,HAUTE GARONNE,6234,4826,300,4526,2001,t1,cantonales
3941,31,HAUTE GARONNE,12593,7227,249,6978,2001,t1,cantonales
3942,31,HAUTE GARONNE,11476,6640,250,6390,2001,t1,cantonales
3943,31,HAUTE GARONNE,32402,21496,905,20591,2001,t1,cantonales
3944,31,HAUTE GARONNE,26629,16015,672,15343,2001,t1,cantonales
3945,31,HAUTE GARONNE,15634,8793,403,8390,2001,t1,cantonales
3946,31,HAUTE GARONNE,14957,8479,329,8150,2001,t1,cantonales
3947,31,HAUTE GARONNE,35705,22895,1151,21744,2001,t1,cantonales
3948,31,HAUTE GARONNE,23765,16158,993,15165,2001,t1,cantonales
3949,32,GERS,2377,2042,84,1958,2001,t1,cantonales
3950,32,GERS,6727,4795,221,4574,2001,t1,cantonales
3951,32,GERS,7856,5990,243,5747,2001,t1,cantonales
3952,32,GERS,4855,3768,234,3534,2001,t1,cantonales
3953,32,GERS,5005,4099,109,3990,2001,t1,cantonales
3954,32,GERS,7693,5695,194,5501,2001,t1,cantonales
3955,32,GERS,4937,3847,229,3618,2001,t1,cantonales
3956,32,GERS,2572,2079,223,1856,2001,t1,cantonales
3957,32,GERS,3200,2720,100,2620,2001,t1,cantonales
3958,32,GERS,5703,4909,183,4726,2001,t1,cantonales
3959,32,GERS,2469,2206,81,2125,2001,t1,cantonales
3960,32,GERS,6140,5079,242,4837,2001,t1,cantonales
3961,32,GERS,3200,2663,374,2289,2001,t1,cantonales
3962,32,GERS,4748,3924,185,3739,2001,t1,cantonales
3963,32,GERS,6622,4646,247,4399,2001,t1,cantonales
3964,33,GIRONDE,6349,5033,242,4791,2001,t1,cantonales
3965,33,GIRONDE,32636,19615,981,18634,2001,t1,cantonales
3966,33,GIRONDE,9469,6647,347,6300,2001,t1,cantonales
3967,33,GIRONDE,10540,5504,204,5300,2001,t1,cantonales
3968,33,GIRONDE,17567,8883,235,8648,2001,t1,cantonales
3969,33,GIRONDE,15288,7862,263,7599,2001,t1,cantonales
3970,33,GIRONDE,10057,5139,137,5002,2001,t1,cantonales
3971,33,GIRONDE,6512,3362,119,3243,2001,t1,cantonales
3972,33,GIRONDE,7274,5142,246,4896,2001,t1,cantonales
3973,33,GIRONDE,14165,10177,886,9291,2001,t1,cantonales
3974,33,GIRONDE,27055,17797,655,17142,2001,t1,cantonales
3975,33,GIRONDE,10063,6923,759,6164,2001,t1,cantonales
3976,33,GIRONDE,2143,1822,91,1731,2001,t1,cantonales
3977,33,GIRONDE,10708,8206,348,7858,2001,t1,cantonales
3978,33,GIRONDE,11511,8260,324,7936,2001,t1,cantonales
3979,33,GIRONDE,5639,4296,301,3995,2001,t1,cantonales
3980,33,GIRONDE,2077,1683,76,1607,2001,t1,cantonales
3981,33,GIRONDE,11678,8823,512,8311,2001,t1,cantonales
3982,33,GIRONDE,9212,7098,328,6770,2001,t1,cantonales
3983,33,GIRONDE,11734,7691,448,7243,2001,t1,cantonales
3984,33,GIRONDE,8514,6113,359,5754,2001,t1,cantonales
3985,33,GIRONDE,12031,8425,502,7923,2001,t1,cantonales
3986,33,GIRONDE,7008,5322,192,5130,2001,t1,cantonales
3987,33,GIRONDE,4411,3588,147,3441,2001,t1,cantonales
3988,33,GIRONDE,31064,20329,665,19664,2001,t1,cantonales
3989,33,GIRONDE,20989,11541,510,11031,2001,t1,cantonales
3990,33,GIRONDE,20814,12565,553,12012,2001,t1,cantonales
3991,33,GIRONDE,17217,10494,381,10113,2001,t1,cantonales
3992,33,GIRONDE,30036,18328,761,17567,2001,t1,cantonales
3993,33,GIRONDE,16738,9786,543,9243,2001,t1,cantonales
3994,33,GIRONDE,17993,9480,440,9040,2001,t1,cantonales
3995,33,GIRONDE,31592,20265,753,19512,2001,t1,cantonales
3996,34,HERAULT,27151,18699,838,17861,2001,t1,cantonales
3997,34,HERAULT,5541,4195,190,4005,2001,t1,cantonales
3998,34,HERAULT,7374,5444,227,5217,2001,t1,cantonales
3999,34,HERAULT,13521,7731,317,7414,2001,t1,cantonales
4000,34,HERAULT,22120,15135,683,14452,2001,t1,cantonales
4001,34,HERAULT,2668,2159,189,1970,2001,t1,cantonales
4002,34,HERAULT,5695,4373,279,4094,2001,t1,cantonales
4003,34,HERAULT,27991,18649,973,17676,2001,t1,cantonales
4004,34,HERAULT,14656,10829,819,10010,2001,t1,cantonales
4005,34,HERAULT,8036,5994,239,5755,2001,t1,cantonales
4006,34,HERAULT,3293,2724,136,2588,2001,t1,cantonales
4007,34,HERAULT,17179,11907,442,11465,2001,t1,cantonales
4008,34,HERAULT,6762,5259,235,5024,2001,t1,cantonales
4009,34,HERAULT,11442,5516,260,5256,2001,t1,cantonales
4010,34,HERAULT,13013,7852,303,7549,2001,t1,cantonales
4011,34,HERAULT,4174,3364,194,3170,2001,t1,cantonales
4012,34,HERAULT,5178,4070,137,3933,2001,t1,cantonales
4013,34,HERAULT,3223,2534,140,2394,2001,t1,cantonales
4014,34,HERAULT,3295,2477,166,2311,2001,t1,cantonales
4015,34,HERAULT,15221,9270,390,8880,2001,t1,cantonales
4016,34,HERAULT,12476,6934,292,6642,2001,t1,cantonales
4017,34,HERAULT,10870,6123,242,5881,2001,t1,cantonales
4018,34,HERAULT,19542,11594,520,11074,2001,t1,cantonales
4019,35,ILLE ET VILAINE,6549,5293,256,5037,2001,t1,cantonales
4020,35,ILLE ET VILAINE,9008,6755,417,6338,2001,t1,cantonales
4021,35,ILLE ET VILAINE,15798,11067,517,10550,2001,t1,cantonales
4022,35,ILLE ET VILAINE,8073,6217,210,6007,2001,t1,cantonales
4023,35,ILLE ET VILAINE,17906,11920,449,11471,2001,t1,cantonales
4024,35,ILLE ET VILAINE,9198,6791,379,6412,2001,t1,cantonales
4025,35,ILLE ET VILAINE,16834,11132,685,10447,2001,t1,cantonales
4026,35,ILLE ET VILAINE,8114,6204,461,5743,2001,t1,cantonales
4027,35,ILLE ET VILAINE,15377,10334,445,9889,2001,t1,cantonales
4028,35,ILLE ET VILAINE,8829,6569,293,6276,2001,t1,cantonales
4029,35,ILLE ET VILAINE,5252,4176,135,4041,2001,t1,cantonales
4030,35,ILLE ET VILAINE,6734,5211,202,5009,2001,t1,cantonales
4031,35,ILLE ET VILAINE,17101,11596,458,11138,2001,t1,cantonales
4032,35,ILLE ET VILAINE,17508,11754,428,11326,2001,t1,cantonales
4033,35,ILLE ET VILAINE,12456,8431,245,8186,2001,t1,cantonales
4034,35,ILLE ET VILAINE,15597,8836,267,8569,2001,t1,cantonales
4035,35,ILLE ET VILAINE,6044,4863,191,4672,2001,t1,cantonales
4036,35,ILLE ET VILAINE,21207,12590,498,12092,2001,t1,cantonales
4037,35,ILLE ET VILAINE,6622,5216,145,5071,2001,t1,cantonales
4038,35,ILLE ET VILAINE,6349,5271,319,4952,2001,t1,cantonales
4039,35,ILLE ET VILAINE,15396,10125,674,9451,2001,t1,cantonales
4040,35,ILLE ET VILAINE,10621,5319,151,5168,2001,t1,cantonales
4041,35,ILLE ET VILAINE,9809,4975,169,4806,2001,t1,cantonales
4042,35,ILLE ET VILAINE,16626,9340,324,9016,2001,t1,cantonales
4043,35,ILLE ET VILAINE,9228,4337,173,4164,2001,t1,cantonales
4044,35,ILLE ET VILAINE,16254,10656,351,10305,2001,t1,cantonales
4045,36,INDRE,11859,8248,488,7760,2001,t1,cantonales
4046,36,INDRE,2916,2262,98,2164,2001,t1,cantonales
4047,36,INDRE,8647,5946,382,5564,2001,t1,cantonales
4048,36,INDRE,9061,7010,367,6643,2001,t1,cantonales
4049,36,INDRE,12202,7345,396,6949,2001,t1,cantonales
4050,36,INDRE,5245,4159,225,3934,2001,t1,cantonales
4051,36,INDRE,10412,7855,445,7410,2001,t1,cantonales
4052,36,INDRE,8675,6117,297,5820,2001,t1,cantonales
4053,36,INDRE,6019,4504,339,4165,2001,t1,cantonales
4054,36,INDRE,4905,3824,199,3625,2001,t1,cantonales
4055,36,INDRE,4830,3752,163,3589,2001,t1,cantonales
4056,36,INDRE,3692,2840,160,2680,2001,t1,cantonales
4057,36,INDRE,7536,4000,335,3665,2001,t1,cantonales
4058,37,INDRE ET LOIRE ,16658,10993,543,10450,2001,t1,cantonales
4059,37,INDRE ET LOIRE ,10038,7147,480,6667,2001,t1,cantonales
4060,37,INDRE ET LOIRE ,14394,9387,644,8743,2001,t1,cantonales
4061,37,INDRE ET LOIRE ,6699,4998,205,4793,2001,t1,cantonales
4062,37,INDRE ET LOIRE ,7496,5254,491,4763,2001,t1,cantonales
4063,37,INDRE ET LOIRE ,13331,9527,472,9055,2001,t1,cantonales
4064,37,INDRE ET LOIRE ,8156,5727,374,5353,2001,t1,cantonales
4065,37,INDRE ET LOIRE ,4407,3310,426,2884,2001,t1,cantonales
4066,37,INDRE ET LOIRE ,8043,6118,264,5854,2001,t1,cantonales
4067,37,INDRE ET LOIRE ,11427,5615,120,5495,2001,t1,cantonales
4068,37,INDRE ET LOIRE ,17314,11707,739,10968,2001,t1,cantonales
4069,37,INDRE ET LOIRE ,10889,5648,186,5462,2001,t1,cantonales
4070,37,INDRE ET LOIRE ,12296,6586,295,6291,2001,t1,cantonales
4071,37,INDRE ET LOIRE ,11734,6665,209,6456,2001,t1,cantonales
4072,37,INDRE ET LOIRE ,10301,5588,149,5439,2001,t1,cantonales
4073,37,INDRE ET LOIRE ,14078,8966,359,8607,2001,t1,cantonales
4074,37,INDRE ET LOIRE ,10547,6551,203,6348,2001,t1,cantonales
4075,37,INDRE ET LOIRE ,13310,8893,440,8453,2001,t1,cantonales
4076,38,ISERE,4570,3173,90,3083,2001,t1,cantonales
4077,38,ISERE,9179,6264,798,5466,2001,t1,cantonales
4078,38,ISERE,8795,6421,305,6116,2001,t1,cantonales
4079,38,ISERE,16807,11615,324,11291,2001,t1,cantonales
4080,38,ISERE,12765,8543,383,8160,2001,t1,cantonales
4081,38,ISERE,13012,6851,218,6633,2001,t1,cantonales
4082,38,ISERE,12835,8082,350,7732,2001,t1,cantonales
4083,38,ISERE,4448,3375,120,3255,2001,t1,cantonales
4084,38,ISERE,18451,11943,408,11535,2001,t1,cantonales
4085,38,ISERE,4385,3493,316,3177,2001,t1,cantonales
4086,38,ISERE,7357,5360,266,5094,2001,t1,cantonales
4087,38,ISERE,7544,5247,132,5115,2001,t1,cantonales
4088,38,ISERE,16249,10330,472,9858,2001,t1,cantonales
4089,38,ISERE,15767,11028,435,10593,2001,t1,cantonales
4090,38,ISERE,21907,12378,569,11809,2001,t1,cantonales
4091,38,ISERE,21073,13495,477,13018,2001,t1,cantonales
4092,38,ISERE,6555,4738,176,4562,2001,t1,cantonales
4093,38,ISERE,19394,12313,458,11855,2001,t1,cantonales
4094,38,ISERE,12814,7784,315,7469,2001,t1,cantonales
4095,38,ISERE,9918,5062,159,4903,2001,t1,cantonales
4096,38,ISERE,14175,7035,271,6764,2001,t1,cantonales
4097,38,ISERE,19728,12451,392,12059,2001,t1,cantonales
4098,38,ISERE,14621,8947,508,8439,2001,t1,cantonales
4099,38,ISERE,10286,5816,226,5590,2001,t1,cantonales
4100,38,ISERE,12027,7249,635,6614,2001,t1,cantonales
4101,38,ISERE,18079,10361,356,10005,2001,t1,cantonales
4102,38,ISERE,14523,7746,314,7432,2001,t1,cantonales
4103,38,ISERE,5962,3134,129,3005,2001,t1,cantonales
4104,38,ISERE,13098,8403,400,8003,2001,t1,cantonales
4105,39,JURA,4867,3734,244,3490,2001,t1,cantonales
4106,39,JURA,12470,9172,605,8567,2001,t1,cantonales
4107,39,JURA,2002,1639,78,1561,2001,t1,cantonales
4108,39,JURA,4707,3706,114,3592,2001,t1,cantonales
4109,39,JURA,4921,3730,196,3534,2001,t1,cantonales
4110,39,JURA,1925,1594,54,1540,2001,t1,cantonales
4111,39,JURA,3143,2569,123,2446,2001,t1,cantonales
4112,39,JURA,6898,5021,263,4758,2001,t1,cantonales
4113,39,JURA,4408,3491,135,3356,2001,t1,cantonales
4114,39,JURA,3369,2769,122,2647,2001,t1,cantonales
4115,39,JURA,13480,8968,569,8399,2001,t1,cantonales
4116,39,JURA,1540,1228,199,1029,2001,t1,cantonales
4117,39,JURA,3961,3024,175,2849,2001,t1,cantonales
4118,39,JURA,4486,3244,208,3036,2001,t1,cantonales
4119,39,JURA,4844,3773,201,3572,2001,t1,cantonales
4120,39,JURA,11503,7417,375,7042,2001,t1,cantonales
4121,39,JURA,10187,6499,389,6110,2001,t1,cantonales
4122,40,LANDES,7265,5246,816,4430,2001,t1,cantonales
4123,40,LANDES,5360,4387,319,4068,2001,t1,cantonales
4124,40,LANDES,7544,6210,483,5727,2001,t1,cantonales
4125,40,LANDES,4382,3734,291,3443,2001,t1,cantonales
4126,40,LANDES,15186,10670,364,10306,2001,t1,cantonales
4127,40,LANDES,7636,5976,407,5569,2001,t1,cantonales
4128,40,LANDES,5729,4647,289,4358,2001,t1,cantonales
4129,40,LANDES,4310,3324,164,3160,2001,t1,cantonales
4130,40,LANDES,15595,11313,470,10843,2001,t1,cantonales
4131,40,LANDES,7185,5995,256,5739,2001,t1,cantonales
4132,40,LANDES,1471,1245,36,1209,2001,t1,cantonales
4133,40,LANDES,17152,12367,629,11738,2001,t1,cantonales
4134,40,LANDES,4158,3218,557,2661,2001,t1,cantonales
4135,40,LANDES,7205,5600,559,5041,2001,t1,cantonales
4136,40,LANDES,4461,3479,398,3081,2001,t1,cantonales
4137,40,LANDES,20590,13415,725,12690,2001,t1,cantonales
4138,41,LOIR ET CHER,11521,6984,283,6701,2001,t1,cantonales
4139,41,LOIR ET CHER,13012,9060,447,8613,2001,t1,cantonales
4140,41,LOIR ET CHER,2825,2200,128,2072,2001,t1,cantonales
4141,41,LOIR ET CHER,10940,7806,476,7330,2001,t1,cantonales
4142,41,LOIR ET CHER,7529,5299,310,4989,2001,t1,cantonales
4143,41,LOIR ET CHER,5266,3871,189,3682,2001,t1,cantonales
4144,41,LOIR ET CHER,7905,5696,263,5433,2001,t1,cantonales
4145,41,LOIR ET CHER,6336,4711,264,4447,2001,t1,cantonales
4146,41,LOIR ET CHER,13318,9619,446,9173,2001,t1,cantonales
4147,41,LOIR ET CHER,3558,2711,170,2541,2001,t1,cantonales
4148,41,LOIR ET CHER,7623,5477,304,5173,2001,t1,cantonales
4149,41,LOIR ET CHER,2912,2302,139,2163,2001,t1,cantonales
4150,41,LOIR ET CHER,9101,6415,283,6132,2001,t1,cantonales
4151,41,LOIR ET CHER,7998,4948,326,4622,2001,t1,cantonales
4152,41,LOIR ET CHER,6873,4570,213,4357,2001,t1,cantonales
4153,42,LOIRE,8690,6764,338,6426,2001,t1,cantonales
4154,42,LOIRE,13757,8502,357,8145,2001,t1,cantonales
4155,42,LOIRE,10653,7302,394,6908,2001,t1,cantonales
4156,42,LOIRE,22476,13179,559,12620,2001,t1,cantonales
4157,42,LOIRE,6144,4199,289,3910,2001,t1,cantonales
4158,42,LOIRE,3560,2930,91,2839,2001,t1,cantonales
4159,42,LOIRE,9570,6869,285,6584,2001,t1,cantonales
4160,42,LOIRE,18053,9321,427,8894,2001,t1,cantonales
4161,42,LOIRE,15396,7926,229,7697,2001,t1,cantonales
4162,42,LOIRE,20218,11430,344,11086,2001,t1,cantonales
4163,42,LOIRE,22284,14081,679,13402,2001,t1,cantonales
4164,42,LOIRE,4475,3407,114,3293,2001,t1,cantonales
4165,42,LOIRE,4609,3617,162,3455,2001,t1,cantonales
4166,42,LOIRE,23552,14695,694,14001,2001,t1,cantonales
4167,42,LOIRE,8887,6619,289,6330,2001,t1,cantonales
4168,42,LOIRE,14570,9071,275,8796,2001,t1,cantonales
4169,42,LOIRE,24642,14759,652,14107,2001,t1,cantonales
4170,42,LOIRE,16014,7886,206,7680,2001,t1,cantonales
4171,42,LOIRE,13148,6151,178,5973,2001,t1,cantonales
4172,43,HAUTE LOIRE,2683,2229,47,2182,2001,t1,cantonales
4173,43,HAUTE LOIRE,4847,3865,186,3679,2001,t1,cantonales
4174,43,HAUTE LOIRE,2026,1821,61,1760,2001,t1,cantonales
4175,43,HAUTE LOIRE,2106,1622,68,1554,2001,t1,cantonales
4176,43,HAUTE LOIRE,3767,2984,97,2887,2001,t1,cantonales
4177,43,HAUTE LOIRE,6250,4987,257,4730,2001,t1,cantonales
4178,43,HAUTE LOIRE,3724,3057,114,2943,2001,t1,cantonales
4179,43,HAUTE LOIRE,3488,2797,189,2608,2001,t1,cantonales
4180,43,HAUTE LOIRE,1114,943,22,921,2001,t1,cantonales
4181,43,HAUTE LOIRE,7439,5208,251,4957,2001,t1,cantonales
4182,43,HAUTE LOIRE,8050,5678,257,5421,2001,t1,cantonales
4183,43,HAUTE LOIRE,2356,1719,55,1664,2001,t1,cantonales
4184,43,HAUTE LOIRE,9661,7208,340,6868,2001,t1,cantonales
4185,43,HAUTE LOIRE,4214,3475,99,3376,2001,t1,cantonales
4186,43,HAUTE LOIRE,8569,6520,390,6130,2001,t1,cantonales
4187,43,HAUTE LOIRE,3549,2587,103,2484,2001,t1,cantonales
4188,43,HAUTE LOIRE,5310,3391,174,3217,2001,t1,cantonales
4189,43,HAUTE LOIRE,4893,3714,187,3527,2001,t1,cantonales
4190,44,LOIRE ATLANTIQUE,28019,17697,654,17043,2001,t1,cantonales
4191,44,LOIRE ATLANTIQUE,7169,5367,241,5126,2001,t1,cantonales
4192,44,LOIRE ATLANTIQUE,23615,15263,684,14579,2001,t1,cantonales
4193,44,LOIRE ATLANTIQUE,11781,8261,342,7919,2001,t1,cantonales
4194,44,LOIRE ATLANTIQUE,9805,6701,136,6565,2001,t1,cantonales
4195,44,LOIRE ATLANTIQUE,19833,13223,547,12676,2001,t1,cantonales
4196,44,LOIRE ATLANTIQUE,5142,3966,105,3861,2001,t1,cantonales
4197,44,LOIRE ATLANTIQUE,6818,4753,242,4511,2001,t1,cantonales
4198,44,LOIRE ATLANTIQUE,8757,6133,288,5845,2001,t1,cantonales
4199,44,LOIRE ATLANTIQUE,4721,3622,170,3452,2001,t1,cantonales
4200,44,LOIRE ATLANTIQUE,20367,10016,376,9640,2001,t1,cantonales
4201,44,LOIRE ATLANTIQUE,20744,10237,287,9950,2001,t1,cantonales
4202,44,LOIRE ATLANTIQUE,16696,8429,285,8144,2001,t1,cantonales
4203,44,LOIRE ATLANTIQUE,12790,6001,197,5804,2001,t1,cantonales
4204,44,LOIRE ATLANTIQUE,8781,6465,331,6134,2001,t1,cantonales
4205,44,LOIRE ATLANTIQUE,16772,11154,528,10626,2001,t1,cantonales
4206,44,LOIRE ATLANTIQUE,14952,10007,429,9578,2001,t1,cantonales
4207,44,LOIRE ATLANTIQUE,9062,6136,242,5894,2001,t1,cantonales
4208,44,LOIRE ATLANTIQUE,3582,2806,89,2717,2001,t1,cantonales
4209,44,LOIRE ATLANTIQUE,4191,3100,172,2928,2001,t1,cantonales
4210,44,LOIRE ATLANTIQUE,8070,5624,126,5498,2001,t1,cantonales
4211,44,LOIRE ATLANTIQUE,6815,4737,216,4521,2001,t1,cantonales
4212,44,LOIRE ATLANTIQUE,10460,6885,445,6440,2001,t1,cantonales
4213,44,LOIRE ATLANTIQUE,15824,9235,502,8733,2001,t1,cantonales
4214,44,LOIRE ATLANTIQUE,15255,7905,295,7610,2001,t1,cantonales
4215,44,LOIRE ATLANTIQUE,24950,14173,371,13802,2001,t1,cantonales
4216,44,LOIRE ATLANTIQUE,19916,10637,875,9762,2001,t1,cantonales
4217,44,LOIRE ATLANTIQUE,15020,8233,424,7809,2001,t1,cantonales
4218,44,LOIRE ATLANTIQUE,15106,7198,284,6914,2001,t1,cantonales
4219,44,LOIRE ATLANTIQUE,14152,9392,282,9110,2001,t1,cantonales
4220,45,LOIRET,10673,7187,338,6849,2001,t1,cantonales
4221,45,LOIRET,6565,4857,323,4534,2001,t1,cantonales
4222,45,LOIRET,4688,3483,135,3348,2001,t1,cantonales
4223,45,LOIRET,7196,5026,245,4781,2001,t1,cantonales
4224,45,LOIRET,5036,3706,134,3572,2001,t1,cantonales
4225,45,LOIRET,6249,4350,172,4178,2001,t1,cantonales
4226,45,LOIRET,10103,7053,374,6679,2001,t1,cantonales
4227,45,LOIRET,9596,7134,261,6873,2001,t1,cantonales
4228,45,LOIRET,16096,10894,483,10411,2001,t1,cantonales
4229,45,LOIRET,9452,6505,328,6177,2001,t1,cantonales
4230,45,LOIRET,10289,5171,223,4948,2001,t1,cantonales
4231,45,LOIRET,8539,4194,200,3994,2001,t1,cantonales
4232,45,LOIRET,11162,5843,248,5595,2001,t1,cantonales
4233,45,LOIRET,5858,4271,344,3927,2001,t1,cantonales
4234,45,LOIRET,6278,4301,191,4110,2001,t1,cantonales
4235,45,LOIRET,15296,9739,650,9089,2001,t1,cantonales
4236,45,LOIRET,17825,11077,418,10659,2001,t1,cantonales
4237,45,LOIRET,8893,4844,181,4663,2001,t1,cantonales
4238,45,LOIRET,11615,7813,290,7523,2001,t1,cantonales
4239,45,LOIRET,22342,14465,571,13894,2001,t1,cantonales
4240,45,LOIRET,9030,4353,140,4213,2001,t1,cantonales
4241,46,LOT,6579,5423,299,5124,2001,t1,cantonales
4242,46,LOT,3096,2592,138,2454,2001,t1,cantonales
4243,46,LOT,3789,3115,187,2928,2001,t1,cantonales
4244,46,LOT,5979,4550,392,4158,2001,t1,cantonales
4245,46,LOT,1774,1511,54,1457,2001,t1,cantonales
4246,46,LOT,3899,3210,274,2936,2001,t1,cantonales
4247,46,LOT,2467,2148,188,1960,2001,t1,cantonales
4248,46,LOT,2676,2313,129,2184,2001,t1,cantonales
4249,46,LOT,2983,2576,180,2396,2001,t1,cantonales
4250,46,LOT,3050,2514,221,2293,2001,t1,cantonales
4251,46,LOT,7287,5598,337,5261,2001,t1,cantonales
4252,46,LOT,5866,4561,293,4268,2001,t1,cantonales
4253,46,LOT,1981,1696,140,1556,2001,t1,cantonales
4254,46,LOT,1944,1598,83,1515,2001,t1,cantonales
4255,46,LOT,3485,2974,97,2877,2001,t1,cantonales
4256,47,LOT ET GARONNE ,8235,5278,217,5061,2001,t1,cantonales
4257,47,LOT ET GARONNE ,5798,4586,232,4354,2001,t1,cantonales
4258,47,LOT ET GARONNE ,5098,3975,175,3800,2001,t1,cantonales
4259,47,LOT ET GARONNE ,2702,2238,97,2141,2001,t1,cantonales
4260,47,LOT ET GARONNE ,2625,2182,96,2086,2001,t1,cantonales
4261,47,LOT ET GARONNE ,2152,1842,83,1759,2001,t1,cantonales
4262,47,LOT ET GARONNE ,7081,5452,240,5212,2001,t1,cantonales
4263,47,LOT ET GARONNE ,7206,5603,241,5362,2001,t1,cantonales
4264,47,LOT ET GARONNE ,6463,4897,320,4577,2001,t1,cantonales
4265,47,LOT ET GARONNE ,4386,3617,168,3449,2001,t1,cantonales
4266,47,LOT ET GARONNE ,2990,2419,89,2330,2001,t1,cantonales
4267,47,LOT ET GARONNE ,6993,5252,273,4979,2001,t1,cantonales
4268,47,LOT ET GARONNE ,5619,4342,209,4133,2001,t1,cantonales
4269,47,LOT ET GARONNE ,6045,4625,202,4423,2001,t1,cantonales
4270,47,LOT ET GARONNE ,4651,3718,157,3561,2001,t1,cantonales
4271,47,LOT ET GARONNE ,4484,3711,174,3537,2001,t1,cantonales
4272,47,LOT ET GARONNE ,5009,3674,198,3476,2001,t1,cantonales
4273,47,LOT ET GARONNE ,2879,2409,157,2252,2001,t1,cantonales
4274,47,LOT ET GARONNE ,9562,6444,288,6156,2001,t1,cantonales
4275,47,LOT ET GARONNE ,9721,6460,405,6055,2001,t1,cantonales
4276,48,LOZERE,1099,879,61,818,2001,t1,cantonales
4277,48,LOZERE,1733,1462,37,1425,2001,t1,cantonales
4278,48,LOZERE,2408,2002,90,1912,2001,t1,cantonales
4279,48,LOZERE,3039,2449,117,2332,2001,t1,cantonales
4280,48,LOZERE,1684,1467,37,1430,2001,t1,cantonales
4281,48,LOZERE,5526,4388,233,4155,2001,t1,cantonales
4282,48,LOZERE,802,711,76,635,2001,t1,cantonales
4283,48,LOZERE,6250,4851,280,4571,2001,t1,cantonales
4284,48,LOZERE,1255,1045,62,983,2001,t1,cantonales
4285,48,LOZERE,2061,1803,26,1777,2001,t1,cantonales
4286,48,LOZERE,5020,4365,115,4250,2001,t1,cantonales
4287,48,LOZERE,2286,2042,83,1959,2001,t1,cantonales
4288,48,LOZERE,4238,3312,88,3224,2001,t1,cantonales
4289,49,MAINE ET LOIRE ,18294,10435,637,9798,2001,t1,cantonales
4290,49,MAINE ET LOIRE ,19068,11007,468,10539,2001,t1,cantonales
4291,49,MAINE ET LOIRE ,18764,10266,336,9930,2001,t1,cantonales
4292,49,MAINE ET LOIRE ,11849,8330,385,7945,2001,t1,cantonales
4293,49,MAINE ET LOIRE ,19649,13662,1134,12528,2001,t1,cantonales
4294,49,MAINE ET LOIRE ,9769,6894,524,6370,2001,t1,cantonales
4295,49,MAINE ET LOIRE ,7654,5564,249,5315,2001,t1,cantonales
4296,49,MAINE ET LOIRE ,10438,7095,888,6207,2001,t1,cantonales
4297,49,MAINE ET LOIRE ,7586,5703,318,5385,2001,t1,cantonales
4298,49,MAINE ET LOIRE ,9260,6058,368,5690,2001,t1,cantonales
4299,49,MAINE ET LOIRE ,6068,4542,219,4323,2001,t1,cantonales
4300,49,MAINE ET LOIRE ,16408,11317,767,10550,2001,t1,cantonales
4301,49,MAINE ET LOIRE ,9122,6077,370,5707,2001,t1,cantonales
4302,49,MAINE ET LOIRE ,4533,3459,142,3317,2001,t1,cantonales
4303,49,MAINE ET LOIRE ,7349,5401,307,5094,2001,t1,cantonales
4304,49,MAINE ET LOIRE ,12709,9205,416,8789,2001,t1,cantonales
4305,49,MAINE ET LOIRE ,9166,6512,352,6160,2001,t1,cantonales
4306,49,MAINE ET LOIRE ,10811,7713,595,7118,2001,t1,cantonales
4307,49,MAINE ET LOIRE ,15291,9705,532,9173,2001,t1,cantonales
4308,49,MAINE ET LOIRE ,18564,11415,653,10762,2001,t1,cantonales
4309,49,MAINE ET LOIRE ,13606,8257,337,7920,2001,t1,cantonales
4310,50,MANCHE,13755,9528,577,8951,2001,t1,cantonales
4311,50,MANCHE,2666,2071,155,1916,2001,t1,cantonales
4312,50,MANCHE,4951,3555,284,3271,2001,t1,cantonales
4313,50,MANCHE,4081,3005,248,2757,2001,t1,cantonales
4314,50,MANCHE,7062,3519,170,3349,2001,t1,cantonales
4315,50,MANCHE,5042,3963,269,3694,2001,t1,cantonales
4316,50,MANCHE,4150,3206,167,3039,2001,t1,cantonales
4317,50,MANCHE,18087,10762,541,10221,2001,t1,cantonales
4318,50,MANCHE,4842,3693,226,3467,2001,t1,cantonales
4319,50,MANCHE,6964,5128,295,4833,2001,t1,cantonales
4320,50,MANCHE,4966,3534,178,3356,2001,t1,cantonales
4321,50,MANCHE,4749,3704,234,3470,2001,t1,cantonales
4322,50,MANCHE,6217,4444,494,3950,2001,t1,cantonales
4323,50,MANCHE,5341,4163,205,3958,2001,t1,cantonales
4324,50,MANCHE,12514,7138,455,6683,2001,t1,cantonales
4325,50,MANCHE,8490,6230,336,5894,2001,t1,cantonales
4326,50,MANCHE,7142,5265,321,4944,2001,t1,cantonales
4327,50,MANCHE,5564,3769,252,3517,2001,t1,cantonales
4328,50,MANCHE,8995,6976,408,6568,2001,t1,cantonales
4329,50,MANCHE,9771,5982,398,5584,2001,t1,cantonales
4330,50,MANCHE,2425,1914,118,1796,2001,t1,cantonales
4331,50,MANCHE,4088,3163,142,3021,2001,t1,cantonales
4332,50,MANCHE,4934,3722,128,3594,2001,t1,cantonales
4333,50,MANCHE,5367,3996,276,3720,2001,t1,cantonales
4334,50,MANCHE,4152,3301,303,2998,2001,t1,cantonales
4335,50,MANCHE,17681,11009,547,10462,2001,t1,cantonales
4336,51,MARNE,4951,3746,268,3478,2001,t1,cantonales
4337,51,MARNE,13465,8856,457,8399,2001,t1,cantonales
4338,51,MARNE,15626,10016,380,9636,2001,t1,cantonales
4339,51,MARNE,7924,4114,183,3931,2001,t1,cantonales
4340,51,MARNE,2628,2094,75,2019,2001,t1,cantonales
4341,51,MARNE,6974,4665,285,4380,2001,t1,cantonales
4342,51,MARNE,3751,2879,97,2782,2001,t1,cantonales
4343,51,MARNE,10207,7040,312,6728,2001,t1,cantonales
4344,51,MARNE,3078,2457,215,2242,2001,t1,cantonales
4345,51,MARNE,6726,4724,220,4504,2001,t1,cantonales
4346,51,MARNE,5141,3716,197,3519,2001,t1,cantonales
4347,51,MARNE,12773,6142,306,5836,2001,t1,cantonales
4348,51,MARNE,9875,5359,212,5147,2001,t1,cantonales
4349,51,MARNE,1830,1451,94,1357,2001,t1,cantonales
4350,51,MARNE,4981,3642,199,3443,2001,t1,cantonales
4351,51,MARNE,10625,7279,512,6767,2001,t1,cantonales
4352,51,MARNE,1941,1502,160,1342,2001,t1,cantonales
4353,51,MARNE,9117,5996,341,5655,2001,t1,cantonales
4354,51,MARNE,11039,6029,260,5769,2001,t1,cantonales
4355,51,MARNE,10383,4967,190,4777,2001,t1,cantonales
4356,51,MARNE,12442,6681,169,6512,2001,t1,cantonales
4357,51,MARNE,11997,5821,160,5661,2001,t1,cantonales
4358,52,HAUTE MARNE,2776,2277,134,2143,2001,t1,cantonales
4359,52,HAUTE MARNE,3644,2701,144,2557,2001,t1,cantonales
4360,52,HAUTE MARNE,3141,2611,94,2517,2001,t1,cantonales
4361,52,HAUTE MARNE,5176,3814,251,3563,2001,t1,cantonales
4362,52,HAUTE MARNE,1834,1479,77,1402,2001,t1,cantonales
4363,52,HAUTE MARNE,3276,2438,178,2260,2001,t1,cantonales
4364,52,HAUTE MARNE,5578,3995,181,3814,2001,t1,cantonales
4365,52,HAUTE MARNE,1353,1070,86,984,2001,t1,cantonales
4366,52,HAUTE MARNE,2293,1820,109,1711,2001,t1,cantonales
4367,52,HAUTE MARNE,3604,2841,234,2607,2001,t1,cantonales
4368,52,HAUTE MARNE,7018,5101,376,4725,2001,t1,cantonales
4369,52,HAUTE MARNE,1699,1373,64,1309,2001,t1,cantonales
4370,52,HAUTE MARNE,2251,1795,106,1689,2001,t1,cantonales
4371,52,HAUTE MARNE,2436,1963,129,1834,2001,t1,cantonales
4372,52,HAUTE MARNE,13029,7757,644,7113,2001,t1,cantonales
4373,52,HAUTE MARNE,5276,2792,160,2632,2001,t1,cantonales
4374,53,MAYENNE,11258,7693,668,7025,2001,t1,cantonales
4375,53,MAYENNE,4042,3070,271,2799,2001,t1,cantonales
4376,53,MAYENNE,3772,2864,169,2695,2001,t1,cantonales
4377,53,MAYENNE,8320,5768,278,5490,2001,t1,cantonales
4378,53,MAYENNE,3333,2611,224,2387,2001,t1,cantonales
4379,53,MAYENNE,9589,6630,379,6251,2001,t1,cantonales
4380,53,MAYENNE,4634,3378,358,3020,2001,t1,cantonales
4381,53,MAYENNE,2875,2281,118,2163,2001,t1,cantonales
4382,53,MAYENNE,2717,2158,122,2036,2001,t1,cantonales
4383,53,MAYENNE,5584,4060,277,3783,2001,t1,cantonales
4384,53,MAYENNE,3833,3025,165,2860,2001,t1,cantonales
4385,53,MAYENNE,4249,3219,228,2991,2001,t1,cantonales
4386,53,MAYENNE,6257,4643,317,4326,2001,t1,cantonales
4387,53,MAYENNE,3319,2483,130,2353,2001,t1,cantonales
4388,53,MAYENNE,5178,3918,194,3724,2001,t1,cantonales
4389,53,MAYENNE,7266,4889,279,4610,2001,t1,cantonales
4390,54,MEURTHE ET MOSELLE,7876,5749,385,5364,2001,t1,cantonales
4391,54,MEURTHE ET MOSELLE,9307,6379,327,6052,2001,t1,cantonales
4392,54,MEURTHE ET MOSELLE,11119,7060,334,6726,2001,t1,cantonales
4393,54,MEURTHE ET MOSELLE,2416,1895,98,1797,2001,t1,cantonales
4394,54,MEURTHE ET MOSELLE,2730,1884,94,1790,2001,t1,cantonales
4395,54,MEURTHE ET MOSELLE,9560,6659,284,6375,2001,t1,cantonales
4396,54,MEURTHE ET MOSELLE,4568,3680,212,3468,2001,t1,cantonales
4397,54,MEURTHE ET MOSELLE,10561,7292,444,6848,2001,t1,cantonales
4398,54,MEURTHE ET MOSELLE,8093,3741,155,3586,2001,t1,cantonales
4399,54,MEURTHE ET MOSELLE,15203,9721,486,9235,2001,t1,cantonales
4400,54,MEURTHE ET MOSELLE,16042,8583,327,8256,2001,t1,cantonales
4401,54,MEURTHE ET MOSELLE,17111,11491,516,10975,2001,t1,cantonales
4402,54,MEURTHE ET MOSELLE,6731,5256,242,5014,2001,t1,cantonales
4403,54,MEURTHE ET MOSELLE,13276,7783,383,7400,2001,t1,cantonales
4404,54,MEURTHE ET MOSELLE,13076,8243,418,7825,2001,t1,cantonales
4405,54,MEURTHE ET MOSELLE,19494,11922,525,11397,2001,t1,cantonales
4406,54,MEURTHE ET MOSELLE,12238,7068,284,6784,2001,t1,cantonales
4407,54,MEURTHE ET MOSELLE,7237,3877,126,3751,2001,t1,cantonales
4408,54,MEURTHE ET MOSELLE,19835,10653,392,10261,2001,t1,cantonales
4409,54,MEURTHE ET MOSELLE,13998,9062,449,8613,2001,t1,cantonales
4410,54,MEURTHE ET MOSELLE,15322,9540,507,9033,2001,t1,cantonales
4411,54,MEURTHE ET MOSELLE,7969,4386,141,4245,2001,t1,cantonales
4412,55,MEUSE,3268,2497,148,2349,2001,t1,cantonales
4413,55,MEUSE,9084,6307,562,5745,2001,t1,cantonales
4414,55,MEUSE,2053,1757,51,1706,2001,t1,cantonales
4415,55,MEUSE,5089,3970,158,3812,2001,t1,cantonales
4416,55,MEUSE,3690,2983,159,2824,2001,t1,cantonales
4417,55,MEUSE,8301,5828,410,5418,2001,t1,cantonales
4418,55,MEUSE,2262,1821,81,1740,2001,t1,cantonales
4419,55,MEUSE,4437,3431,202,3229,2001,t1,cantonales
4420,55,MEUSE,5752,4225,279,3946,2001,t1,cantonales
4421,55,MEUSE,2770,2258,82,2176,2001,t1,cantonales
4422,55,MEUSE,4466,3286,195,3091,2001,t1,cantonales
4423,55,MEUSE,5735,3478,194,3284,2001,t1,cantonales
4424,55,MEUSE,2711,2282,106,2176,2001,t1,cantonales
4425,55,MEUSE,4043,3193,115,3078,2001,t1,cantonales
4426,55,MEUSE,7050,4632,261,4371,2001,t1,cantonales
4427,55,MEUSE,4498,2733,196,2537,2001,t1,cantonales
4428,56,MORBIHAN,11168,7982,255,7727,2001,t1,cantonales
4429,56,MORBIHAN,21715,14436,578,13858,2001,t1,cantonales
4430,56,MORBIHAN,9955,7975,213,7762,2001,t1,cantonales
4431,56,MORBIHAN,10161,7205,212,6993,2001,t1,cantonales
4432,56,MORBIHAN,6980,5948,244,5704,2001,t1,cantonales
4433,56,MORBIHAN,11291,8095,233,7862,2001,t1,cantonales
4434,56,MORBIHAN,8117,6613,245,6368,2001,t1,cantonales
4435,56,MORBIHAN,7657,5849,218,5631,2001,t1,cantonales
4436,56,MORBIHAN,11473,8536,331,8205,2001,t1,cantonales
4437,56,MORBIHAN,2561,1930,68,1862,2001,t1,cantonales
4438,56,MORBIHAN,6626,5336,147,5189,2001,t1,cantonales
4439,56,MORBIHAN,20380,13624,535,13089,2001,t1,cantonales
4440,56,MORBIHAN,8518,6716,335,6381,2001,t1,cantonales
4441,56,MORBIHAN,10467,4918,180,4738,2001,t1,cantonales
4442,56,MORBIHAN,11705,8871,556,8315,2001,t1,cantonales
4443,56,MORBIHAN,4490,3702,103,3599,2001,t1,cantonales
4444,56,MORBIHAN,3900,2767,68,2699,2001,t1,cantonales
4445,56,MORBIHAN,9535,7350,267,7083,2001,t1,cantonales
4446,56,MORBIHAN,24804,16251,613,15638,2001,t1,cantonales
4447,56,MORBIHAN,25261,17190,553,16637,2001,t1,cantonales
4448,56,MORBIHAN,15287,7284,368,6916,2001,t1,cantonales
4449,57,MOSELLE,4869,3990,168,3822,2001,t1,cantonales
4450,57,MOSELLE,22250,15827,800,15027,2001,t1,cantonales
4451,57,MOSELLE,4994,3758,89,3669,2001,t1,cantonales
4452,57,MOSELLE,16446,11137,642,10495,2001,t1,cantonales
4453,57,MOSELLE,5788,4806,248,4558,2001,t1,cantonales
4454,57,MOSELLE,10278,8340,384,7956,2001,t1,cantonales
4455,57,MOSELLE,14204,7392,405,6987,2001,t1,cantonales
4456,57,MOSELLE,25536,11046,381,10665,2001,t1,cantonales
4457,57,MOSELLE,22541,15761,767,14994,2001,t1,cantonales
4458,57,MOSELLE,14075,9014,465,8549,2001,t1,cantonales
4459,57,MOSELLE,13118,9450,464,8986,2001,t1,cantonales
4460,57,MOSELLE,12540,9384,530,8854,2001,t1,cantonales
4461,57,MOSELLE,3219,2575,146,2429,2001,t1,cantonales
4462,57,MOSELLE,12422,9976,507,9469,2001,t1,cantonales
4463,57,MOSELLE,19428,10837,514,10323,2001,t1,cantonales
4464,57,MOSELLE,11044,8434,418,8016,2001,t1,cantonales
4465,57,MOSELLE,7937,5935,342,5593,2001,t1,cantonales
4466,57,MOSELLE,14210,7370,319,7051,2001,t1,cantonales
4467,57,MOSELLE,21392,14406,846,13560,2001,t1,cantonales
4468,57,MOSELLE,10668,7866,357,7509,2001,t1,cantonales
4469,57,MOSELLE,4649,3883,173,3710,2001,t1,cantonales
4470,57,MOSELLE,11065,6001,241,5760,2001,t1,cantonales
4471,57,MOSELLE,16718,6904,415,6489,2001,t1,cantonales
4472,57,MOSELLE,18529,12159,810,11349,2001,t1,cantonales
4473,57,MOSELLE,13428,6365,373,5992,2001,t1,cantonales
4474,58,NIEVRE,2317,1897,95,1802,2001,t1,cantonales
4475,58,NIEVRE,5315,4049,262,3787,2001,t1,cantonales
4476,58,NIEVRE,3477,2721,115,2606,2001,t1,cantonales
4477,58,NIEVRE,6465,4257,250,4007,2001,t1,cantonales
4478,58,NIEVRE,6859,4322,226,4096,2001,t1,cantonales
4479,58,NIEVRE,3380,2583,92,2491,2001,t1,cantonales
4480,58,NIEVRE,3429,2465,181,2284,2001,t1,cantonales
4481,58,NIEVRE,3831,2919,425,2494,2001,t1,cantonales
4482,58,NIEVRE,6953,3650,173,3477,2001,t1,cantonales
4483,58,NIEVRE,8648,5606,302,5304,2001,t1,cantonales
4484,58,NIEVRE,4671,3568,140,3428,2001,t1,cantonales
4485,58,NIEVRE,2928,2097,153,1944,2001,t1,cantonales
4486,58,NIEVRE,4047,3063,150,2913,2001,t1,cantonales
4487,58,NIEVRE,4722,3408,119,3289,2001,t1,cantonales
4488,58,NIEVRE,12117,7931,557,7374,2001,t1,cantonales
4489,58,NIEVRE,6108,3746,221,3525,2001,t1,cantonales
4490,59,NORD,10416,7639,362,7277,2001,t1,cantonales
4491,59,NORD,11617,7872,553,7319,2001,t1,cantonales
4492,59,NORD,18538,12478,643,11835,2001,t1,cantonales
4493,59,NORD,13744,9659,398,9261,2001,t1,cantonales
4494,59,NORD,16768,11267,660,10607,2001,t1,cantonales
4495,59,NORD,13693,10581,439,10142,2001,t1,cantonales
4496,59,NORD,27945,18731,821,17910,2001,t1,cantonales
4497,59,NORD,21911,16056,874,15182,2001,t1,cantonales
4498,59,NORD,30846,19018,1094,17924,2001,t1,cantonales
4499,59,NORD,29952,17868,1018,16850,2001,t1,cantonales
4500,59,NORD,22706,14683,696,13987,2001,t1,cantonales
4501,59,NORD,34725,20874,1288,19586,2001,t1,cantonales
4502,59,NORD,32171,19189,952,18237,2001,t1,cantonales
4503,59,NORD,11636,8495,521,7974,2001,t1,cantonales
4504,59,NORD,10029,7678,306,7372,2001,t1,cantonales
4505,59,NORD,10879,4841,167,4674,2001,t1,cantonales
4506,59,NORD,18238,9123,319,8804,2001,t1,cantonales
4507,59,NORD,43949,24172,1160,23012,2001,t1,cantonales
4508,59,NORD,20734,8110,418,7692,2001,t1,cantonales
4509,59,NORD,29070,19865,868,18997,2001,t1,cantonales
4510,59,NORD,11100,8970,475,8495,2001,t1,cantonales
4511,59,NORD,29209,17398,808,16590,2001,t1,cantonales
4512,59,NORD,17672,12888,685,12203,2001,t1,cantonales
4513,59,NORD,16554,12179,569,11610,2001,t1,cantonales
4514,59,NORD,9235,7281,407,6874,2001,t1,cantonales
4515,59,NORD,25174,15586,713,14873,2001,t1,cantonales
4516,59,NORD,28346,12975,679,12296,2001,t1,cantonales
4517,59,NORD,33622,17265,799,16466,2001,t1,cantonales
4518,59,NORD,13811,9243,634,8609,2001,t1,cantonales
4519,59,NORD,27509,18358,1203,17155,2001,t1,cantonales
4520,59,NORD,10136,8111,430,7681,2001,t1,cantonales
4521,59,NORD,32148,16711,672,16039,2001,t1,cantonales
4522,59,NORD,19429,12232,607,11625,2001,t1,cantonales
4523,59,NORD,31311,20789,1249,19540,2001,t1,cantonales
4524,59,NORD,13080,8859,240,8619,2001,t1,cantonales
4525,59,NORD,32245,18158,590,17568,2001,t1,cantonales
4526,59,NORD,28294,16882,684,16198,2001,t1,cantonales
4527,59,NORD,28058,16662,972,15690,2001,t1,cantonales
4528,59,NORD,17922,9803,308,9495,2001,t1,cantonales
4529,60,OISE,10930,7794,377,7417,2001,t1,cantonales
4530,60,OISE,10408,7617,473,7144,2001,t1,cantonales
4531,60,OISE,7304,4978,259,4719,2001,t1,cantonales
4532,60,OISE,7813,6137,359,5778,2001,t1,cantonales
4533,60,OISE,18879,12294,860,11434,2001,t1,cantonales
4534,60,OISE,17894,11264,385,10879,2001,t1,cantonales
4535,60,OISE,10242,7344,579,6765,2001,t1,cantonales
4536,60,OISE,10661,7442,378,7064,2001,t1,cantonales
4537,60,OISE,6751,5449,324,5125,2001,t1,cantonales
4538,60,OISE,23707,15754,1026,14728,2001,t1,cantonales
4539,60,OISE,5845,4689,253,4436,2001,t1,cantonales
4540,60,OISE,18067,11872,544,11328,2001,t1,cantonales
4541,60,OISE,11098,7728,381,7347,2001,t1,cantonales
4542,60,OISE,18461,11709,777,10932,2001,t1,cantonales
4543,60,OISE,11235,8276,543,7733,2001,t1,cantonales
4544,60,OISE,7735,5862,244,5618,2001,t1,cantonales
4545,60,OISE,9991,6268,307,5961,2001,t1,cantonales
4546,60,OISE,10621,5419,208,5211,2001,t1,cantonales
4547,60,OISE,15863,9839,478,9361,2001,t1,cantonales
4548,60,OISE,12370,8013,345,7668,2001,t1,cantonales
4549,60,OISE,13094,7981,396,7585,2001,t1,cantonales
4550,61,ORNE,7756,4525,174,4351,2001,t1,cantonales
4551,61,ORNE,14322,9662,441,9221,2001,t1,cantonales
4552,61,ORNE,6295,3915,220,3695,2001,t1,cantonales
4553,61,ORNE,6120,4442,223,4219,2001,t1,cantonales
4554,61,ORNE,2636,2103,94,2009,2001,t1,cantonales
4555,61,ORNE,2144,1702,91,1611,2001,t1,cantonales
4556,61,ORNE,4620,3590,172,3418,2001,t1,cantonales
4557,61,ORNE,3134,2280,53,2227,2001,t1,cantonales
4558,61,ORNE,7742,5961,277,5684,2001,t1,cantonales
4559,61,ORNE,3214,2406,130,2276,2001,t1,cantonales
4560,61,ORNE,5986,3984,147,3837,2001,t1,cantonales
4561,61,ORNE,3547,2739,167,2572,2001,t1,cantonales
4562,61,ORNE,5809,4264,205,4059,2001,t1,cantonales
4563,61,ORNE,6911,4742,270,4472,2001,t1,cantonales
4564,61,ORNE,3400,2516,119,2397,2001,t1,cantonales
4565,61,ORNE,3762,2995,183,2812,2001,t1,cantonales
4566,61,ORNE,5439,3981,386,3595,2001,t1,cantonales
4567,61,ORNE,5313,4225,140,4085,2001,t1,cantonales
4568,61,ORNE,3363,2609,528,2081,2001,t1,cantonales
4569,61,ORNE,4485,3376,326,3050,2001,t1,cantonales
4570,62,PAS DE CALAIS,17952,13906,813,13093,2001,t1,cantonales
4571,62,PAS DE CALAIS,9059,7718,520,7198,2001,t1,cantonales
4572,62,PAS DE CALAIS,8850,7221,476,6745,2001,t1,cantonales
4573,62,PAS DE CALAIS,6309,5005,286,4719,2001,t1,cantonales
4574,62,PAS DE CALAIS,5065,4175,150,4025,2001,t1,cantonales
4575,62,PAS DE CALAIS,16957,10293,512,9781,2001,t1,cantonales
4576,62,PAS DE CALAIS,12370,6593,575,6018,2001,t1,cantonales
4577,62,PAS DE CALAIS,8222,7023,386,6637,2001,t1,cantonales
4578,62,PAS DE CALAIS,5466,4933,171,4762,2001,t1,cantonales
4579,62,PAS DE CALAIS,10559,8382,549,7833,2001,t1,cantonales
4580,62,PAS DE CALAIS,8895,6997,405,6592,2001,t1,cantonales
4581,62,PAS DE CALAIS,8112,6963,401,6562,2001,t1,cantonales
4582,62,PAS DE CALAIS,5375,4899,202,4697,2001,t1,cantonales
4583,62,PAS DE CALAIS,12730,9571,486,9085,2001,t1,cantonales
4584,62,PAS DE CALAIS,14944,8238,480,7758,2001,t1,cantonales
4585,62,PAS DE CALAIS,14876,8631,526,8105,2001,t1,cantonales
4586,62,PAS DE CALAIS,16494,14198,790,13408,2001,t1,cantonales
4587,62,PAS DE CALAIS,8495,6854,320,6534,2001,t1,cantonales
4588,62,PAS DE CALAIS,15140,11872,862,11010,2001,t1,cantonales
4589,62,PAS DE CALAIS,18395,13182,895,12287,2001,t1,cantonales
4590,62,PAS DE CALAIS,15596,11476,1057,10419,2001,t1,cantonales
4591,62,PAS DE CALAIS,5693,4991,269,4722,2001,t1,cantonales
4592,62,PAS DE CALAIS,11846,8354,408,7946,2001,t1,cantonales
4593,62,PAS DE CALAIS,16303,10346,685,9661,2001,t1,cantonales
4594,62,PAS DE CALAIS,20319,14564,784,13780,2001,t1,cantonales
4595,62,PAS DE CALAIS,12965,7243,661,6582,2001,t1,cantonales
4596,62,PAS DE CALAIS,15099,9880,340,9540,2001,t1,cantonales
4597,62,PAS DE CALAIS,13160,8047,492,7555,2001,t1,cantonales
4598,62,PAS DE CALAIS,14485,8575,812,7763,2001,t1,cantonales
4599,62,PAS DE CALAIS,12372,7843,539,7304,2001,t1,cantonales
4600,62,PAS DE CALAIS,15598,10671,476,10195,2001,t1,cantonales
4601,62,PAS DE CALAIS,18383,11713,595,11118,2001,t1,cantonales
4602,62,PAS DE CALAIS,14460,9097,455,8642,2001,t1,cantonales
4603,62,PAS DE CALAIS,12598,7520,511,7009,2001,t1,cantonales
4604,62,PAS DE CALAIS,16189,11859,778,11081,2001,t1,cantonales
4605,62,PAS DE CALAIS,15475,10411,724,9687,2001,t1,cantonales
4606,62,PAS DE CALAIS,14579,8929,751,8178,2001,t1,cantonales
4607,62,PAS DE CALAIS,15091,10064,435,9629,2001,t1,cantonales
4608,62,PAS DE CALAIS,14599,10658,789,9869,2001,t1,cantonales
4609,63,PUY DE DOME,5762,4714,245,4469,2001,t1,cantonales
4610,63,PUY DE DOME,2096,1804,93,1711,2001,t1,cantonales
4611,63,PUY DE DOME,3279,2665,75,2590,2001,t1,cantonales
4612,63,PUY DE DOME,4219,3557,128,3429,2001,t1,cantonales
4613,63,PUY DE DOME,4461,3455,284,3171,2001,t1,cantonales
4614,63,PUY DE DOME,6963,3713,222,3491,2001,t1,cantonales
4615,63,PUY DE DOME,9389,4779,235,4544,2001,t1,cantonales
4616,63,PUY DE DOME,5405,2823,163,2660,2001,t1,cantonales
4617,63,PUY DE DOME,6192,4864,171,4693,2001,t1,cantonales
4618,63,PUY DE DOME,6537,5134,290,4844,2001,t1,cantonales
4619,63,PUY DE DOME,1229,1089,33,1056,2001,t1,cantonales
4620,63,PUY DE DOME,5885,4360,174,4186,2001,t1,cantonales
4621,63,PUY DE DOME,3615,2835,175,2660,2001,t1,cantonales
4622,63,PUY DE DOME,3392,2769,149,2620,2001,t1,cantonales
4623,63,PUY DE DOME,2727,2173,82,2091,2001,t1,cantonales
4624,63,PUY DE DOME,4605,3780,313,3467,2001,t1,cantonales
4625,63,PUY DE DOME,5219,4307,247,4060,2001,t1,cantonales
4626,63,PUY DE DOME,16260,11345,579,10766,2001,t1,cantonales
4627,63,PUY DE DOME,8848,7272,322,6950,2001,t1,cantonales
4628,63,PUY DE DOME,5931,4553,215,4338,2001,t1,cantonales
4629,63,PUY DE DOME,1736,1389,58,1331,2001,t1,cantonales
4630,63,PUY DE DOME,2738,2320,84,2236,2001,t1,cantonales
4631,63,PUY DE DOME,5109,3921,220,3701,2001,t1,cantonales
4632,63,PUY DE DOME,2629,2314,87,2227,2001,t1,cantonales
4633,63,PUY DE DOME,7056,5359,333,5026,2001,t1,cantonales
4634,63,PUY DE DOME,1979,1642,42,1600,2001,t1,cantonales
4635,63,PUY DE DOME,7178,3668,194,3474,2001,t1,cantonales
4636,63,PUY DE DOME,13725,8668,503,8165,2001,t1,cantonales
4637,63,PUY DE DOME,19273,12117,673,11444,2001,t1,cantonales
4638,63,PUY DE DOME,5627,2917,167,2750,2001,t1,cantonales
4639,63,PUY DE DOME,9039,6208,359,5849,2001,t1,cantonales
4640,64,PYRENEES ATLANTIQUES,2748,2446,70,2376,2001,t1,cantonales
4641,64,PYRENEES ATLANTIQUES,5752,4800,192,4608,2001,t1,cantonales
4642,64,PYRENEES ATLANTIQUES,12273,6659,375,6284,2001,t1,cantonales
4643,64,PYRENEES ATLANTIQUES,3497,2904,135,2769,2001,t1,cantonales
4644,64,PYRENEES ATLANTIQUES,9760,7540,304,7236,2001,t1,cantonales
4645,64,PYRENEES ATLANTIQUES,2854,2445,71,2374,2001,t1,cantonales
4646,64,PYRENEES ATLANTIQUES,8530,7204,236,6968,2001,t1,cantonales
4647,64,PYRENEES ATLANTIQUES,2062,1770,91,1679,2001,t1,cantonales
4648,64,PYRENEES ATLANTIQUES,13828,10701,577,10124,2001,t1,cantonales
4649,64,PYRENEES ATLANTIQUES,5854,4840,184,4656,2001,t1,cantonales
4650,64,PYRENEES ATLANTIQUES,8507,7022,184,6838,2001,t1,cantonales
4651,64,PYRENEES ATLANTIQUES,12666,9881,516,9365,2001,t1,cantonales
4652,64,PYRENEES ATLANTIQUES,15764,10324,511,9813,2001,t1,cantonales
4653,64,PYRENEES ATLANTIQUES,6237,5087,203,4884,2001,t1,cantonales
4654,64,PYRENEES ATLANTIQUES,4961,4172,94,4078,2001,t1,cantonales
4655,64,PYRENEES ATLANTIQUES,17309,12027,671,11356,2001,t1,cantonales
4656,64,PYRENEES ATLANTIQUES,7145,6162,221,5941,2001,t1,cantonales
4657,64,PYRENEES ATLANTIQUES,6722,5449,278,5171,2001,t1,cantonales
4658,64,PYRENEES ATLANTIQUES,3210,2696,113,2583,2001,t1,cantonales
4659,64,PYRENEES ATLANTIQUES,4151,3519,146,3373,2001,t1,cantonales
4660,64,PYRENEES ATLANTIQUES,14582,11072,575,10497,2001,t1,cantonales
4661,64,PYRENEES ATLANTIQUES,19149,13314,465,12849,2001,t1,cantonales
4662,64,PYRENEES ATLANTIQUES,12367,8352,298,8054,2001,t1,cantonales
4663,64,PYRENEES ATLANTIQUES,14776,8535,317,8218,2001,t1,cantonales
4664,64,PYRENEES ATLANTIQUES,8481,4963,192,4771,2001,t1,cantonales
4665,64,PYRENEES ATLANTIQUES,10211,7703,335,7368,2001,t1,cantonales
4666,65,HAUTES PYRENEES,8411,6635,240,6395,2001,t1,cantonales
4667,65,HAUTES PYRENEES,10320,7568,360,7208,2001,t1,cantonales
4668,65,HAUTES PYRENEES,3721,2855,197,2658,2001,t1,cantonales
4669,65,HAUTES PYRENEES,3201,2625,77,2548,2001,t1,cantonales
4670,65,HAUTES PYRENEES,3085,2583,117,2466,2001,t1,cantonales
4671,65,HAUTES PYRENEES,1596,1381,23,1358,2001,t1,cantonales
4672,65,HAUTES PYRENEES,1958,1677,94,1583,2001,t1,cantonales
4673,65,HAUTES PYRENEES,8043,6166,267,5899,2001,t1,cantonales
4674,65,HAUTES PYRENEES,7935,5864,313,5551,2001,t1,cantonales
4675,65,HAUTES PYRENEES,2936,2373,85,2288,2001,t1,cantonales
4676,65,HAUTES PYRENEES,3711,3120,144,2976,2001,t1,cantonales
4677,65,HAUTES PYRENEES,8655,5716,465,5251,2001,t1,cantonales
4678,65,HAUTES PYRENEES,4625,3737,244,3493,2001,t1,cantonales
4679,65,HAUTES PYRENEES,9064,6524,310,6214,2001,t1,cantonales
4680,65,HAUTES PYRENEES,5355,3189,132,3057,2001,t1,cantonales
4681,65,HAUTES PYRENEES,4868,2768,113,2655,2001,t1,cantonales
4682,65,HAUTES PYRENEES,7903,5481,272,5209,2001,t1,cantonales
4683,66,PYRENEES ORIENTALES,5695,4336,152,4184,2001,t1,cantonales
4684,66,PYRENEES ORIENTALES,15081,11206,633,10573,2001,t1,cantonales
4685,66,PYRENEES ORIENTALES,3858,3275,209,3066,2001,t1,cantonales
4686,66,PYRENEES ORIENTALES,13030,10231,540,9691,2001,t1,cantonales
4687,66,PYRENEES ORIENTALES,1664,1443,51,1392,2001,t1,cantonales
4688,66,PYRENEES ORIENTALES,7841,6309,254,6055,2001,t1,cantonales
4689,66,PYRENEES ORIENTALES,7542,5907,207,5700,2001,t1,cantonales
4690,66,PYRENEES ORIENTALES,9315,5630,320,5310,2001,t1,cantonales
4691,66,PYRENEES ORIENTALES,6566,3937,184,3753,2001,t1,cantonales
4692,66,PYRENEES ORIENTALES,4778,2434,144,2290,2001,t1,cantonales
4693,66,PYRENEES ORIENTALES,7415,4092,171,3921,2001,t1,cantonales
4694,66,PYRENEES ORIENTALES,12057,8930,392,8538,2001,t1,cantonales
4695,66,PYRENEES ORIENTALES,13119,9750,478,9272,2001,t1,cantonales
4696,66,PYRENEES ORIENTALES,9944,7193,324,6869,2001,t1,cantonales
4697,66,PYRENEES ORIENTALES,12007,8826,422,8404,2001,t1,cantonales
4698,67,BAS RHIN,12489,9135,441,8694,2001,t1,cantonales
4699,67,BAS RHIN,13674,9747,472,9275,2001,t1,cantonales
4700,67,BAS RHIN,29571,20087,1132,18955,2001,t1,cantonales
4701,67,BAS RHIN,14070,9992,458,9534,2001,t1,cantonales
4702,67,BAS RHIN,33854,22425,1251,21174,2001,t1,cantonales
4703,67,BAS RHIN,8505,6669,345,6324,2001,t1,cantonales
4704,67,BAS RHIN,16216,11310,536,10774,2001,t1,cantonales
4705,67,BAS RHIN,32384,20736,1197,19539,2001,t1,cantonales
4706,67,BAS RHIN,11619,9285,453,8832,2001,t1,cantonales
4707,67,BAS RHIN,3144,2586,85,2501,2001,t1,cantonales
4708,67,BAS RHIN,14817,11230,729,10501,2001,t1,cantonales
4709,67,BAS RHIN,26218,18385,1044,17341,2001,t1,cantonales
4710,67,BAS RHIN,8124,6216,283,5933,2001,t1,cantonales
4711,67,BAS RHIN,11943,8571,537,8034,2001,t1,cantonales
4712,67,BAS RHIN,8020,6534,237,6297,2001,t1,cantonales
4713,67,BAS RHIN,13635,9802,513,9289,2001,t1,cantonales
4714,67,BAS RHIN,13998,7211,170,7041,2001,t1,cantonales
4715,67,BAS RHIN,11244,6025,160,5865,2001,t1,cantonales
4716,67,BAS RHIN,11542,6478,134,6344,2001,t1,cantonales
4717,67,BAS RHIN,12190,6677,125,6552,2001,t1,cantonales
4718,67,BAS RHIN,13091,6517,212,6305,2001,t1,cantonales
4719,67,BAS RHIN,15088,8179,257,7922,2001,t1,cantonales
4720,68,HAUT RHIN,24032,15467,634,14833,2001,t1,cantonales
4721,68,HAUT RHIN,15091,7544,407,7137,2001,t1,cantonales
4722,68,HAUT RHIN,9637,7736,268,7468,2001,t1,cantonales
4723,68,HAUT RHIN,10578,8298,439,7859,2001,t1,cantonales
4724,68,HAUT RHIN,6981,5180,203,4977,2001,t1,cantonales
4725,68,HAUT RHIN,14765,7129,422,6707,2001,t1,cantonales
4726,68,HAUT RHIN,24245,14353,630,13723,2001,t1,cantonales
4727,68,HAUT RHIN,9471,7200,284,6916,2001,t1,cantonales
4728,68,HAUT RHIN,9613,6912,298,6614,2001,t1,cantonales
4729,68,HAUT RHIN,8358,6384,196,6188,2001,t1,cantonales
4730,68,HAUT RHIN,15247,10183,682,9501,2001,t1,cantonales
4731,68,HAUT RHIN,13843,9451,386,9065,2001,t1,cantonales
4732,68,HAUT RHIN,32384,18611,717,17894,2001,t1,cantonales
4733,68,HAUT RHIN,26444,14606,731,13875,2001,t1,cantonales
4734,68,HAUT RHIN,15339,7453,279,7174,2001,t1,cantonales
4735,68,HAUT RHIN,11833,5872,204,5668,2001,t1,cantonales
4736,68,HAUT RHIN,22748,14256,770,13486,2001,t1,cantonales
4737,69,RHONE,5692,4124,131,3993,2001,t1,cantonales
4738,69,RHONE,13388,8007,309,7698,2001,t1,cantonales
4739,69,RHONE,10202,6891,223,6668,2001,t1,cantonales
4740,69,RHONE,18956,10975,355,10620,2001,t1,cantonales
4741,69,RHONE,14441,9164,229,8935,2001,t1,cantonales
4742,69,RHONE,12810,7601,294,7307,2001,t1,cantonales
4743,69,RHONE,20621,11521,380,11141,2001,t1,cantonales
4744,69,RHONE,15419,9574,320,9254,2001,t1,cantonales
4745,69,RHONE,11307,6945,232,6713,2001,t1,cantonales
4746,69,RHONE,3343,2444,159,2285,2001,t1,cantonales
4747,69,RHONE,14158,9887,351,9536,2001,t1,cantonales
4748,69,RHONE,24371,14514,704,13810,2001,t1,cantonales
4749,69,RHONE,25961,14353,403,13950,2001,t1,cantonales
4750,69,RHONE,9779,6898,451,6447,2001,t1,cantonales
4751,69,RHONE,14239,9122,540,8582,2001,t1,cantonales
4752,69,RHONE,14399,7907,299,7608,2001,t1,cantonales
4753,69,RHONE,19692,10483,335,10148,2001,t1,cantonales
4754,69,RHONE,11700,6554,248,6306,2001,t1,cantonales
4755,69,RHONE,25523,16178,588,15590,2001,t1,cantonales
4756,69,RHONE,14701,7650,304,7346,2001,t1,cantonales
4757,69,RHONE,11410,5115,240,4875,2001,t1,cantonales
4758,69,RHONE,26258,14277,263,14014,2001,t1,cantonales
4759,69,RHONE,27547,14844,465,14379,2001,t1,cantonales
4760,69,RHONE,17860,10137,276,9861,2001,t1,cantonales
4761,69,RHONE,19284,10310,210,10100,2001,t1,cantonales
4762,69,RHONE,20506,11199,315,10884,2001,t1,cantonales
4763,69,RHONE,15655,9953,373,9580,2001,t1,cantonales
4764,69,RHONE,12458,7325,289,7036,2001,t1,cantonales
4765,69,RHONE,15258,8334,346,7988,2001,t1,cantonales
4766,70,HAUTE SAONE,9503,6355,327,6028,2001,t1,cantonales
4767,70,HAUTE SAONE,3601,2961,122,2839,2001,t1,cantonales
4768,70,HAUTE SAONE,6943,4911,302,4609,2001,t1,cantonales
4769,70,HAUTE SAONE,4111,3321,162,3159,2001,t1,cantonales
4770,70,HAUTE SAONE,5547,4284,287,3997,2001,t1,cantonales
4771,70,HAUTE SAONE,3310,2709,103,2606,2001,t1,cantonales
4772,70,HAUTE SAONE,5247,4110,249,3861,2001,t1,cantonales
4773,70,HAUTE SAONE,5563,4556,245,4311,2001,t1,cantonales
4774,70,HAUTE SAONE,10893,7659,543,7116,2001,t1,cantonales
4775,70,HAUTE SAONE,2707,2247,147,2100,2001,t1,cantonales
4776,70,HAUTE SAONE,5057,4016,219,3797,2001,t1,cantonales
4777,70,HAUTE SAONE,3329,2700,157,2543,2001,t1,cantonales
4778,70,HAUTE SAONE,10039,7015,345,6670,2001,t1,cantonales
4779,70,HAUTE SAONE,5795,4869,241,4628,2001,t1,cantonales
4780,70,HAUTE SAONE,2079,1760,96,1664,2001,t1,cantonales
4781,70,HAUTE SAONE,7407,5492,508,4984,2001,t1,cantonales
4782,71,SAONE ET LOIRE ,7029,5324,334,4990,2001,t1,cantonales
4783,71,SAONE ET LOIRE ,6377,4711,255,4456,2001,t1,cantonales
4784,71,SAONE ET LOIRE ,10759,7570,454,7116,2001,t1,cantonales
4785,71,SAONE ET LOIRE ,12893,7146,319,6827,2001,t1,cantonales
4786,71,SAONE ET LOIRE ,7508,4956,254,4702,2001,t1,cantonales
4787,71,SAONE ET LOIRE ,5099,3522,259,3263,2001,t1,cantonales
4788,71,SAONE ET LOIRE ,6292,4505,376,4129,2001,t1,cantonales
4789,71,SAONE ET LOIRE ,4544,3447,146,3301,2001,t1,cantonales
4790,71,SAONE ET LOIRE ,12606,7501,574,6927,2001,t1,cantonales
4791,71,SAONE ET LOIRE ,9556,6902,353,6549,2001,t1,cantonales
4792,71,SAONE ET LOIRE ,10326,7539,420,7119,2001,t1,cantonales
4793,71,SAONE ET LOIRE ,16995,10931,703,10228,2001,t1,cantonales
4794,71,SAONE ET LOIRE ,12351,7781,443,7338,2001,t1,cantonales
4795,71,SAONE ET LOIRE ,6777,4640,233,4407,2001,t1,cantonales
4796,71,SAONE ET LOIRE ,2283,1607,60,1547,2001,t1,cantonales
4797,71,SAONE ET LOIRE ,2841,2188,112,2076,2001,t1,cantonales
4798,71,SAONE ET LOIRE ,3156,2398,106,2292,2001,t1,cantonales
4799,71,SAONE ET LOIRE ,5008,3840,265,3575,2001,t1,cantonales
4800,71,SAONE ET LOIRE ,2187,1753,49,1704,2001,t1,cantonales
4801,71,SAONE ET LOIRE ,3314,2642,97,2545,2001,t1,cantonales
4802,71,SAONE ET LOIRE ,3430,2546,174,2372,2001,t1,cantonales
4803,71,SAONE ET LOIRE ,9677,6569,296,6273,2001,t1,cantonales
4804,71,SAONE ET LOIRE ,8528,5525,269,5256,2001,t1,cantonales
4805,71,SAONE ET LOIRE ,2736,2091,57,2034,2001,t1,cantonales
4806,71,SAONE ET LOIRE ,7107,5376,236,5140,2001,t1,cantonales
4807,71,SAONE ET LOIRE ,6729,4895,270,4625,2001,t1,cantonales
4808,71,SAONE ET LOIRE ,9364,4706,353,4353,2001,t1,cantonales
4809,71,SAONE ET LOIRE ,9279,5394,226,5168,2001,t1,cantonales
4810,71,SAONE ET LOIRE ,13858,7935,320,7615,2001,t1,cantonales
4811,72,SARTHE,8886,6667,523,6144,2001,t1,cantonales
4812,72,SARTHE,4702,3513,142,3371,2001,t1,cantonales
4813,72,SARTHE,5115,3679,209,3470,2001,t1,cantonales
4814,72,SARTHE,4308,3310,252,3058,2001,t1,cantonales
4815,72,SARTHE,8603,5905,300,5605,2001,t1,cantonales
4816,72,SARTHE,17995,12185,752,11433,2001,t1,cantonales
4817,72,SARTHE,11924,7710,362,7348,2001,t1,cantonales
4818,72,SARTHE,2748,2183,169,2014,2001,t1,cantonales
4819,72,SARTHE,6352,4494,226,4268,2001,t1,cantonales
4820,72,SARTHE,14636,9612,541,9071,2001,t1,cantonales
4821,72,SARTHE,5560,4265,281,3984,2001,t1,cantonales
4822,72,SARTHE,11814,6180,328,5852,2001,t1,cantonales
4823,72,SARTHE,14654,8858,256,8602,2001,t1,cantonales
4824,72,SARTHE,6607,4695,246,4449,2001,t1,cantonales
4825,72,SARTHE,3136,2302,118,2184,2001,t1,cantonales
4826,72,SARTHE,7726,5322,244,5078,2001,t1,cantonales
4827,72,SARTHE,5615,4046,320,3726,2001,t1,cantonales
4828,72,SARTHE,14823,10360,612,9748,2001,t1,cantonales
4829,72,SARTHE,4442,3320,143,3177,2001,t1,cantonales
4830,72,SARTHE,11602,6597,427,6170,2001,t1,cantonales
4831,72,SARTHE,11377,6653,320,6333,2001,t1,cantonales
4832,73,SAVOIE,3878,3055,83,2972,2001,t1,cantonales
4833,73,SAVOIE,7201,5333,164,5169,2001,t1,cantonales
4834,73,SAVOIE,4907,3427,167,3260,2001,t1,cantonales
4835,73,SAVOIE,3445,2791,110,2681,2001,t1,cantonales
4836,73,SAVOIE,6852,3796,138,3658,2001,t1,cantonales
4837,73,SAVOIE,3643,2694,117,2577,2001,t1,cantonales
4838,73,SAVOIE,4362,3196,126,3070,2001,t1,cantonales
4839,73,SAVOIE,9171,6772,292,6480,2001,t1,cantonales
4840,73,SAVOIE,9843,6603,244,6359,2001,t1,cantonales
4841,73,SAVOIE,11309,7838,291,7547,2001,t1,cantonales
4842,73,SAVOIE,5082,3837,162,3675,2001,t1,cantonales
4843,73,SAVOIE,3271,2566,79,2487,2001,t1,cantonales
4844,73,SAVOIE,3926,2924,133,2791,2001,t1,cantonales
4845,73,SAVOIE,11272,7860,301,7559,2001,t1,cantonales
4846,73,SAVOIE,4143,3212,81,3131,2001,t1,cantonales
4847,73,SAVOIE,7868,5854,170,5684,2001,t1,cantonales
4848,73,SAVOIE,10428,6569,257,6312,2001,t1,cantonales
4849,73,SAVOIE,6372,3414,143,3271,2001,t1,cantonales
4850,73,SAVOIE,8720,5350,166,5184,2001,t1,cantonales
4851,74,HAUTE SAVOIE,11259,6077,259,5818,2001,t1,cantonales
4852,74,HAUTE SAVOIE,4947,3618,114,3504,2001,t1,cantonales
4853,74,HAUTE SAVOIE,4268,3263,107,3156,2001,t1,cantonales
4854,74,HAUTE SAVOIE,18148,11343,413,10930,2001,t1,cantonales
4855,74,HAUTE SAVOIE,10132,5707,178,5529,2001,t1,cantonales
4856,74,HAUTE SAVOIE,6100,4461,126,4335,2001,t1,cantonales
4857,74,HAUTE SAVOIE,18087,12097,403,11694,2001,t1,cantonales
4858,74,HAUTE SAVOIE,14700,9883,371,9512,2001,t1,cantonales
4859,74,HAUTE SAVOIE,17109,10332,402,9930,2001,t1,cantonales
4860,74,HAUTE SAVOIE,3844,2818,102,2716,2001,t1,cantonales
4861,74,HAUTE SAVOIE,4865,3476,108,3368,2001,t1,cantonales
4862,74,HAUTE SAVOIE,9609,6982,252,6730,2001,t1,cantonales
4863,74,HAUTE SAVOIE,12667,7640,330,7310,2001,t1,cantonales
4864,74,HAUTE SAVOIE,7016,5079,184,4895,2001,t1,cantonales
4865,74,HAUTE SAVOIE,20451,10437,382,10055,2001,t1,cantonales
4866,74,HAUTE SAVOIE,5640,3977,117,3860,2001,t1,cantonales
4867,74,HAUTE SAVOIE,29114,16700,605,16095,2001,t1,cantonales
4868,76,SEINE MARITIME ,3688,2831,116,2715,2001,t1,cantonales
4869,76,SEINE MARITIME ,16845,11062,500,10562,2001,t1,cantonales
4870,76,SEINE MARITIME ,26339,16486,632,15854,2001,t1,cantonales
4871,76,SEINE MARITIME ,6799,4884,307,4577,2001,t1,cantonales
4872,76,SEINE MARITIME ,9860,7268,254,7014,2001,t1,cantonales
4873,76,SEINE MARITIME ,15378,10515,383,10132,2001,t1,cantonales
4874,76,SEINE MARITIME ,5602,4342,260,4082,2001,t1,cantonales
4875,76,SEINE MARITIME ,16477,8861,453,8408,2001,t1,cantonales
4876,76,SEINE MARITIME ,11935,9044,435,8609,2001,t1,cantonales
4877,76,SEINE MARITIME ,20035,13536,799,12737,2001,t1,cantonales
4878,76,SEINE MARITIME ,7965,5903,231,5672,2001,t1,cantonales
4879,76,SEINE MARITIME ,9452,6954,242,6712,2001,t1,cantonales
4880,76,SEINE MARITIME ,8796,6393,280,6113,2001,t1,cantonales
4881,76,SEINE MARITIME ,11207,6536,160,6376,2001,t1,cantonales
4882,76,SEINE MARITIME ,11920,5603,294,5309,2001,t1,cantonales
4883,76,SEINE MARITIME ,19208,10550,353,10197,2001,t1,cantonales
4884,76,SEINE MARITIME ,25832,15959,691,15268,2001,t1,cantonales
4885,76,SEINE MARITIME ,13906,9717,738,8979,2001,t1,cantonales
4886,76,SEINE MARITIME ,10235,5390,142,5248,2001,t1,cantonales
4887,76,SEINE MARITIME ,6590,3660,78,3582,2001,t1,cantonales
4888,76,SEINE MARITIME ,5848,3203,101,3102,2001,t1,cantonales
4889,76,SEINE MARITIME ,13560,9408,288,9120,2001,t1,cantonales
4890,76,SEINE MARITIME ,5638,4348,245,4103,2001,t1,cantonales
4891,76,SEINE MARITIME ,14411,8073,471,7602,2001,t1,cantonales
4892,76,SEINE MARITIME ,6667,5204,224,4980,2001,t1,cantonales
4893,76,SEINE MARITIME ,14674,10137,518,9619,2001,t1,cantonales
4894,76,SEINE MARITIME ,17495,10077,320,9757,2001,t1,cantonales
4895,76,SEINE MARITIME ,16213,8208,316,7892,2001,t1,cantonales
4896,76,SEINE MARITIME ,7809,3829,131,3698,2001,t1,cantonales
4897,76,SEINE MARITIME ,17582,10178,323,9855,2001,t1,cantonales
4898,76,SEINE MARITIME ,18395,10369,639,9730,2001,t1,cantonales
4899,76,SEINE MARITIME ,13329,8406,277,8129,2001,t1,cantonales
4900,76,SEINE MARITIME ,15246,9773,593,9180,2001,t1,cantonales
4901,76,SEINE MARITIME ,19315,11955,612,11343,2001,t1,cantonales
4902,76,SEINE MARITIME ,11676,6179,338,5841,2001,t1,cantonales
4903,77,SEINE ET MARNE ,8321,5711,348,5363,2001,t1,cantonales
4904,77,SEINE ET MARNE ,23319,13305,501,12804,2001,t1,cantonales
4905,77,SEINE ET MARNE ,8644,5919,212,5707,2001,t1,cantonales
4906,77,SEINE ET MARNE ,8509,5547,275,5272,2001,t1,cantonales
4907,77,SEINE ET MARNE ,24929,13605,453,13152,2001,t1,cantonales
4908,77,SEINE ET MARNE ,22218,12706,645,12061,2001,t1,cantonales
4909,77,SEINE ET MARNE ,20003,12467,397,12070,2001,t1,cantonales
4910,77,SEINE ET MARNE ,25365,15638,626,15012,2001,t1,cantonales
4911,77,SEINE ET MARNE ,6776,4831,225,4606,2001,t1,cantonales
4912,77,SEINE ET MARNE ,9220,6286,281,6005,2001,t1,cantonales
4913,77,SEINE ET MARNE ,27629,15791,535,15256,2001,t1,cantonales
4914,77,SEINE ET MARNE ,7190,5239,319,4920,2001,t1,cantonales
4915,77,SEINE ET MARNE ,19970,10484,449,10035,2001,t1,cantonales
4916,77,SEINE ET MARNE ,10106,6592,340,6252,2001,t1,cantonales
4917,77,SEINE ET MARNE ,18425,10361,369,9992,2001,t1,cantonales
4918,77,SEINE ET MARNE ,17143,11052,377,10675,2001,t1,cantonales
4919,77,SEINE ET MARNE ,29571,17966,651,17315,2001,t1,cantonales
4920,77,SEINE ET MARNE ,15441,8423,409,8014,2001,t1,cantonales
4921,77,SEINE ET MARNE ,14230,8968,325,8643,2001,t1,cantonales
4922,77,SEINE ET MARNE ,14160,6149,227,5922,2001,t1,cantonales
4923,78,YVELINES,14928,10391,431,9960,2001,t1,cantonales
4924,78,YVELINES,24232,12838,307,12531,2001,t1,cantonales
4925,78,YVELINES,31854,20055,689,19366,2001,t1,cantonales
4926,78,YVELINES,24573,14147,330,13817,2001,t1,cantonales
4927,78,YVELINES,19255,9828,298,9530,2001,t1,cantonales
4928,78,YVELINES,14124,7939,222,7717,2001,t1,cantonales
4929,78,YVELINES,24790,14409,517,13892,2001,t1,cantonales
4930,78,YVELINES,23772,14020,409,13611,2001,t1,cantonales
4931,78,YVELINES,34533,21336,1005,20331,2001,t1,cantonales
4932,78,YVELINES,22603,12316,359,11957,2001,t1,cantonales
4933,78,YVELINES,24746,13668,353,13315,2001,t1,cantonales
4934,78,YVELINES,10843,5734,189,5545,2001,t1,cantonales
4935,78,YVELINES,21166,12527,368,12159,2001,t1,cantonales
4936,78,YVELINES,20211,11209,274,10935,2001,t1,cantonales
4937,78,YVELINES,31306,19187,546,18641,2001,t1,cantonales
4938,78,YVELINES,10096,6236,116,6120,2001,t1,cantonales
4939,78,YVELINES,18780,11055,361,10694,2001,t1,cantonales
4940,78,YVELINES,33318,18102,569,17533,2001,t1,cantonales
4941,78,YVELINES,14800,7645,201,7444,2001,t1,cantonales
4942,79,DEUX SEVRES,4137,3221,209,3012,2001,t1,cantonales
4943,79,DEUX SEVRES,7764,5830,399,5431,2001,t1,cantonales
4944,79,DEUX SEVRES,3536,2642,98,2544,2001,t1,cantonales
4945,79,DEUX SEVRES,16206,11138,686,10452,2001,t1,cantonales
4946,79,DEUX SEVRES,4962,4007,130,3877,2001,t1,cantonales
4947,79,DEUX SEVRES,11683,8414,871,7543,2001,t1,cantonales
4948,79,DEUX SEVRES,4802,3800,151,3649,2001,t1,cantonales
4949,79,DEUX SEVRES,7107,4998,190,4808,2001,t1,cantonales
4950,79,DEUX SEVRES,4780,3352,182,3170,2001,t1,cantonales
4951,79,DEUX SEVRES,4957,3785,180,3605,2001,t1,cantonales
4952,79,DEUX SEVRES,6917,4811,237,4574,2001,t1,cantonales
4953,79,DEUX SEVRES,21242,12862,502,12360,2001,t1,cantonales
4954,79,DEUX SEVRES,15814,10714,657,10057,2001,t1,cantonales
4955,79,DEUX SEVRES,3370,2614,192,2422,2001,t1,cantonales
4956,79,DEUX SEVRES,10220,7246,343,6903,2001,t1,cantonales
4957,79,DEUX SEVRES,5714,4369,369,4000,2001,t1,cantonales
4958,79,DEUX SEVRES,10244,7017,429,6588,2001,t1,cantonales
4959,80,SOMME,10930,7785,465,7320,2001,t1,cantonales
4960,80,SOMME,5485,4378,187,4191,2001,t1,cantonales
4961,80,SOMME,11388,6383,285,6098,2001,t1,cantonales
4962,80,SOMME,7508,4254,296,3958,2001,t1,cantonales
4963,80,SOMME,10829,6306,306,6000,2001,t1,cantonales
4964,80,SOMME,4074,3543,170,3373,2001,t1,cantonales
4965,80,SOMME,14093,10480,503,9977,2001,t1,cantonales
4966,80,SOMME,4741,4105,144,3961,2001,t1,cantonales
4967,80,SOMME,4925,4065,152,3913,2001,t1,cantonales
4968,80,SOMME,4944,4345,296,4049,2001,t1,cantonales
4969,80,SOMME,8061,6368,361,6007,2001,t1,cantonales
4970,80,SOMME,5900,4939,222,4717,2001,t1,cantonales
4971,80,SOMME,9737,7161,326,6835,2001,t1,cantonales
4972,80,SOMME,4596,3823,252,3571,2001,t1,cantonales
4973,80,SOMME,8627,6741,282,6459,2001,t1,cantonales
4974,80,SOMME,6171,5206,285,4921,2001,t1,cantonales
4975,80,SOMME,4974,4191,277,3914,2001,t1,cantonales
4976,80,SOMME,12491,9213,392,8821,2001,t1,cantonales
4977,80,SOMME,13704,10766,572,10194,2001,t1,cantonales
4978,80,SOMME,5485,4464,191,4273,2001,t1,cantonales
4979,80,SOMME,6222,5063,301,4762,2001,t1,cantonales
4980,80,SOMME,9347,7015,428,6587,2001,t1,cantonales
4981,80,SOMME,9250,7557,299,7258,2001,t1,cantonales
4982,80,SOMME,8960,5140,247,4893,2001,t1,cantonales
4983,81,TARN,2760,2305,134,2171,2001,t1,cantonales
4984,81,TARN,2992,2440,188,2252,2001,t1,cantonales
4985,81,TARN,7204,5070,286,4784,2001,t1,cantonales
4986,81,TARN,8957,6055,304,5751,2001,t1,cantonales
4987,81,TARN,6456,5142,319,4823,2001,t1,cantonales
4988,81,TARN,13923,9278,1126,8152,2001,t1,cantonales
4989,81,TARN,3141,2665,71,2594,2001,t1,cantonales
4990,81,TARN,14799,11500,670,10830,2001,t1,cantonales
4991,81,TARN,2463,2070,140,1930,2001,t1,cantonales
4992,81,TARN,3332,2815,365,2450,2001,t1,cantonales
4993,81,TARN,4996,4096,251,3845,2001,t1,cantonales
4994,81,TARN,5709,4421,267,4154,2001,t1,cantonales
4995,81,TARN,5392,4213,201,4012,2001,t1,cantonales
4996,81,TARN,2104,1876,68,1808,2001,t1,cantonales
4997,81,TARN,2944,2577,107,2470,2001,t1,cantonales
4998,81,TARN,1373,1094,109,985,2001,t1,cantonales
4999,81,TARN,4074,3237,325,2912,2001,t1,cantonales
5000,81,TARN,9413,7231,496,6735,2001,t1,cantonales
5001,81,TARN,6076,4389,365,4024,2001,t1,cantonales
5002,81,TARN,7409,5081,295,4786,2001,t1,cantonales
5003,81,TARN,8465,5682,302,5380,2001,t1,cantonales
5004,81,TARN,7345,5075,189,4886,2001,t1,cantonales
5005,81,TARN,7616,5524,322,5202,2001,t1,cantonales
5006,82,TARN ET GARONNE,3242,2667,124,2543,2001,t1,cantonales
5007,82,TARN ET GARONNE,1690,1399,89,1310,2001,t1,cantonales
5008,82,TARN ET GARONNE,2084,1775,86,1689,2001,t1,cantonales
5009,82,TARN ET GARONNE,2093,1813,66,1747,2001,t1,cantonales
5010,82,TARN ET GARONNE,5975,3780,266,3514,2001,t1,cantonales
5011,82,TARN ET GARONNE,2277,1871,72,1799,2001,t1,cantonales
5012,82,TARN ET GARONNE,6211,3973,234,3739,2001,t1,cantonales
5013,82,TARN ET GARONNE,11239,8025,430,7595,2001,t1,cantonales
5014,82,TARN ET GARONNE,8014,6195,447,5748,2001,t1,cantonales
5015,82,TARN ET GARONNE,4397,3573,132,3441,2001,t1,cantonales
5016,82,TARN ET GARONNE,5607,4367,325,4042,2001,t1,cantonales
5017,82,TARN ET GARONNE,3886,2979,230,2749,2001,t1,cantonales
5018,82,TARN ET GARONNE,6471,4854,213,4641,2001,t1,cantonales
5019,82,TARN ET GARONNE,6834,4345,225,4120,2001,t1,cantonales
5020,82,TARN ET GARONNE,4170,2624,107,2517,2001,t1,cantonales
5021,82,TARN ET GARONNE,6182,4038,223,3815,2001,t1,cantonales
5022,83,VAR,2370,2007,53,1954,2001,t1,cantonales
5023,83,VAR,6228,4657,199,4458,2001,t1,cantonales
5024,83,VAR,20565,12989,442,12547,2001,t1,cantonales
5025,83,VAR,10517,7269,173,7096,2001,t1,cantonales
5026,83,VAR,1225,1048,41,1007,2001,t1,cantonales
5027,83,VAR,5749,4249,219,4030,2001,t1,cantonales
5028,83,VAR,12935,8524,305,8219,2001,t1,cantonales
5029,83,VAR,30388,19298,611,18687,2001,t1,cantonales
5030,83,VAR,12318,8433,234,8199,2001,t1,cantonales
5031,83,VAR,19358,12940,532,12408,2001,t1,cantonales
5032,83,VAR,12573,8680,319,8361,2001,t1,cantonales
5033,83,VAR,3703,2774,146,2628,2001,t1,cantonales
5034,83,VAR,17862,11755,545,11210,2001,t1,cantonales
5035,83,VAR,7022,3849,180,3669,2001,t1,cantonales
5036,83,VAR,16054,8881,506,8375,2001,t1,cantonales
5037,83,VAR,6961,4014,177,3837,2001,t1,cantonales
5038,83,VAR,19754,10726,395,10331,2001,t1,cantonales
5039,83,VAR,6712,3855,115,3740,2001,t1,cantonales
5040,83,VAR,16968,9100,411,8689,2001,t1,cantonales
5041,83,VAR,24558,16062,502,15560,2001,t1,cantonales
5042,83,VAR,20049,10836,444,10392,2001,t1,cantonales
5043,84,VAUCLUSE,20591,12425,530,11895,2001,t1,cantonales
5044,84,VAUCLUSE,17860,12374,440,11934,2001,t1,cantonales
5045,84,VAUCLUSE,24378,16614,565,16049,2001,t1,cantonales
5046,84,VAUCLUSE,25609,16034,816,15218,2001,t1,cantonales
5047,84,VAUCLUSE,4712,3650,149,3501,2001,t1,cantonales
5048,84,VAUCLUSE,14556,10946,305,10641,2001,t1,cantonales
5049,84,VAUCLUSE,11994,8484,324,8160,2001,t1,cantonales
5050,84,VAUCLUSE,21598,14339,722,13617,2001,t1,cantonales
5051,84,VAUCLUSE,1881,1578,49,1529,2001,t1,cantonales
5052,84,VAUCLUSE,8973,6928,337,6591,2001,t1,cantonales
5053,84,VAUCLUSE,8808,6110,292,5818,2001,t1,cantonales
5054,84,VAUCLUSE,13852,8621,334,8287,2001,t1,cantonales
5055,85,VENDEE,11927,8983,654,8329,2001,t1,cantonales
5056,85,VENDEE,15014,10444,747,9697,2001,t1,cantonales
5057,85,VENDEE,15307,10782,492,10290,2001,t1,cantonales
5058,85,VENDEE,5653,4492,210,4282,2001,t1,cantonales
5059,85,VENDEE,19547,14296,932,13364,2001,t1,cantonales
5060,85,VENDEE,19056,13833,718,13115,2001,t1,cantonales
5061,85,VENDEE,11766,8538,568,7970,2001,t1,cantonales
5062,85,VENDEE,10464,7981,334,7647,2001,t1,cantonales
5063,85,VENDEE,8369,5554,158,5396,2001,t1,cantonales
5064,85,VENDEE,6621,4979,228,4751,2001,t1,cantonales
5065,85,VENDEE,16494,12532,1093,11439,2001,t1,cantonales
5066,85,VENDEE,28711,20065,957,19108,2001,t1,cantonales
5067,85,VENDEE,6955,5341,266,5075,2001,t1,cantonales
5068,85,VENDEE,12735,8749,367,8382,2001,t1,cantonales
5069,85,VENDEE,29659,18674,1068,17606,2001,t1,cantonales
5070,86,VIENNE,2529,2060,73,1987,2001,t1,cantonales
5071,86,VIENNE,10808,6040,317,5723,2001,t1,cantonales
5072,86,VIENNE,7188,5310,273,5037,2001,t1,cantonales
5073,86,VIENNE,6136,4572,285,4287,2001,t1,cantonales
5074,86,VIENNE,4508,3560,146,3414,2001,t1,cantonales
5075,86,VIENNE,6337,4444,154,4290,2001,t1,cantonales
5076,86,VIENNE,8156,6132,378,5754,2001,t1,cantonales
5077,86,VIENNE,3007,2531,84,2447,2001,t1,cantonales
5078,86,VIENNE,9544,5949,230,5719,2001,t1,cantonales
5079,86,VIENNE,11469,6745,363,6382,2001,t1,cantonales
5080,86,VIENNE,8814,6047,308,5739,2001,t1,cantonales
5081,86,VIENNE,4305,3372,158,3214,2001,t1,cantonales
5082,86,VIENNE,9299,7177,640,6537,2001,t1,cantonales
5083,86,VIENNE,6131,4473,291,4182,2001,t1,cantonales
5084,86,VIENNE,7509,5603,315,5288,2001,t1,cantonales
5085,86,VIENNE,11052,6707,291,6416,2001,t1,cantonales
5086,86,VIENNE,11407,7533,404,7129,2001,t1,cantonales
5087,86,VIENNE,8409,4892,218,4674,2001,t1,cantonales
5088,86,VIENNE,13001,7734,457,7277,2001,t1,cantonales
5089,87,HAUTE VIENNE,4338,3146,322,2824,2001,t1,cantonales
5090,87,HAUTE VIENNE,4673,3677,487,3190,2001,t1,cantonales
5091,87,HAUTE VIENNE,4834,3760,393,3367,2001,t1,cantonales
5092,87,HAUTE VIENNE,3997,3098,114,2984,2001,t1,cantonales
5093,87,HAUTE VIENNE,3017,2432,126,2306,2001,t1,cantonales
5094,87,HAUTE VIENNE,4665,2780,189,2591,2001,t1,cantonales
5095,87,HAUTE VIENNE,3874,2253,131,2122,2001,t1,cantonales
5096,87,HAUTE VIENNE,3266,2533,88,2445,2001,t1,cantonales
5097,87,HAUTE VIENNE,5620,4295,522,3773,2001,t1,cantonales
5098,87,HAUTE VIENNE,6853,5143,300,4843,2001,t1,cantonales
5099,87,HAUTE VIENNE,3490,2704,217,2487,2001,t1,cantonales
5100,87,HAUTE VIENNE,5834,4693,225,4468,2001,t1,cantonales
5101,87,HAUTE VIENNE,4405,3503,286,3217,2001,t1,cantonales
5102,87,HAUTE VIENNE,3018,2441,136,2305,2001,t1,cantonales
5103,87,HAUTE VIENNE,9006,7268,411,6857,2001,t1,cantonales
5104,87,HAUTE VIENNE,7864,5264,422,4842,2001,t1,cantonales
5105,87,HAUTE VIENNE,3898,2251,141,2110,2001,t1,cantonales
5106,87,HAUTE VIENNE,12136,8180,540,7640,2001,t1,cantonales
5107,87,HAUTE VIENNE,6241,4562,298,4264,2001,t1,cantonales
5108,87,HAUTE VIENNE,5640,3488,268,3220,2001,t1,cantonales
5109,87,HAUTE VIENNE,4700,2901,159,2742,2001,t1,cantonales
5110,88,VOSGES,3073,2473,97,2376,2001,t1,cantonales
5111,88,VOSGES,4548,3788,147,3641,2001,t1,cantonales
5112,88,VOSGES,8914,6464,262,6202,2001,t1,cantonales
5113,88,VOSGES,5731,4295,263,4032,2001,t1,cantonales
5114,88,VOSGES,3205,2635,139,2496,2001,t1,cantonales
5115,88,VOSGES,3956,3187,115,3072,2001,t1,cantonales
5116,88,VOSGES,4411,3569,146,3423,2001,t1,cantonales
5117,88,VOSGES,5886,4409,371,4038,2001,t1,cantonales
5118,88,VOSGES,1936,1636,102,1534,2001,t1,cantonales
5119,88,VOSGES,9482,7168,399,6769,2001,t1,cantonales
5120,88,VOSGES,8619,5836,299,5537,2001,t1,cantonales
5121,88,VOSGES,24246,15687,971,14716,2001,t1,cantonales
5122,88,VOSGES,7723,5377,353,5024,2001,t1,cantonales
5123,88,VOSGES,10095,7361,374,6987,2001,t1,cantonales
5124,88,VOSGES,24147,15849,754,15095,2001,t1,cantonales
5125,88,VOSGES,12775,7813,514,7299,2001,t1,cantonales
5126,89,YONNE,6979,4957,302,4655,2001,t1,cantonales
5127,89,YONNE,5240,3943,532,3411,2001,t1,cantonales
5128,89,YONNE,5836,2836,170,2666,2001,t1,cantonales
5129,89,YONNE,5427,3954,159,3795,2001,t1,cantonales
5130,89,YONNE,4611,3272,201,3071,2001,t1,cantonales
5131,89,YONNE,5907,4325,187,4138,2001,t1,cantonales
5132,89,YONNE,2679,2105,137,1968,2001,t1,cantonales
5133,89,YONNE,2529,2043,135,1908,2001,t1,cantonales
5134,89,YONNE,2368,1924,69,1855,2001,t1,cantonales
5135,89,YONNE,9661,6013,243,5770,2001,t1,cantonales
5136,89,YONNE,2466,1980,82,1898,2001,t1,cantonales
5137,89,YONNE,3567,2622,151,2471,2001,t1,cantonales
5138,89,YONNE,3857,2599,135,2464,2001,t1,cantonales
5139,89,YONNE,4076,2860,143,2717,2001,t1,cantonales
5140,89,YONNE,13922,8655,626,8029,2001,t1,cantonales
5141,89,YONNE,5777,3830,257,3573,2001,t1,cantonales
5142,89,YONNE,7044,5125,287,4838,2001,t1,cantonales
5143,89,YONNE,4339,3305,174,3131,2001,t1,cantonales
5144,89,YONNE,7195,4263,293,3970,2001,t1,cantonales
5145,89,YONNE,8895,5769,294,5475,2001,t1,cantonales
5146,90,TERRITOIRE DE BELFORT,7396,4723,312,4411,2001,t1,cantonales
5147,90,TERRITOIRE DE BELFORT,4979,3948,206,3742,2001,t1,cantonales
5148,90,TERRITOIRE DE BELFORT,9188,6562,438,6124,2001,t1,cantonales
5149,90,TERRITOIRE DE BELFORT,3813,2904,199,2705,2001,t1,cantonales
5150,90,TERRITOIRE DE BELFORT,4816,3367,131,3236,2001,t1,cantonales
5151,90,TERRITOIRE DE BELFORT,6458,4388,365,4023,2001,t1,cantonales
5152,90,TERRITOIRE DE BELFORT,4883,2488,116,2372,2001,t1,cantonales
5153,91,ESSONNE,18025,11386,251,11135,2001,t1,cantonales
5154,91,ESSONNE,19998,11535,521,11014,2001,t1,cantonales
5155,91,ESSONNE,14512,8314,260,8054,2001,t1,cantonales
5156,91,ESSONNE,17395,11085,638,10447,2001,t1,cantonales
5157,91,ESSONNE,14405,8986,519,8467,2001,t1,cantonales
5158,91,ESSONNE,14721,9573,331,9242,2001,t1,cantonales
5159,91,ESSONNE,25573,14506,570,13936,2001,t1,cantonales
5160,91,ESSONNE,22240,13417,647,12770,2001,t1,cantonales
5161,91,ESSONNE,14684,8096,245,7851,2001,t1,cantonales
5162,91,ESSONNE,24409,14348,373,13975,2001,t1,cantonales
5163,91,ESSONNE,13707,7734,175,7559,2001,t1,cantonales
5164,91,ESSONNE,16241,10472,541,9931,2001,t1,cantonales
5165,91,ESSONNE,16351,8692,246,8446,2001,t1,cantonales
5166,91,ESSONNE,16621,9576,273,9303,2001,t1,cantonales
5167,91,ESSONNE,19712,11956,397,11559,2001,t1,cantonales
5168,91,ESSONNE,11530,6479,203,6276,2001,t1,cantonales
5169,91,ESSONNE,13326,8655,234,8421,2001,t1,cantonales
5170,91,ESSONNE,23380,14671,405,14266,2001,t1,cantonales
5171,91,ESSONNE,9380,5482,110,5372,2001,t1,cantonales
5172,91,ESSONNE,16370,8547,430,8117,2001,t1,cantonales
5173,91,ESSONNE,10192,5838,230,5608,2001,t1,cantonales
5174,92,HAUTS DE SEINE ,28331,16629,460,16169,2001,t1,cantonales
5175,92,HAUTS DE SEINE ,14582,8760,363,8397,2001,t1,cantonales
5176,92,HAUTS DE SEINE ,19817,9900,291,9609,2001,t1,cantonales
5177,92,HAUTS DE SEINE ,13292,7861,176,7685,2001,t1,cantonales
5178,92,HAUTS DE SEINE ,15577,7465,210,7255,2001,t1,cantonales
5179,92,HAUTS DE SEINE ,22798,10993,363,10630,2001,t1,cantonales
5180,92,HAUTS DE SEINE ,19473,11161,359,10802,2001,t1,cantonales
5181,92,HAUTS DE SEINE ,17610,10072,348,9724,2001,t1,cantonales
5182,92,HAUTS DE SEINE ,15893,9352,275,9077,2001,t1,cantonales
5183,92,HAUTS DE SEINE ,15891,9088,315,8773,2001,t1,cantonales
5184,92,HAUTS DE SEINE ,26581,14423,318,14105,2001,t1,cantonales
5185,92,HAUTS DE SEINE ,17538,10498,208,10290,2001,t1,cantonales
5186,92,HAUTS DE SEINE ,14245,9539,260,9279,2001,t1,cantonales
5187,92,HAUTS DE SEINE ,18421,9639,211,9428,2001,t1,cantonales
5188,92,HAUTS DE SEINE ,14553,7344,335,7009,2001,t1,cantonales
5189,92,HAUTS DE SEINE ,14570,7550,207,7343,2001,t1,cantonales
5190,92,HAUTS DE SEINE ,12935,7806,195,7611,2001,t1,cantonales
5191,92,HAUTS DE SEINE ,21169,11858,256,11602,2001,t1,cantonales
5192,92,HAUTS DE SEINE ,11248,5356,156,5200,2001,t1,cantonales
5193,92,HAUTS DE SEINE ,11450,5889,224,5665,2001,t1,cantonales
5194,92,HAUTS DE SEINE ,13711,8227,211,8016,2001,t1,cantonales
5195,92,HAUTS DE SEINE ,8193,4091,158,3933,2001,t1,cantonales
5196,93,SEINE SAINT-DENIS,8651,4172,131,4041,2001,t1,cantonales
5197,93,SEINE SAINT-DENIS,15228,8264,239,8025,2001,t1,cantonales
5198,93,SEINE SAINT-DENIS,13867,6722,272,6450,2001,t1,cantonales
5199,93,SEINE SAINT-DENIS,21325,10575,415,10160,2001,t1,cantonales
5200,93,SEINE SAINT-DENIS,18254,7930,314,7616,2001,t1,cantonales
5201,93,SEINE SAINT-DENIS,10031,5602,207,5395,2001,t1,cantonales
5202,93,SEINE SAINT-DENIS,23163,12849,468,12381,2001,t1,cantonales
5203,93,SEINE SAINT-DENIS,21664,11904,455,11449,2001,t1,cantonales
5204,93,SEINE SAINT-DENIS,15677,6991,270,6721,2001,t1,cantonales
5205,93,SEINE SAINT-DENIS,11023,6077,132,5945,2001,t1,cantonales
5206,93,SEINE SAINT-DENIS,16634,8419,280,8139,2001,t1,cantonales
5207,93,SEINE SAINT-DENIS,10705,5498,197,5301,2001,t1,cantonales
5208,93,SEINE SAINT-DENIS,18479,8181,419,7762,2001,t1,cantonales
5209,93,SEINE SAINT-DENIS,11440,5850,279,5571,2001,t1,cantonales
5210,93,SEINE SAINT-DENIS,15000,6405,297,6108,2001,t1,cantonales
5211,93,SEINE SAINT-DENIS,18714,8813,507,8306,2001,t1,cantonales
5212,93,SEINE SAINT-DENIS,15013,8712,288,8424,2001,t1,cantonales
5213,93,SEINE SAINT-DENIS,10115,5378,220,5158,2001,t1,cantonales
5214,93,SEINE SAINT-DENIS,14726,6587,260,6327,2001,t1,cantonales
5215,93,SEINE SAINT-DENIS,16469,8749,448,8301,2001,t1,cantonales
5216,94,VAL DE MARNE,10591,5898,263,5635,2001,t1,cantonales
5217,94,VAL DE MARNE,16109,8719,281,8438,2001,t1,cantonales
5218,94,VAL DE MARNE,13341,7492,202,7290,2001,t1,cantonales
5219,94,VAL DE MARNE,9191,4945,162,4783,2001,t1,cantonales
5220,94,VAL DE MARNE,12443,6643,242,6401,2001,t1,cantonales
5221,94,VAL DE MARNE,17558,8999,296,8703,2001,t1,cantonales
5222,94,VAL DE MARNE,10769,6033,198,5835,2001,t1,cantonales
5223,94,VAL DE MARNE,15756,9069,313,8756,2001,t1,cantonales
5224,94,VAL DE MARNE,9932,5430,177,5253,2001,t1,cantonales
5225,94,VAL DE MARNE,12146,7061,146,6915,2001,t1,cantonales
5226,94,VAL DE MARNE,14347,8126,206,7920,2001,t1,cantonales
5227,94,VAL DE MARNE,14842,9068,237,8831,2001,t1,cantonales
5228,94,VAL DE MARNE,12412,7107,207,6900,2001,t1,cantonales
5229,94,VAL DE MARNE,14657,7663,145,7518,2001,t1,cantonales
5230,94,VAL DE MARNE,11706,6795,214,6581,2001,t1,cantonales
5231,94,VAL DE MARNE,12729,5918,265,5653,2001,t1,cantonales
5232,94,VAL DE MARNE,13830,6335,233,6102,2001,t1,cantonales
5233,94,VAL DE MARNE,10962,5198,181,5017,2001,t1,cantonales
5234,94,VAL DE MARNE,13310,7034,157,6877,2001,t1,cantonales
5235,94,VAL DE MARNE,22164,13088,504,12584,2001,t1,cantonales
5236,94,VAL DE MARNE,14823,8191,309,7882,2001,t1,cantonales
5237,94,VAL DE MARNE,11277,6623,148,6475,2001,t1,cantonales
5238,94,VAL DE MARNE,15674,9155,220,8935,2001,t1,cantonales
5239,94,VAL DE MARNE,12692,6048,260,5788,2001,t1,cantonales
5240,95,VAL D'OISE,16872,8753,294,8459,2001,t1,cantonales
5241,95,VAL D'OISE,11051,6304,199,6105,2001,t1,cantonales
5242,95,VAL D'OISE,20568,11061,353,10708,2001,t1,cantonales
5243,95,VAL D'OISE,13793,8357,265,8092,2001,t1,cantonales
5244,95,VAL D'OISE,22865,12993,323,12670,2001,t1,cantonales
5245,95,VAL D'OISE,16987,9050,336,8714,2001,t1,cantonales
5246,95,VAL D'OISE,5672,3122,119,3003,2001,t1,cantonales
5247,95,VAL D'OISE,16347,10280,321,9959,2001,t1,cantonales
5248,95,VAL D'OISE,22500,13615,768,12847,2001,t1,cantonales
5249,95,VAL D'OISE,14598,8050,204,7846,2001,t1,cantonales
5250,95,VAL D'OISE,15938,9740,272,9468,2001,t1,cantonales
5251,95,VAL D'OISE,12715,7061,183,6878,2001,t1,cantonales
5252,95,VAL D'OISE,21810,12288,356,11932,2001,t1,cantonales
5253,95,VAL D'OISE,7344,5361,210,5151,2001,t1,cantonales
5254,95,VAL D'OISE,23590,12333,377,11956,2001,t1,cantonales
5255,95,VAL D'OISE,17439,10632,387,10245,2001,t1,cantonales
5256,95,VAL D'OISE,17141,8710,451,8259,2001,t1,cantonales
5257,95,VAL D'OISE,16825,9474,254,9220,2001,t1,cantonales
5258,95,VAL D'OISE,23415,14424,386,14038,2001,t1,cantonales
5259,95,VAL D'OISE,11827,5981,132,5849,2001,t1,cantonales
5260,971,GUADELOUPE,6266,3315,331,2984,2001,t1,cantonales
5261,971,GUADELOUPE,5645,3351,320,3031,2001,t1,cantonales
5262,971,GUADELOUPE,4072,2437,281,2156,2001,t1,cantonales
5263,971,GUADELOUPE,6132,4277,253,4024,2001,t1,cantonales
5264,971,GUADELOUPE,3216,2511,114,2397,2001,t1,cantonales
5265,971,GUADELOUPE,6814,3579,247,3332,2001,t1,cantonales
5266,971,GUADELOUPE,4885,3178,142,3036,2001,t1,cantonales
5267,971,GUADELOUPE,5259,3829,223,3606,2001,t1,cantonales
5268,971,GUADELOUPE,7298,4855,333,4522,2001,t1,cantonales
5269,971,GUADELOUPE,3079,2051,97,1954,2001,t1,cantonales
5270,971,GUADELOUPE,8601,4836,529,4307,2001,t1,cantonales
5271,971,GUADELOUPE,4960,3052,350,2702,2001,t1,cantonales
5272,971,GUADELOUPE,9253,6591,359,6232,2001,t1,cantonales
5273,971,GUADELOUPE,5238,3776,212,3564,2001,t1,cantonales
5274,971,GUADELOUPE,3182,2506,33,2473,2001,t1,cantonales
5275,971,GUADELOUPE,10360,7798,397,7401,2001,t1,cantonales
5276,971,GUADELOUPE,7530,5283,426,4857,2001,t1,cantonales
5277,971,GUADELOUPE,7756,4097,473,3624,2001,t1,cantonales
5278,971,GUADELOUPE,5704,3759,460,3299,2001,t1,cantonales
5279,971,GUADELOUPE,8784,5179,437,4742,2001,t1,cantonales
5280,971,GUADELOUPE,4857,2534,442,2092,2001,t1,cantonales
5281,972,MARTINIQUE,1344,1041,56,985,2001,t1,cantonales
5282,972,MARTINIQUE,2979,2312,68,2244,2001,t1,cantonales
5283,972,MARTINIQUE,3543,2505,265,2240,2001,t1,cantonales
5284,972,MARTINIQUE,4118,2809,170,2639,2001,t1,cantonales
5285,972,MARTINIQUE,4229,2953,166,2787,2001,t1,cantonales
5286,972,MARTINIQUE,3408,2541,107,2434,2001,t1,cantonales
5287,972,MARTINIQUE,5711,2764,236,2528,2001,t1,cantonales
5288,972,MARTINIQUE,3135,1452,141,1311,2001,t1,cantonales
5289,972,MARTINIQUE,7361,4701,425,4276,2001,t1,cantonales
5290,972,MARTINIQUE,7457,4694,465,4229,2001,t1,cantonales
5291,972,MARTINIQUE,5398,3094,176,2918,2001,t1,cantonales
5292,972,MARTINIQUE,5670,3668,156,3512,2001,t1,cantonales
5293,972,MARTINIQUE,4316,2793,269,2524,2001,t1,cantonales
5294,972,MARTINIQUE,7112,4145,169,3976,2001,t1,cantonales
5295,972,MARTINIQUE,9754,6541,340,6201,2001,t1,cantonales
5296,972,MARTINIQUE,5044,3052,132,2920,2001,t1,cantonales
5297,972,MARTINIQUE,3425,2669,114,2555,2001,t1,cantonales
5298,972,MARTINIQUE,5821,3740,178,3562,2001,t1,cantonales
5299,972,MARTINIQUE,4592,2282,233,2049,2001,t1,cantonales
5300,972,MARTINIQUE,10600,5600,572,5028,2001,t1,cantonales
5301,972,MARTINIQUE,6845,3334,202,3132,2001,t1,cantonales
5302,972,MARTINIQUE,5950,3657,330,3327,2001,t1,cantonales
5303,973,GUYANE,1894,834,55,779,2001,t1,cantonales
5304,973,GUYANE,2703,1396,69,1327,2001,t1,cantonales
5305,973,GUYANE,3460,1518,173,1345,2001,t1,cantonales
5306,973,GUYANE,2740,1754,64,1690,2001,t1,cantonales
5307,973,GUYANE,3476,1800,96,1704,2001,t1,cantonales
5308,973,GUYANE,2585,1649,70,1579,2001,t1,cantonales
5309,973,GUYANE,610,430,15,415,2001,t1,cantonales
5310,973,GUYANE,2827,1239,103,1136,2001,t1,cantonales
5311,973,GUYANE,2671,1217,114,1103,2001,t1,cantonales
5312,973,GUYANE,5199,3075,169,2906,2001,t1,cantonales
5313,974,LA REUNION,6008,4341,181,4160,2001,t1,cantonales
5314,974,LA REUNION,3872,3235,116,3119,2001,t1,cantonales
5315,974,LA REUNION,7243,4986,318,4668,2001,t1,cantonales
5316,974,LA REUNION,2599,2172,49,2123,2001,t1,cantonales
5317,974,LA REUNION,10213,6599,341,6258,2001,t1,cantonales
5318,974,LA REUNION,5690,3184,249,2935,2001,t1,cantonales
5319,974,LA REUNION,6640,4578,284,4294,2001,t1,cantonales
5320,974,LA REUNION,7181,4309,246,4063,2001,t1,cantonales
5321,974,LA REUNION,7790,5953,274,5679,2001,t1,cantonales
5322,974,LA REUNION,7828,5860,276,5584,2001,t1,cantonales
5323,974,LA REUNION,14155,11092,448,10644,2001,t1,cantonales
5324,974,LA REUNION,10307,6479,458,6021,2001,t1,cantonales
5325,974,LA REUNION,12879,9448,604,8844,2001,t1,cantonales
5326,974,LA REUNION,8175,5307,332,4975,2001,t1,cantonales
5327,974,LA REUNION,9960,6923,493,6430,2001,t1,cantonales
5328,974,LA REUNION,4790,4042,116,3926,2001,t1,cantonales
5329,974,LA REUNION,10620,7714,698,7016,2001,t1,cantonales
5330,974,LA REUNION,4664,3524,97,3427,2001,t1,cantonales
5331,974,LA REUNION,10363,6720,548,6172,2001,t1,cantonales
5332,974,LA REUNION,7660,3960,322,3638,2001,t1,cantonales
5333,974,LA REUNION,7363,4191,365,3826,2001,t1,cantonales
5334,974,LA REUNION,8156,4644,494,4150,2001,t1,cantonales
5335,974,LA REUNION,9877,5701,442,5259,2001,t1,cantonales
5336,974,LA REUNION,11349,7927,581,7346,2001,t1,cantonales
5337,974,LA REUNION,9387,6954,610,6344,2001,t1,cantonales
5338,974,LA REUNION,7421,5231,194,5037,2001,t1,cantonales
5339,1,AIN,10638,4870,327,4543,2011,t2,cantonales
5340,1,AIN,10657,4539,204,4335,2011,t2,cantonales
5341,1,AIN,12238,6406,384,6022,2011,t2,cantonales
5342,1,AIN,12550,5311,317,4994,2011,t2,cantonales
5343,1,AIN,5032,3022,140,2882,2011,t2,cantonales
5344,1,AIN,16768,6026,248,5778,2011,t2,cantonales
5345,1,AIN,3559,1851,70,1781,2011,t2,cantonales
5346,1,AIN,4087,2218,111,2107,2011,t2,cantonales
5347,1,AIN,14103,6171,288,5883,2011,t2,cantonales
5348,1,AIN,7607,3350,258,3092,2011,t2,cantonales
5349,1,AIN,4914,2485,197,2288,2011,t2,cantonales
5350,1,AIN,9152,4077,259,3818,2011,t2,cantonales
5351,1,AIN,8943,4392,254,4138,2011,t2,cantonales
5352,1,AIN,4111,1998,98,1900,2011,t2,cantonales
5353,1,AIN,10190,4400,308,4092,2011,t2,cantonales
5354,1,AIN,11852,4642,240,4402,2011,t2,cantonales
5355,1,AIN,6725,2797,179,2618,2011,t2,cantonales
5356,1,AIN,3248,1802,98,1704,2011,t2,cantonales
5357,1,AIN,9942,4490,145,4345,2011,t2,cantonales
5358,1,AIN,14225,5392,304,5088,2011,t2,cantonales
5359,1,AIN,12216,6580,185,6395,2011,t2,cantonales
5360,2,AISNE,7470,3719,247,3472,2011,t2,cantonales
5361,2,AISNE,9831,4888,377,4511,2011,t2,cantonales
5362,2,AISNE,8175,4065,228,3837,2011,t2,cantonales
5363,2,AISNE,19797,9381,818,8563,2011,t2,cantonales
5364,2,AISNE,4099,2289,141,2148,2011,t2,cantonales
5365,2,AISNE,6537,3343,340,3003,2011,t2,cantonales
5366,2,AISNE,10281,4676,284,4392,2011,t2,cantonales
5367,2,AISNE,7014,3203,237,2966,2011,t2,cantonales
5368,2,AISNE,4814,2691,159,2532,2011,t2,cantonales
5369,2,AISNE,11987,4921,622,4299,2011,t2,cantonales
5370,2,AISNE,7208,3562,249,3313,2011,t2,cantonales
5371,2,AISNE,7395,3671,214,3457,2011,t2,cantonales
5372,2,AISNE,5979,3192,175,3017,2011,t2,cantonales
5373,2,AISNE,7787,3849,227,3622,2011,t2,cantonales
5374,2,AISNE,15578,6786,854,5932,2011,t2,cantonales
5375,3,ALLIER,4824,3168,109,3059,2011,t2,cantonales
5376,3,ALLIER,9230,4361,409,3952,2011,t2,cantonales
5377,3,ALLIER,6796,3359,159,3200,2011,t2,cantonales
5378,3,ALLIER,14929,7313,502,6811,2011,t2,cantonales
5379,3,ALLIER,6864,4031,320,3711,2011,t2,cantonales
5380,3,ALLIER,3428,1868,109,1759,2011,t2,cantonales
5381,3,ALLIER,3785,2176,199,1977,2011,t2,cantonales
5382,3,ALLIER,9153,3745,195,3550,2011,t2,cantonales
5383,3,ALLIER,11086,4640,277,4363,2011,t2,cantonales
5384,3,ALLIER,8426,3260,396,2864,2011,t2,cantonales
5385,3,ALLIER,12480,4359,807,3552,2011,t2,cantonales
5386,3,ALLIER,10562,5380,350,5030,2011,t2,cantonales
5387,4,ALPES DE HAUTE PROVENCE,5439,2906,192,2714,2011,t2,cantonales
5388,4,ALPES DE HAUTE PROVENCE,1249,879,25,854,2011,t2,cantonales
5389,4,ALPES DE HAUTE PROVENCE,10267,4706,636,4070,2011,t2,cantonales
5390,4,ALPES DE HAUTE PROVENCE,8678,4033,328,3705,2011,t2,cantonales
5391,4,ALPES DE HAUTE PROVENCE,1153,830,25,805,2011,t2,cantonales
5392,4,ALPES DE HAUTE PROVENCE,2887,1691,185,1506,2011,t2,cantonales
5393,4,ALPES DE HAUTE PROVENCE,4163,2365,138,2227,2011,t2,cantonales
5394,4,ALPES DE HAUTE PROVENCE,5085,2581,167,2414,2011,t2,cantonales
5395,4,ALPES DE HAUTE PROVENCE,8491,4649,300,4349,2011,t2,cantonales
5396,4,ALPES DE HAUTE PROVENCE,6025,3105,181,2924,2011,t2,cantonales
5397,5,HAUTES ALPES,5222,3024,193,2831,2011,t2,cantonales
5398,5,HAUTES ALPES,3675,1732,175,1557,2011,t2,cantonales
5399,5,HAUTES ALPES,3675,2431,123,2308,2011,t2,cantonales
5400,5,HAUTES ALPES,3170,1665,60,1605,2011,t2,cantonales
5401,5,HAUTES ALPES,1658,1263,42,1221,2011,t2,cantonales
5402,5,HAUTES ALPES,2152,1513,55,1458,2011,t2,cantonales
5403,5,HAUTES ALPES,4683,3436,109,3327,2011,t2,cantonales
5404,5,HAUTES ALPES,5658,2479,133,2346,2011,t2,cantonales
5405,5,HAUTES ALPES,6282,2589,218,2371,2011,t2,cantonales
5406,6,ALPES MARITIMES,27153,11528,983,10545,2011,t2,cantonales
5407,6,ALPES MARITIMES,21843,8756,560,8196,2011,t2,cantonales
5408,6,ALPES MARITIMES,15978,7343,606,6737,2011,t2,cantonales
5409,6,ALPES MARITIMES,21373,9276,634,8642,2011,t2,cantonales
5410,6,ALPES MARITIMES,2673,1894,74,1820,2011,t2,cantonales
5411,6,ALPES MARITIMES,15816,7394,592,6802,2011,t2,cantonales
5412,6,ALPES MARITIMES,2799,1948,124,1824,2011,t2,cantonales
5413,6,ALPES MARITIMES,16932,7682,609,7073,2011,t2,cantonales
5414,6,ALPES MARITIMES,18296,7441,475,6966,2011,t2,cantonales
5415,6,ALPES MARITIMES,29352,11606,1092,10514,2011,t2,cantonales
5416,6,ALPES MARITIMES,28315,12287,1017,11270,2011,t2,cantonales
5417,6,ALPES MARITIMES,14915,5669,532,5137,2011,t2,cantonales
5418,6,ALPES MARITIMES,12987,4797,394,4403,2011,t2,cantonales
5419,6,ALPES MARITIMES,20919,7655,592,7063,2011,t2,cantonales
5420,6,ALPES MARITIMES,19188,7549,694,6855,2011,t2,cantonales
5421,6,ALPES MARITIMES,12492,5071,449,4622,2011,t2,cantonales
5422,6,ALPES MARITIMES,13852,5304,380,4924,2011,t2,cantonales
5423,6,ALPES MARITIMES,19658,6852,510,6342,2011,t2,cantonales
5424,6,ALPES MARITIMES,18022,7384,587,6797,2011,t2,cantonales
5425,6,ALPES MARITIMES,15253,5735,612,5123,2011,t2,cantonales
5426,7,ARDECHE,13726,5816,363,5453,2011,t2,cantonales
5427,7,ARDECHE,2541,1528,116,1412,2011,t2,cantonales
5428,7,ARDECHE,5297,3478,117,3361,2011,t2,cantonales
5429,7,ARDECHE,7959,4272,242,4030,2011,t2,cantonales
5430,7,ARDECHE,5225,3668,136,3532,2011,t2,cantonales
5431,7,ARDECHE,1836,1317,135,1182,2011,t2,cantonales
5432,7,ARDECHE,14187,6869,582,6287,2011,t2,cantonales
5433,7,ARDECHE,883,676,16,660,2011,t2,cantonales
5434,7,ARDECHE,3097,1986,97,1889,2011,t2,cantonales
5435,7,ARDECHE,2903,1924,78,1846,2011,t2,cantonales
5436,7,ARDECHE,7094,4186,202,3984,2011,t2,cantonales
5437,7,ARDECHE,10509,5662,322,5340,2011,t2,cantonales
5438,7,ARDECHE,11198,4979,335,4644,2011,t2,cantonales
5439,7,ARDECHE,11516,4807,450,4357,2011,t2,cantonales
5440,8,ARDENNES,3648,1847,120,1727,2011,t2,cantonales
5441,8,ARDENNES,8905,4051,191,3860,2011,t2,cantonales
5442,8,ARDENNES,2963,1753,133,1620,2011,t2,cantonales
5443,8,ARDENNES,5940,2944,234,2710,2011,t2,cantonales
5444,8,ARDENNES,9477,4139,225,3914,2011,t2,cantonales
5445,8,ARDENNES,7138,2911,215,2696,2011,t2,cantonales
5446,8,ARDENNES,8904,3584,301,3283,2011,t2,cantonales
5447,8,ARDENNES,3094,1674,110,1564,2011,t2,cantonales
5448,8,ARDENNES,2779,1863,53,1810,2011,t2,cantonales
5449,8,ARDENNES,4477,2399,167,2232,2011,t2,cantonales
5450,9,ARIEGE,4587,2730,339,2391,2011,t2,cantonales
5451,9,ARIEGE,10293,5598,409,5189,2011,t2,cantonales
5452,9,ARIEGE,3450,1962,179,1783,2011,t2,cantonales
5453,9,ARIEGE,2736,1582,77,1505,2011,t2,cantonales
5454,9,ARIEGE,7513,3359,287,3072,2011,t2,cantonales
5455,9,ARIEGE,6715,4904,266,4638,2011,t2,cantonales
5456,9,ARIEGE,9669,4465,411,4054,2011,t2,cantonales
5457,10,AUBE,6924,3475,275,3200,2011,t2,cantonales
5458,10,AUBE,7839,4453,136,4317,2011,t2,cantonales
5459,10,AUBE,5766,3352,209,3143,2011,t2,cantonales
5460,10,AUBE,4296,2277,204,2073,2011,t2,cantonales
5461,10,AUBE,4441,2348,165,2183,2011,t2,cantonales
5462,10,AUBE,5088,2615,192,2423,2011,t2,cantonales
5463,10,AUBE,2578,1439,131,1308,2011,t2,cantonales
5464,10,AUBE,7546,3565,285,3280,2011,t2,cantonales
5465,10,AUBE,2863,1650,116,1534,2011,t2,cantonales
5466,10,AUBE,10037,4358,273,4085,2011,t2,cantonales
5467,10,AUBE,8022,2745,265,2480,2011,t2,cantonales
5468,10,AUBE,2844,1519,116,1403,2011,t2,cantonales
5469,10,AUBE,6812,2890,208,2682,2011,t2,cantonales
5470,10,AUBE,5079,1794,125,1669,2011,t2,cantonales
5471,10,AUBE,10910,4217,341,3876,2011,t2,cantonales
5472,10,AUBE,5966,2451,201,2250,2011,t2,cantonales
5473,11,AUDE,3880,2524,171,2353,2011,t2,cantonales
5474,11,AUDE,1709,1102,117,985,2011,t2,cantonales
5475,11,AUDE,13945,7127,564,6563,2011,t2,cantonales
5476,11,AUDE,7078,3790,496,3294,2011,t2,cantonales
5477,11,AUDE,2523,1801,84,1717,2011,t2,cantonales
5478,11,AUDE,20092,10644,898,9746,2011,t2,cantonales
5479,11,AUDE,3199,2204,125,2079,2011,t2,cantonales
5480,11,AUDE,2633,1749,49,1700,2011,t2,cantonales
5481,11,AUDE,15285,8898,619,8279,2011,t2,cantonales
5482,11,AUDE,1876,1332,106,1226,2011,t2,cantonales
5483,11,AUDE,14387,6734,639,6095,2011,t2,cantonales
5484,11,AUDE,9619,5711,431,5280,2011,t2,cantonales
5485,11,AUDE,6300,3090,225,2865,2011,t2,cantonales
5486,12,AVEYRON,5597,3210,124,3086,2011,t2,cantonales
5487,12,AVEYRON,2154,1391,86,1305,2011,t2,cantonales
5488,12,AVEYRON,1999,1479,115,1364,2011,t2,cantonales
5489,12,AVEYRON,2568,2018,24,1994,2011,t2,cantonales
5490,12,AVEYRON,2776,2041,118,1923,2011,t2,cantonales
5491,12,AVEYRON,9276,4457,241,4216,2011,t2,cantonales
5492,12,AVEYRON,9540,5885,471,5414,2011,t2,cantonales
5493,12,AVEYRON,12755,7207,239,6968,2011,t2,cantonales
5494,12,AVEYRON,14031,7163,592,6571,2011,t2,cantonales
5495,13,BOUCHES DU RHONE,46456,16655,1329,15326,2011,t2,cantonales
5496,13,BOUCHES DU RHONE,17786,8211,389,7822,2011,t2,cantonales
5497,13,BOUCHES DU RHONE,23510,10794,630,10164,2011,t2,cantonales
5498,13,BOUCHES DU RHONE,29928,12947,1690,11257,2011,t2,cantonales
5499,13,BOUCHES DU RHONE,17727,8412,487,7925,2011,t2,cantonales
5500,13,BOUCHES DU RHONE,20228,10107,652,9455,2011,t2,cantonales
5501,13,BOUCHES DU RHONE,16960,6029,876,5153,2011,t2,cantonales
5502,13,BOUCHES DU RHONE,18447,8065,539,7526,2011,t2,cantonales
5503,13,BOUCHES DU RHONE,16205,6740,1026,5714,2011,t2,cantonales
5504,13,BOUCHES DU RHONE,17308,6946,222,6724,2011,t2,cantonales
5505,13,BOUCHES DU RHONE,21787,8995,788,8207,2011,t2,cantonales
5506,13,BOUCHES DU RHONE,19803,8118,428,7690,2011,t2,cantonales
5507,13,BOUCHES DU RHONE,14166,6797,487,6310,2011,t2,cantonales
5508,13,BOUCHES DU RHONE,6223,4759,143,4616,2011,t2,cantonales
5509,13,BOUCHES DU RHONE,12757,6358,467,5891,2011,t2,cantonales
5510,13,BOUCHES DU RHONE,13003,6511,359,6152,2011,t2,cantonales
5511,13,BOUCHES DU RHONE,23378,11058,724,10334,2011,t2,cantonales
5512,13,BOUCHES DU RHONE,25491,12518,911,11607,2011,t2,cantonales
5513,13,BOUCHES DU RHONE,26991,11765,723,11042,2011,t2,cantonales
5514,13,BOUCHES DU RHONE,19665,9338,413,8925,2011,t2,cantonales
5515,13,BOUCHES DU RHONE,24851,10355,544,9811,2011,t2,cantonales
5516,13,BOUCHES DU RHONE,18486,7932,269,7663,2011,t2,cantonales
5517,13,BOUCHES DU RHONE,23830,9550,902,8648,2011,t2,cantonales
5518,13,BOUCHES DU RHONE,36854,17621,1214,16407,2011,t2,cantonales
5519,13,BOUCHES DU RHONE,35166,16256,1324,14932,2011,t2,cantonales
5520,13,BOUCHES DU RHONE,32635,14855,800,14055,2011,t2,cantonales
5521,13,BOUCHES DU RHONE,23035,10775,520,10255,2011,t2,cantonales
5522,13,BOUCHES DU RHONE,31631,13327,1307,12020,2011,t2,cantonales
5523,13,BOUCHES DU RHONE,21952,9022,748,8274,2011,t2,cantonales
5524,14,CALVADOS,6227,2839,174,2665,2011,t2,cantonales
5525,14,CALVADOS,7802,3444,250,3194,2011,t2,cantonales
5526,14,CALVADOS,14462,7194,298,6896,2011,t2,cantonales
5527,14,CALVADOS,16900,7572,426,7146,2011,t2,cantonales
5528,14,CALVADOS,10448,4948,321,4627,2011,t2,cantonales
5529,14,CALVADOS,11064,5376,187,5189,2011,t2,cantonales
5530,14,CALVADOS,3874,2074,154,1920,2011,t2,cantonales
5531,14,CALVADOS,4520,2041,110,1931,2011,t2,cantonales
5532,14,CALVADOS,15950,8259,339,7920,2011,t2,cantonales
5533,14,CALVADOS,11706,6246,265,5981,2011,t2,cantonales
5534,14,CALVADOS,8169,3969,271,3698,2011,t2,cantonales
5535,14,CALVADOS,6411,3270,110,3160,2011,t2,cantonales
5536,14,CALVADOS,9891,4461,286,4175,2011,t2,cantonales
5537,14,CALVADOS,7594,3194,162,3032,2011,t2,cantonales
5538,14,CALVADOS,7803,3319,134,3185,2011,t2,cantonales
5539,14,CALVADOS,11188,4713,189,4524,2011,t2,cantonales
5540,14,CALVADOS,6697,2860,102,2758,2011,t2,cantonales
5541,14,CALVADOS,10002,4338,137,4201,2011,t2,cantonales
5542,14,CALVADOS,14356,6007,472,5535,2011,t2,cantonales
5543,14,CALVADOS,9493,4499,262,4237,2011,t2,cantonales
5544,15,CANTAL,5922,2551,131,2420,2011,t2,cantonales
5545,15,CANTAL,2045,1422,36,1386,2011,t2,cantonales
5546,15,CANTAL,4875,3323,163,3160,2011,t2,cantonales
5547,15,CANTAL,3134,2082,65,2017,2011,t2,cantonales
5548,16,CHARENTE,3857,2880,110,2770,2011,t2,cantonales
5549,16,CHARENTE,8044,2868,259,2609,2011,t2,cantonales
5550,16,CHARENTE,8504,3173,223,2950,2011,t2,cantonales
5551,16,CHARENTE,11804,5122,495,4627,2011,t2,cantonales
5552,16,CHARENTE,3518,2311,140,2171,2011,t2,cantonales
5553,16,CHARENTE,4752,2838,121,2717,2011,t2,cantonales
5554,16,CHARENTE,9464,4321,319,4002,2011,t2,cantonales
5555,16,CHARENTE,9513,3738,248,3490,2011,t2,cantonales
5556,16,CHARENTE,6445,3523,225,3298,2011,t2,cantonales
5557,16,CHARENTE,7021,3448,226,3222,2011,t2,cantonales
5558,16,CHARENTE,8374,4035,245,3790,2011,t2,cantonales
5559,16,CHARENTE,9454,4000,269,3731,2011,t2,cantonales
5560,16,CHARENTE,5874,3281,145,3136,2011,t2,cantonales
5561,16,CHARENTE,9323,3391,218,3173,2011,t2,cantonales
5562,17,CHARENTE MARITIME,9230,3800,256,3544,2011,t2,cantonales
5563,17,CHARENTE MARITIME,5217,2772,143,2629,2011,t2,cantonales
5564,17,CHARENTE MARITIME,5105,2403,173,2230,2011,t2,cantonales
5565,17,CHARENTE MARITIME,3881,2193,91,2102,2011,t2,cantonales
5566,17,CHARENTE MARITIME,8797,3863,261,3602,2011,t2,cantonales
5567,17,CHARENTE MARITIME,11025,5438,414,5024,2011,t2,cantonales
5568,17,CHARENTE MARITIME,5018,2811,130,2681,2011,t2,cantonales
5569,17,CHARENTE MARITIME,4912,2882,153,2729,2011,t2,cantonales
5570,17,CHARENTE MARITIME,10658,5820,256,5564,2011,t2,cantonales
5571,17,CHARENTE MARITIME,7201,2808,153,2655,2011,t2,cantonales
5572,17,CHARENTE MARITIME,6348,2408,179,2229,2011,t2,cantonales
5573,17,CHARENTE MARITIME,14839,6987,518,6469,2011,t2,cantonales
5574,17,CHARENTE MARITIME,5840,2684,151,2533,2011,t2,cantonales
5575,17,CHARENTE MARITIME,10990,5715,393,5322,2011,t2,cantonales
5576,17,CHARENTE MARITIME,10760,5139,404,4735,2011,t2,cantonales
5577,17,CHARENTE MARITIME,12157,5146,347,4799,2011,t2,cantonales
5578,17,CHARENTE MARITIME,13896,6686,393,6293,2011,t2,cantonales
5579,17,CHARENTE MARITIME,10878,5311,302,5009,2011,t2,cantonales
5580,17,CHARENTE MARITIME,2565,1566,62,1504,2011,t2,cantonales
5581,17,CHARENTE MARITIME,5483,1815,79,1736,2011,t2,cantonales
5582,17,CHARENTE MARITIME,8917,3883,155,3728,2011,t2,cantonales
5583,17,CHARENTE MARITIME,17327,7562,618,6944,2011,t2,cantonales
5584,17,CHARENTE MARITIME,13665,5631,324,5307,2011,t2,cantonales
5585,17,CHARENTE MARITIME,9884,3199,334,2865,2011,t2,cantonales
5586,18,CHER,7122,3577,184,3393,2011,t2,cantonales
5587,18,CHER,3229,1861,135,1726,2011,t2,cantonales
5588,18,CHER,10658,4802,535,4267,2011,t2,cantonales
5589,18,CHER,2176,1418,108,1310,2011,t2,cantonales
5590,18,CHER,2792,1566,84,1482,2011,t2,cantonales
5591,18,CHER,8263,3774,485,3289,2011,t2,cantonales
5592,18,CHER,3195,2005,142,1863,2011,t2,cantonales
5593,18,CHER,8461,4362,221,4141,2011,t2,cantonales
5594,18,CHER,3514,1813,132,1681,2011,t2,cantonales
5595,18,CHER,12512,5824,291,5533,2011,t2,cantonales
5596,18,CHER,4116,2297,148,2149,2011,t2,cantonales
5597,18,CHER,2900,1617,122,1495,2011,t2,cantonales
5598,18,CHER,11002,4438,331,4107,2011,t2,cantonales
5599,18,CHER,14888,5969,426,5543,2011,t2,cantonales
5600,18,CHER,10112,3707,215,3492,2011,t2,cantonales
5601,18,CHER,6742,2383,173,2210,2011,t2,cantonales
5602,19,CORREZE,5128,3710,106,3604,2011,t2,cantonales
5603,19,CORREZE,3267,2442,106,2336,2011,t2,cantonales
5604,19,CORREZE,2047,1601,109,1492,2011,t2,cantonales
5605,19,CORREZE,4326,2997,153,2844,2011,t2,cantonales
5606,19,CORREZE,9067,5458,183,5275,2011,t2,cantonales
5607,19,CORREZE,3098,2245,96,2149,2011,t2,cantonales
5608,19,CORREZE,2831,2282,51,2231,2011,t2,cantonales
5609,19,CORREZE,5061,2954,180,2774,2011,t2,cantonales
5610,19,CORREZE,5896,2416,106,2310,2011,t2,cantonales
5611,19,CORREZE,7214,2789,199,2590,2011,t2,cantonales
5612,19,CORREZE,11511,5914,440,5474,2011,t2,cantonales
5613,2A,CORSE SUD,6471,3183,289,2894,2011,t2,cantonales
5614,2A,CORSE SUD,2809,2129,52,2077,2011,t2,cantonales
5615,2A,CORSE SUD,2737,2031,78,1953,2011,t2,cantonales
5616,2A,CORSE SUD,10646,8012,278,7734,2011,t2,cantonales
5617,2A,CORSE SUD,4285,2294,124,2170,2011,t2,cantonales
5618,2A,CORSE SUD,3148,1900,87,1813,2011,t2,cantonales
5619,2A,CORSE SUD,4292,2920,92,2828,2011,t2,cantonales
5620,2B,HAUTE CORSE,3142,1878,129,1749,2011,t2,cantonales
5621,2B,HAUTE CORSE,3533,1640,200,1440,2011,t2,cantonales
5622,2B,HAUTE CORSE,2896,1936,122,1814,2011,t2,cantonales
5623,2B,HAUTE CORSE,4108,3436,79,3357,2011,t2,cantonales
5624,2B,HAUTE CORSE,5870,4621,88,4533,2011,t2,cantonales
5625,21,COTE D'OR,1360,881,65,816,2011,t2,cantonales
5626,21,COTE D'OR,9922,4381,537,3844,2011,t2,cantonales
5627,21,COTE D'OR,11385,4611,452,4159,2011,t2,cantonales
5628,21,COTE D'OR,10361,3925,259,3666,2011,t2,cantonales
5629,21,COTE D'OR,11354,5847,318,5529,2011,t2,cantonales
5630,21,COTE D'OR,9297,5176,218,4958,2011,t2,cantonales
5631,21,COTE D'OR,6331,3475,260,3215,2011,t2,cantonales
5632,21,COTE D'OR,8192,4511,340,4171,2011,t2,cantonales
5633,21,COTE D'OR,2138,1407,70,1337,2011,t2,cantonales
5634,21,COTE D'OR,11082,5142,302,4840,2011,t2,cantonales
5635,21,COTE D'OR,5749,3159,186,2973,2011,t2,cantonales
5636,21,COTE D'OR,7827,3943,220,3723,2011,t2,cantonales
5637,21,COTE D'OR,2867,1791,73,1718,2011,t2,cantonales
5638,21,COTE D'OR,16126,6813,365,6448,2011,t2,cantonales
5639,21,COTE D'OR,13385,6797,235,6562,2011,t2,cantonales
5640,21,COTE D'OR,23326,10867,395,10472,2011,t2,cantonales
5641,22,COTES D'ARMOR,3470,2097,146,1951,2011,t2,cantonales
5642,22,COTES D'ARMOR,6318,3736,175,3561,2011,t2,cantonales
5643,22,COTES D'ARMOR,6342,4341,96,4245,2011,t2,cantonales
5644,22,COTES D'ARMOR,2286,1787,33,1754,2011,t2,cantonales
5645,22,COTES D'ARMOR,19139,8427,649,7778,2011,t2,cantonales
5646,22,COTES D'ARMOR,11916,5820,348,5472,2011,t2,cantonales
5647,22,COTES D'ARMOR,4717,3012,113,2899,2011,t2,cantonales
5648,22,COTES D'ARMOR,15477,7791,387,7404,2011,t2,cantonales
5649,22,COTES D'ARMOR,22890,11549,417,11132,2011,t2,cantonales
5650,22,COTES D'ARMOR,4084,2588,148,2440,2011,t2,cantonales
5651,22,COTES D'ARMOR,8103,5042,211,4831,2011,t2,cantonales
5652,22,COTES D'ARMOR,7962,4182,281,3901,2011,t2,cantonales
5653,22,COTES D'ARMOR,5759,3326,134,3192,2011,t2,cantonales
5654,22,COTES D'ARMOR,6328,3772,295,3477,2011,t2,cantonales
5655,22,COTES D'ARMOR,17987,7778,650,7128,2011,t2,cantonales
5656,22,COTES D'ARMOR,15579,7869,428,7441,2011,t2,cantonales
5657,22,COTES D'ARMOR,11643,5070,239,4831,2011,t2,cantonales
5658,23,CREUSE,5103,2994,161,2833,2011,t2,cantonales
5659,23,CREUSE,4281,2304,146,2158,2011,t2,cantonales
5660,23,CREUSE,4401,2556,158,2398,2011,t2,cantonales
5661,23,CREUSE,3115,2199,95,2104,2011,t2,cantonales
5662,23,CREUSE,3240,1792,122,1670,2011,t2,cantonales
5663,23,CREUSE,1792,1124,71,1053,2011,t2,cantonales
5664,24,DORDOGNE,15084,7842,462,7380,2011,t2,cantonales
5665,24,DORDOGNE,3722,2545,99,2446,2011,t2,cantonales
5666,24,DORDOGNE,2999,1874,150,1724,2011,t2,cantonales
5667,24,DORDOGNE,3294,2782,94,2688,2011,t2,cantonales
5668,24,DORDOGNE,9265,5025,358,4667,2011,t2,cantonales
5669,24,DORDOGNE,7174,4567,239,4328,2011,t2,cantonales
5670,24,DORDOGNE,8185,4785,343,4442,2011,t2,cantonales
5671,24,DORDOGNE,6847,4438,364,4074,2011,t2,cantonales
5672,24,DORDOGNE,3138,2523,69,2454,2011,t2,cantonales
5673,24,DORDOGNE,12490,6864,413,6451,2011,t2,cantonales
5674,24,DORDOGNE,7262,4366,247,4119,2011,t2,cantonales
5675,24,DORDOGNE,7179,3807,303,3504,2011,t2,cantonales
5676,24,DORDOGNE,1877,1387,71,1316,2011,t2,cantonales
5677,24,DORDOGNE,12069,6511,545,5966,2011,t2,cantonales
5678,24,DORDOGNE,12283,5808,412,5396,2011,t2,cantonales
5679,24,DORDOGNE,15035,6610,781,5829,2011,t2,cantonales
5680,25,DOUBS,14668,5996,827,5169,2011,t2,cantonales
5681,25,DOUBS,13376,6554,331,6223,2011,t2,cantonales
5682,25,DOUBS,5584,3284,211,3073,2011,t2,cantonales
5683,25,DOUBS,22534,10832,720,10112,2011,t2,cantonales
5684,25,DOUBS,11047,6706,158,6548,2011,t2,cantonales
5685,25,DOUBS,6771,3934,238,3696,2011,t2,cantonales
5686,25,DOUBS,3249,2024,137,1887,2011,t2,cantonales
5687,25,DOUBS,6434,3727,267,3460,2011,t2,cantonales
5688,25,DOUBS,3563,2183,114,2069,2011,t2,cantonales
5689,25,DOUBS,8408,4690,284,4406,2011,t2,cantonales
5690,25,DOUBS,13083,5122,320,4802,2011,t2,cantonales
5691,25,DOUBS,12789,6698,507,6191,2011,t2,cantonales
5692,25,DOUBS,8765,3070,158,2912,2011,t2,cantonales
5693,25,DOUBS,9541,5002,385,4617,2011,t2,cantonales
5694,26,DROME,22045,9908,590,9318,2011,t2,cantonales
5695,26,DROME,16489,7237,437,6800,2011,t2,cantonales
5696,26,DROME,4986,2811,167,2644,2011,t2,cantonales
5697,26,DROME,6120,3599,273,3326,2011,t2,cantonales
5698,26,DROME,6151,3295,252,3043,2011,t2,cantonales
5699,26,DROME,14231,5821,423,5398,2011,t2,cantonales
5700,26,DROME,929,696,21,675,2011,t2,cantonales
5701,26,DROME,10330,5533,362,5171,2011,t2,cantonales
5702,26,DROME,13910,6525,514,6011,2011,t2,cantonales
5703,26,DROME,5257,3272,120,3152,2011,t2,cantonales
5704,26,DROME,15723,7227,371,6856,2011,t2,cantonales
5705,26,DROME,9546,4683,203,4480,2011,t2,cantonales
5706,26,DROME,17466,8182,419,7763,2011,t2,cantonales
5707,26,DROME,19186,8726,636,8090,2011,t2,cantonales
5708,26,DROME,8874,3801,244,3557,2011,t2,cantonales
5709,27,EURE,11510,5789,362,5427,2011,t2,cantonales
5710,27,EURE,13219,6243,715,5528,2011,t2,cantonales
5711,27,EURE,3872,2057,92,1965,2011,t2,cantonales
5712,27,EURE,9485,4427,301,4126,2011,t2,cantonales
5713,27,EURE,6596,3148,151,2997,2011,t2,cantonales
5714,27,EURE,8434,3795,212,3583,2011,t2,cantonales
5715,27,EURE,10318,5098,289,4809,2011,t2,cantonales
5716,27,EURE,6629,3438,195,3243,2011,t2,cantonales
5717,27,EURE,12041,5815,382,5433,2011,t2,cantonales
5718,27,EURE,5638,2460,219,2241,2011,t2,cantonales
5719,27,EURE,10614,5058,288,4770,2011,t2,cantonales
5720,27,EURE,7837,3753,355,3398,2011,t2,cantonales
5721,27,EURE,17920,7026,531,6495,2011,t2,cantonales
5722,27,EURE,7120,3168,160,3008,2011,t2,cantonales
5723,27,EURE,9733,3920,355,3565,2011,t2,cantonales
5724,27,EURE,8506,3263,175,3088,2011,t2,cantonales
5725,27,EURE,10655,5227,386,4841,2011,t2,cantonales
5726,27,EURE,13026,5405,419,4986,2011,t2,cantonales
5727,28,EURE ET LOIR,13694,6171,316,5855,2011,t2,cantonales
5728,28,EURE ET LOIR,15769,7341,525,6816,2011,t2,cantonales
5729,28,EURE ET LOIR,7255,3346,300,3046,2011,t2,cantonales
5730,28,EURE ET LOIR,7731,3597,208,3389,2011,t2,cantonales
5731,28,EURE ET LOIR,6569,3526,188,3338,2011,t2,cantonales
5732,28,EURE ET LOIR,22439,8891,630,8261,2011,t2,cantonales
5733,28,EURE ET LOIR,10970,4886,252,4634,2011,t2,cantonales
5734,28,EURE ET LOIR,22232,9358,700,8658,2011,t2,cantonales
5735,28,EURE ET LOIR,12513,4913,317,4596,2011,t2,cantonales
5736,28,EURE ET LOIR,13592,5600,303,5297,2011,t2,cantonales
5737,29,FINISTERE,4411,2456,122,2334,2011,t2,cantonales
5738,29,FINISTERE,7923,3245,370,2875,2011,t2,cantonales
5739,29,FINISTERE,12866,5199,296,4903,2011,t2,cantonales
5740,29,FINISTERE,8909,3108,178,2930,2011,t2,cantonales
5741,29,FINISTERE,12166,4175,887,3288,2011,t2,cantonales
5742,29,FINISTERE,22527,9266,587,8679,2011,t2,cantonales
5743,29,FINISTERE,14221,7306,437,6869,2011,t2,cantonales
5744,29,FINISTERE,21281,9846,467,9379,2011,t2,cantonales
5745,29,FINISTERE,22470,11046,559,10487,2011,t2,cantonales
5746,29,FINISTERE,10252,5329,354,4975,2011,t2,cantonales
5747,29,FINISTERE,13612,6408,336,6072,2011,t2,cantonales
5748,29,FINISTERE,14586,6810,258,6552,2011,t2,cantonales
5749,29,FINISTERE,6642,3645,143,3502,2011,t2,cantonales
5750,29,FINISTERE,13987,6970,222,6748,2011,t2,cantonales
5751,29,FINISTERE,14247,7799,388,7411,2011,t2,cantonales
5752,29,FINISTERE,15274,7442,469,6973,2011,t2,cantonales
5753,29,FINISTERE,10679,4487,753,3734,2011,t2,cantonales
5754,29,FINISTERE,15731,7555,170,7385,2011,t2,cantonales
5755,29,FINISTERE,14072,6000,268,5732,2011,t2,cantonales
5756,29,FINISTERE,11701,4728,203,4525,2011,t2,cantonales
5757,29,FINISTERE,9175,2974,217,2757,2011,t2,cantonales
5758,29,FINISTERE,15707,7602,437,7165,2011,t2,cantonales
5759,29,FINISTERE,9421,2824,168,2656,2011,t2,cantonales
5760,29,FINISTERE,14009,5144,358,4786,2011,t2,cantonales
5761,29,FINISTERE,9220,3192,189,3003,2011,t2,cantonales
5762,30,GARD,16131,9067,601,8466,2011,t2,cantonales
5763,30,GARD,15272,6880,458,6422,2011,t2,cantonales
5764,30,GARD,18889,8576,730,7846,2011,t2,cantonales
5765,30,GARD,3181,2363,74,2289,2011,t2,cantonales
5766,30,GARD,5222,1991,620,1371,2011,t2,cantonales
5767,30,GARD,14714,6335,423,5912,2011,t2,cantonales
5768,30,GARD,14806,7994,438,7556,2011,t2,cantonales
5769,30,GARD,16372,8492,557,7935,2011,t2,cantonales
5770,30,GARD,1090,837,33,804,2011,t2,cantonales
5771,30,GARD,10467,5819,334,5485,2011,t2,cantonales
5772,30,GARD,11643,6007,355,5652,2011,t2,cantonales
5773,30,GARD,19987,9855,646,9209,2011,t2,cantonales
5774,30,GARD,15333,8056,489,7567,2011,t2,cantonales
5775,30,GARD,14538,7774,423,7351,2011,t2,cantonales
5776,30,GARD,6689,3487,295,3192,2011,t2,cantonales
5777,30,GARD,6774,4356,197,4159,2011,t2,cantonales
5778,30,GARD,10023,3802,497,3305,2011,t2,cantonales
5779,30,GARD,9590,3890,480,3410,2011,t2,cantonales
5780,31,HAUTE GARONNE,5282,3046,267,2779,2011,t2,cantonales
5781,31,HAUTE GARONNE,4075,2953,225,2728,2011,t2,cantonales
5782,31,HAUTE GARONNE,29118,14684,907,13777,2011,t2,cantonales
5783,31,HAUTE GARONNE,4305,2693,129,2564,2011,t2,cantonales
5784,31,HAUTE GARONNE,28833,13875,901,12974,2011,t2,cantonales
5785,31,HAUTE GARONNE,3786,2887,117,2770,2011,t2,cantonales
5786,31,HAUTE GARONNE,6797,3571,326,3245,2011,t2,cantonales
5787,31,HAUTE GARONNE,12899,6444,376,6068,2011,t2,cantonales
5788,31,HAUTE GARONNE,33743,15941,938,15003,2011,t2,cantonales
5789,31,HAUTE GARONNE,10133,5679,241,5438,2011,t2,cantonales
5790,31,HAUTE GARONNE,6843,4015,230,3785,2011,t2,cantonales
5791,31,HAUTE GARONNE,16181,9423,441,8982,2011,t2,cantonales
5792,31,HAUTE GARONNE,2911,1822,141,1681,2011,t2,cantonales
5793,31,HAUTE GARONNE,17238,5819,279,5540,2011,t2,cantonales
5794,31,HAUTE GARONNE,23531,8440,458,7982,2011,t2,cantonales
5795,31,HAUTE GARONNE,19595,7036,365,6671,2011,t2,cantonales
5796,31,HAUTE GARONNE,18617,6093,408,5685,2011,t2,cantonales
5797,31,HAUTE GARONNE,23755,7784,500,7284,2011,t2,cantonales
5798,31,HAUTE GARONNE,28964,12006,1022,10984,2011,t2,cantonales
5799,31,HAUTE GARONNE,36280,15768,984,14784,2011,t2,cantonales
5800,31,HAUTE GARONNE,24571,11527,697,10830,2011,t2,cantonales
5801,31,HAUTE GARONNE,36135,17086,1121,15965,2011,t2,cantonales
5802,32,GERS,5341,2349,162,2187,2011,t2,cantonales
5803,32,GERS,8038,4356,608,3748,2011,t2,cantonales
5804,32,GERS,2820,1814,108,1706,2011,t2,cantonales
5805,32,GERS,4338,2770,212,2558,2011,t2,cantonales
5806,32,GERS,3527,2594,93,2501,2011,t2,cantonales
5807,32,GERS,3859,2501,106,2395,2011,t2,cantonales
5808,32,GERS,3307,2256,142,2114,2011,t2,cantonales
5809,32,GERS,7060,3187,336,2851,2011,t2,cantonales
5810,33,GIRONDE,45422,19956,1352,18604,2011,t2,cantonales
5811,33,GIRONDE,4127,2628,189,2439,2011,t2,cantonales
5812,33,GIRONDE,11122,5442,446,4996,2011,t2,cantonales
5813,33,GIRONDE,15324,5901,222,5679,2011,t2,cantonales
5814,33,GIRONDE,14314,5101,193,4908,2011,t2,cantonales
5815,33,GIRONDE,9382,4388,392,3996,2011,t2,cantonales
5816,33,GIRONDE,10392,5228,369,4859,2011,t2,cantonales
5817,33,GIRONDE,8974,4036,743,3293,2011,t2,cantonales
5818,33,GIRONDE,27156,11920,689,11231,2011,t2,cantonales
5819,33,GIRONDE,23452,11043,819,10224,2011,t2,cantonales
5820,33,GIRONDE,11325,5044,395,4649,2011,t2,cantonales
5821,33,GIRONDE,27338,12149,898,11251,2011,t2,cantonales
5822,33,GIRONDE,27466,12440,1100,11340,2011,t2,cantonales
5823,33,GIRONDE,8386,4321,267,4054,2011,t2,cantonales
5824,33,GIRONDE,18438,7035,325,6710,2011,t2,cantonales
5825,33,GIRONDE,5685,3373,206,3167,2011,t2,cantonales
5826,33,GIRONDE,7359,3970,212,3758,2011,t2,cantonales
5827,33,GIRONDE,6564,3297,261,3036,2011,t2,cantonales
5828,33,GIRONDE,4916,3287,120,3167,2011,t2,cantonales
5829,33,GIRONDE,16668,4453,1234,3219,2011,t2,cantonales
5830,33,GIRONDE,27609,10505,425,10080,2011,t2,cantonales
5831,33,GIRONDE,22654,9775,532,9243,2011,t2,cantonales
5832,33,GIRONDE,20349,8374,383,7991,2011,t2,cantonales
5833,33,GIRONDE,16514,6467,421,6046,2011,t2,cantonales
5834,33,GIRONDE,29141,11419,701,10718,2011,t2,cantonales
5835,34,HERAULT,14229,7254,507,6747,2011,t2,cantonales
5836,34,HERAULT,34223,15866,1172,14694,2011,t2,cantonales
5837,34,HERAULT,15238,7560,628,6932,2011,t2,cantonales
5838,34,HERAULT,8051,4660,380,4280,2011,t2,cantonales
5839,34,HERAULT,32529,16052,1131,14921,2011,t2,cantonales
5840,34,HERAULT,24836,12075,772,11303,2011,t2,cantonales
5841,34,HERAULT,27810,13311,944,12367,2011,t2,cantonales
5842,34,HERAULT,16898,5664,645,5019,2011,t2,cantonales
5843,34,HERAULT,11477,6148,393,5755,2011,t2,cantonales
5844,34,HERAULT,6003,3476,243,3233,2011,t2,cantonales
5845,34,HERAULT,10016,5303,334,4969,2011,t2,cantonales
5846,34,HERAULT,15493,8891,666,8225,2011,t2,cantonales
5847,34,HERAULT,21393,10341,632,9709,2011,t2,cantonales
5848,34,HERAULT,26656,12696,808,11888,2011,t2,cantonales
5849,34,HERAULT,9922,3956,298,3658,2011,t2,cantonales
5850,34,HERAULT,13935,4918,324,4594,2011,t2,cantonales
5851,34,HERAULT,12805,4626,432,4194,2011,t2,cantonales
5852,34,HERAULT,25582,10077,826,9251,2011,t2,cantonales
5853,34,HERAULT,18505,8202,565,7637,2011,t2,cantonales
5854,34,HERAULT,24780,11467,723,10744,2011,t2,cantonales
5855,34,HERAULT,22368,10406,908,9498,2011,t2,cantonales
5856,35,ILLE ET VILAINE,14413,6327,324,6003,2011,t2,cantonales
5857,35,ILLE ET VILAINE,13066,5618,386,5232,2011,t2,cantonales
5858,35,ILLE ET VILAINE,9589,4077,145,3932,2011,t2,cantonales
5859,35,ILLE ET VILAINE,10230,5253,314,4939,2011,t2,cantonales
5860,35,ILLE ET VILAINE,14064,6237,282,5955,2011,t2,cantonales
5861,35,ILLE ET VILAINE,3600,1985,122,1863,2011,t2,cantonales
5862,35,ILLE ET VILAINE,18014,7638,621,7017,2011,t2,cantonales
5863,35,ILLE ET VILAINE,6505,3672,167,3505,2011,t2,cantonales
5864,35,ILLE ET VILAINE,9747,4427,197,4230,2011,t2,cantonales
5865,35,ILLE ET VILAINE,5949,3452,388,3064,2011,t2,cantonales
5866,35,ILLE ET VILAINE,11457,5766,282,5484,2011,t2,cantonales
5867,35,ILLE ET VILAINE,10614,4039,154,3885,2011,t2,cantonales
5868,35,ILLE ET VILAINE,12643,4655,269,4386,2011,t2,cantonales
5869,35,ILLE ET VILAINE,13539,5323,259,5064,2011,t2,cantonales
5870,35,ILLE ET VILAINE,17589,7178,443,6735,2011,t2,cantonales
5871,35,ILLE ET VILAINE,18867,8052,349,7703,2011,t2,cantonales
5872,35,ILLE ET VILAINE,4458,1888,117,1771,2011,t2,cantonales
5873,35,ILLE ET VILAINE,10575,4341,223,4118,2011,t2,cantonales
5874,35,ILLE ET VILAINE,9705,3593,195,3398,2011,t2,cantonales
5875,35,ILLE ET VILAINE,25341,9712,904,8808,2011,t2,cantonales
5876,35,ILLE ET VILAINE,30364,11275,1057,10218,2011,t2,cantonales
5877,35,ILLE ET VILAINE,11201,4140,271,3869,2011,t2,cantonales
5878,35,ILLE ET VILAINE,17049,8031,335,7696,2011,t2,cantonales
5879,36,INDRE,9816,5388,288,5100,2011,t2,cantonales
5880,36,INDRE,2929,1814,187,1627,2011,t2,cantonales
5881,36,INDRE,3530,2516,87,2429,2011,t2,cantonales
5882,36,INDRE,9497,4714,244,4470,2011,t2,cantonales
5883,36,INDRE,3738,2398,94,2304,2011,t2,cantonales
5884,36,INDRE,12648,5408,318,5090,2011,t2,cantonales
5885,36,INDRE,10897,4537,363,4174,2011,t2,cantonales
5886,37,INDRE ET LOIRE,10255,4940,307,4633,2011,t2,cantonales
5887,37,INDRE ET LOIRE,17146,8410,620,7790,2011,t2,cantonales
5888,37,INDRE ET LOIRE,8973,4336,259,4077,2011,t2,cantonales
5889,37,INDRE ET LOIRE,7407,3564,227,3337,2011,t2,cantonales
5890,37,INDRE ET LOIRE,5682,3395,226,3169,2011,t2,cantonales
5891,37,INDRE ET LOIRE,17551,7979,365,7614,2011,t2,cantonales
5892,37,INDRE ET LOIRE,4287,2676,88,2588,2011,t2,cantonales
5893,37,INDRE ET LOIRE,4636,2437,136,2301,2011,t2,cantonales
5894,37,INDRE ET LOIRE,6460,3085,184,2901,2011,t2,cantonales
5895,37,INDRE ET LOIRE,11526,4791,186,4605,2011,t2,cantonales
5896,37,INDRE ET LOIRE,9745,4036,169,3867,2011,t2,cantonales
5897,37,INDRE ET LOIRE,10711,3423,206,3217,2011,t2,cantonales
5898,37,INDRE ET LOIRE,11326,3981,548,3433,2011,t2,cantonales
5899,37,INDRE ET LOIRE,10747,4328,335,3993,2011,t2,cantonales
5900,37,INDRE ET LOIRE,12036,4723,278,4445,2011,t2,cantonales
5901,37,INDRE ET LOIRE,16337,7705,427,7278,2011,t2,cantonales
5902,37,INDRE ET LOIRE,16152,7092,577,6515,2011,t2,cantonales
5903,38,ISERE,9342,3711,266,3445,2011,t2,cantonales
5904,38,ISERE,16234,6788,706,6082,2011,t2,cantonales
5905,38,ISERE,1755,1260,36,1224,2011,t2,cantonales
5906,38,ISERE,1927,1456,26,1430,2011,t2,cantonales
5907,38,ISERE,21438,9048,999,8049,2011,t2,cantonales
5908,38,ISERE,10758,4657,225,4432,2011,t2,cantonales
5909,38,ISERE,16855,5581,609,4972,2011,t2,cantonales
5910,38,ISERE,13251,4421,490,3931,2011,t2,cantonales
5911,38,ISERE,14960,6580,553,6027,2011,t2,cantonales
5912,38,ISERE,19234,7954,823,7131,2011,t2,cantonales
5913,38,ISERE,10638,4781,299,4482,2011,t2,cantonales
5914,38,ISERE,32882,14168,887,13281,2011,t2,cantonales
5915,38,ISERE,7048,2964,145,2819,2011,t2,cantonales
5916,38,ISERE,16383,8529,299,8230,2011,t2,cantonales
5917,38,ISERE,18161,7665,332,7333,2011,t2,cantonales
5918,38,ISERE,11976,5391,363,5028,2011,t2,cantonales
5919,38,ISERE,21822,9863,687,9176,2011,t2,cantonales
5920,38,ISERE,9469,4756,136,4620,2011,t2,cantonales
5921,38,ISERE,6528,3600,214,3386,2011,t2,cantonales
5922,38,ISERE,32451,13204,827,12377,2011,t2,cantonales
5923,38,ISERE,8132,3307,180,3127,2011,t2,cantonales
5924,38,ISERE,19020,6675,812,5863,2011,t2,cantonales
5925,38,ISERE,10598,4362,292,4070,2011,t2,cantonales
5926,38,ISERE,11407,3745,247,3498,2011,t2,cantonales
5927,39,JURA,4821,3016,151,2865,2011,t2,cantonales
5928,39,JURA,3549,1974,116,1858,2011,t2,cantonales
5929,39,JURA,4778,2630,169,2461,2011,t2,cantonales
5930,39,JURA,7650,4271,267,4004,2011,t2,cantonales
5931,39,JURA,4680,2520,155,2365,2011,t2,cantonales
5932,39,JURA,13471,6876,475,6401,2011,t2,cantonales
5933,39,JURA,10225,5109,289,4820,2011,t2,cantonales
5934,39,JURA,4223,2657,94,2563,2011,t2,cantonales
5935,39,JURA,2386,1550,160,1390,2011,t2,cantonales
5936,39,JURA,9929,4253,403,3850,2011,t2,cantonales
5937,39,JURA,2404,1725,57,1668,2011,t2,cantonales
5938,39,JURA,2604,1583,88,1495,2011,t2,cantonales
5939,40,LANDES,8459,5017,243,4774,2011,t2,cantonales
5940,40,LANDES,15861,6952,552,6400,2011,t2,cantonales
5941,40,LANDES,2854,2151,111,2040,2011,t2,cantonales
5942,40,LANDES,12938,5724,458,5266,2011,t2,cantonales
5943,40,LANDES,8686,5098,221,4877,2011,t2,cantonales
5944,40,LANDES,22628,9809,809,9000,2011,t2,cantonales
5945,40,LANDES,25029,11572,819,10753,2011,t2,cantonales
5946,41,LOIR ET CHER,9930,4462,355,4107,2011,t2,cantonales
5947,41,LOIR ET CHER,12936,5748,387,5361,2011,t2,cantonales
5948,41,LOIR ET CHER,4654,2567,127,2440,2011,t2,cantonales
5949,41,LOIR ET CHER,4626,2604,175,2429,2011,t2,cantonales
5950,41,LOIR ET CHER,7275,4088,325,3763,2011,t2,cantonales
5951,41,LOIR ET CHER,11804,6176,332,5844,2011,t2,cantonales
5952,41,LOIR ET CHER,4672,2245,138,2107,2011,t2,cantonales
5953,41,LOIR ET CHER,9416,4590,329,4261,2011,t2,cantonales
5954,41,LOIR ET CHER,10950,5030,340,4690,2011,t2,cantonales
5955,41,LOIR ET CHER,10218,4062,240,3822,2011,t2,cantonales
5956,41,LOIR ET CHER,5154,1713,70,1643,2011,t2,cantonales
5957,41,LOIR ET CHER,10987,5671,332,5339,2011,t2,cantonales
5958,41,LOIR ET CHER,6734,3149,217,2932,2011,t2,cantonales
5959,42,LOIRE,7569,3837,162,3675,2011,t2,cantonales
5960,42,LOIRE,18896,8162,410,7752,2011,t2,cantonales
5961,42,LOIRE,21372,9964,533,9431,2011,t2,cantonales
5962,42,LOIRE,3378,1882,70,1812,2011,t2,cantonales
5963,42,LOIRE,11635,5481,266,5215,2011,t2,cantonales
5964,42,LOIRE,17452,7616,829,6787,2011,t2,cantonales
5965,42,LOIRE,20139,8248,544,7704,2011,t2,cantonales
5966,42,LOIRE,6264,3318,224,3094,2011,t2,cantonales
5967,42,LOIRE,13509,5986,441,5545,2011,t2,cantonales
5968,42,LOIRE,12266,4441,268,4173,2011,t2,cantonales
5969,42,LOIRE,6478,3485,147,3338,2011,t2,cantonales
5970,42,LOIRE,3293,2009,121,1888,2011,t2,cantonales
5971,42,LOIRE,10111,4745,263,4482,2011,t2,cantonales
5972,42,LOIRE,21100,9742,480,9262,2011,t2,cantonales
5973,42,LOIRE,4007,2416,165,2251,2011,t2,cantonales
5974,42,LOIRE,13008,5159,272,4887,2011,t2,cantonales
5975,42,LOIRE,7087,2449,104,2345,2011,t2,cantonales
5976,42,LOIRE,10135,3901,259,3642,2011,t2,cantonales
5977,42,LOIRE,11042,4472,467,4005,2011,t2,cantonales
5978,43,HAUTE LOIRE,7276,3207,173,3034,2011,t2,cantonales
5979,43,HAUTE LOIRE,1827,1272,101,1171,2011,t2,cantonales
5980,43,HAUTE LOIRE,5769,2704,187,2517,2011,t2,cantonales
5981,43,HAUTE LOIRE,10365,5347,405,4942,2011,t2,cantonales
5982,43,HAUTE LOIRE,2625,1018,388,630,2011,t2,cantonales
5983,43,HAUTE LOIRE,5697,2813,260,2553,2011,t2,cantonales
5984,43,HAUTE LOIRE,7067,4005,170,3835,2011,t2,cantonales
5985,43,HAUTE LOIRE,8242,3857,242,3615,2011,t2,cantonales
5986,43,HAUTE LOIRE,5093,2144,123,2021,2011,t2,cantonales
5987,43,HAUTE LOIRE,6493,3123,249,2874,2011,t2,cantonales
5988,44,LOIRE ATLANTIQUE,17944,8283,388,7895,2011,t2,cantonales
5989,44,LOIRE ATLANTIQUE,13212,5544,542,5002,2011,t2,cantonales
5990,44,LOIRE ATLANTIQUE,30670,13043,620,12423,2011,t2,cantonales
5991,44,LOIRE ATLANTIQUE,16671,7644,305,7339,2011,t2,cantonales
5992,44,LOIRE ATLANTIQUE,10857,4669,223,4446,2011,t2,cantonales
5993,44,LOIRE ATLANTIQUE,17804,7506,659,6847,2011,t2,cantonales
5994,44,LOIRE ATLANTIQUE,17057,7029,254,6775,2011,t2,cantonales
5995,44,LOIRE ATLANTIQUE,17666,5098,528,4570,2011,t2,cantonales
5996,44,LOIRE ATLANTIQUE,15849,5156,330,4826,2011,t2,cantonales
5997,44,LOIRE ATLANTIQUE,13174,4546,189,4357,2011,t2,cantonales
5998,44,LOIRE ATLANTIQUE,18000,7837,429,7408,2011,t2,cantonales
5999,44,LOIRE ATLANTIQUE,13100,6423,235,6188,2011,t2,cantonales
6000,44,LOIRE ATLANTIQUE,22273,10643,637,10006,2011,t2,cantonales
6001,44,LOIRE ATLANTIQUE,5577,2783,218,2565,2011,t2,cantonales
6002,44,LOIRE ATLANTIQUE,3236,1635,55,1580,2011,t2,cantonales
6003,44,LOIRE ATLANTIQUE,26571,10134,986,9148,2011,t2,cantonales
6004,44,LOIRE ATLANTIQUE,14069,4190,347,3843,2011,t2,cantonales
6005,44,LOIRE ATLANTIQUE,14231,6600,305,6295,2011,t2,cantonales
6006,44,LOIRE ATLANTIQUE,16241,6675,1034,5641,2011,t2,cantonales
6007,44,LOIRE ATLANTIQUE,6388,3475,294,3181,2011,t2,cantonales
6008,44,LOIRE ATLANTIQUE,22202,10550,474,10076,2011,t2,cantonales
6009,44,LOIRE ATLANTIQUE,20335,7572,353,7219,2011,t2,cantonales
6010,44,LOIRE ATLANTIQUE,16723,5522,663,4859,2011,t2,cantonales
6011,44,LOIRE ATLANTIQUE,14924,4816,476,4340,2011,t2,cantonales
6012,44,LOIRE ATLANTIQUE,25494,11758,401,11357,2011,t2,cantonales
6013,44,LOIRE ATLANTIQUE,23911,8618,1530,7088,2011,t2,cantonales
6014,44,LOIRE ATLANTIQUE,11379,4084,182,3902,2011,t2,cantonales
6015,45,LOIRET,6280,2897,323,2574,2011,t2,cantonales
6016,45,LOIRET,8549,4193,354,3839,2011,t2,cantonales
6017,45,LOIRET,14515,6636,505,6131,2011,t2,cantonales
6018,45,LOIRET,7620,3756,277,3479,2011,t2,cantonales
6019,45,LOIRET,5627,2938,138,2800,2011,t2,cantonales
6020,45,LOIRET,13120,6017,392,5625,2011,t2,cantonales
6021,45,LOIRET,6608,3697,385,3312,2011,t2,cantonales
6022,45,LOIRET,7695,3345,282,3063,2011,t2,cantonales
6023,45,LOIRET,13883,5804,362,5442,2011,t2,cantonales
6024,45,LOIRET,8967,3176,450,2726,2011,t2,cantonales
6025,45,LOIRET,9087,3795,164,3631,2011,t2,cantonales
6026,45,LOIRET,10466,4586,301,4285,2011,t2,cantonales
6027,45,LOIRET,4234,2170,183,1987,2011,t2,cantonales
6028,45,LOIRET,15607,7357,440,6917,2011,t2,cantonales
6029,45,LOIRET,5015,2226,182,2044,2011,t2,cantonales
6030,45,LOIRET,8292,4239,286,3953,2011,t2,cantonales
6031,45,LOIRET,13881,6435,492,5943,2011,t2,cantonales
6032,45,LOIRET,13772,6126,512,5614,2011,t2,cantonales
6033,45,LOIRET,14779,6204,371,5833,2011,t2,cantonales
6034,45,LOIRET,13658,6204,338,5866,2011,t2,cantonales
6035,46,LOT,5350,2390,247,2143,2011,t2,cantonales
6036,46,LOT,7817,3681,344,3337,2011,t2,cantonales
6037,46,LOT,7771,3869,288,3581,2011,t2,cantonales
6038,46,LOT,5388,3315,225,3090,2011,t2,cantonales
6039,46,LOT,1816,1247,32,1215,2011,t2,cantonales
6040,46,LOT,5974,3832,267,3565,2011,t2,cantonales
6041,46,LOT,8539,4052,526,3526,2011,t2,cantonales
6042,47,LOT ET GARONNE,7173,3647,320,3327,2011,t2,cantonales
6043,47,LOT ET GARONNE,1964,1371,61,1310,2011,t2,cantonales
6044,47,LOT ET GARONNE,4425,2851,91,2760,2011,t2,cantonales
6045,47,LOT ET GARONNE,3860,2502,108,2394,2011,t2,cantonales
6046,47,LOT ET GARONNE,8120,5481,201,5280,2011,t2,cantonales
6047,47,LOT ET GARONNE,3197,2035,127,1908,2011,t2,cantonales
6048,47,LOT ET GARONNE,11412,5527,505,5022,2011,t2,cantonales
6049,47,LOT ET GARONNE,3024,2149,119,2030,2011,t2,cantonales
6050,47,LOT ET GARONNE,3408,2421,112,2309,2011,t2,cantonales
6051,47,LOT ET GARONNE,5966,3685,217,3468,2011,t2,cantonales
6052,47,LOT ET GARONNE,9925,5159,419,4740,2011,t2,cantonales
6053,47,LOT ET GARONNE,12032,5707,390,5317,2011,t2,cantonales
6054,47,LOT ET GARONNE,8733,4165,346,3819,2011,t2,cantonales
6055,47,LOT ET GARONNE,12500,6458,530,5928,2011,t2,cantonales
6056,47,LOT ET GARONNE,9736,4410,413,3997,2011,t2,cantonales
6057,48,LOZERE,2104,1619,41,1578,2011,t2,cantonales
6058,49,MAINE ET LOIRE,18919,6734,269,6465,2011,t2,cantonales
6059,49,MAINE ET LOIRE,7417,3385,201,3184,2011,t2,cantonales
6060,49,MAINE ET LOIRE,5308,2651,272,2379,2011,t2,cantonales
6061,49,MAINE ET LOIRE,29488,13162,731,12431,2011,t2,cantonales
6062,49,MAINE ET LOIRE,12161,5755,221,5534,2011,t2,cantonales
6063,49,MAINE ET LOIRE,8287,3752,214,3538,2011,t2,cantonales
6064,49,MAINE ET LOIRE,7879,3816,218,3598,2011,t2,cantonales
6065,49,MAINE ET LOIRE,21654,9998,621,9377,2011,t2,cantonales
6066,49,MAINE ET LOIRE,12371,5417,262,5155,2011,t2,cantonales
6067,49,MAINE ET LOIRE,18137,6759,260,6499,2011,t2,cantonales
6068,49,MAINE ET LOIRE,20696,8329,565,7764,2011,t2,cantonales
6069,49,MAINE ET LOIRE,14796,5544,249,5295,2011,t2,cantonales
6070,49,MAINE ET LOIRE,22232,8588,462,8126,2011,t2,cantonales
6071,50,MANCHE,6280,3046,81,2965,2011,t2,cantonales
6072,50,MANCHE,8839,4646,165,4481,2011,t2,cantonales
6073,50,MANCHE,9114,3786,421,3365,2011,t2,cantonales
6074,50,MANCHE,8519,3416,157,3259,2011,t2,cantonales
6075,50,MANCHE,8997,4414,194,4220,2011,t2,cantonales
6076,50,MANCHE,8571,4351,119,4232,2011,t2,cantonales
6077,50,MANCHE,6358,3276,151,3125,2011,t2,cantonales
6078,50,MANCHE,2329,1688,59,1629,2011,t2,cantonales
6079,50,MANCHE,3825,2341,53,2288,2011,t2,cantonales
6080,50,MANCHE,5090,3050,181,2869,2011,t2,cantonales
6081,50,MANCHE,4949,2246,111,2135,2011,t2,cantonales
6082,50,MANCHE,5947,3182,234,2948,2011,t2,cantonales
6083,50,MANCHE,6790,3155,149,3006,2011,t2,cantonales
6084,50,MANCHE,9447,4481,417,4064,2011,t2,cantonales
6085,50,MANCHE,10609,4609,275,4334,2011,t2,cantonales
6086,50,MANCHE,6318,3080,248,2832,2011,t2,cantonales
6087,50,MANCHE,7120,2342,108,2234,2011,t2,cantonales
6088,50,MANCHE,18441,6544,457,6087,2011,t2,cantonales
6089,50,MANCHE,9889,4717,329,4388,2011,t2,cantonales
6090,51,MARNE,7543,3407,237,3170,2011,t2,cantonales
6091,51,MARNE,7146,3161,250,2911,2011,t2,cantonales
6092,51,MARNE,5556,2482,189,2293,2011,t2,cantonales
6093,51,MARNE,8532,3264,325,2939,2011,t2,cantonales
6094,51,MARNE,4147,2164,155,2009,2011,t2,cantonales
6095,51,MARNE,3281,1581,172,1409,2011,t2,cantonales
6096,51,MARNE,18534,6637,263,6374,2011,t2,cantonales
6097,51,MARNE,8349,3155,221,2934,2011,t2,cantonales
6098,51,MARNE,6324,3405,267,3138,2011,t2,cantonales
6099,51,MARNE,7741,3336,270,3066,2011,t2,cantonales
6100,51,MARNE,8786,3640,259,3381,2011,t2,cantonales
6101,51,MARNE,8741,3941,193,3748,2011,t2,cantonales
6102,51,MARNE,10057,4678,381,4297,2011,t2,cantonales
6103,51,MARNE,9109,3814,295,3519,2011,t2,cantonales
6104,51,MARNE,10767,4051,403,3648,2011,t2,cantonales
6105,51,MARNE,14106,5698,436,5262,2011,t2,cantonales
6106,51,MARNE,13810,4748,308,4440,2011,t2,cantonales
6107,51,MARNE,9422,3850,272,3578,2011,t2,cantonales
6108,51,MARNE,13249,4261,215,4046,2011,t2,cantonales
6109,51,MARNE,11033,4043,371,3672,2011,t2,cantonales
6110,52,HAUTE MARNE,2192,1213,75,1138,2011,t2,cantonales
6111,52,HAUTE MARNE,1476,1046,24,1022,2011,t2,cantonales
6112,52,HAUTE MARNE,9532,3924,250,3674,2011,t2,cantonales
6113,52,HAUTE MARNE,2063,1155,104,1051,2011,t2,cantonales
6114,52,HAUTE MARNE,2512,1492,68,1424,2011,t2,cantonales
6115,52,HAUTE MARNE,9698,5050,361,4689,2011,t2,cantonales
6116,52,HAUTE MARNE,5557,3044,254,2790,2011,t2,cantonales
6117,52,HAUTE MARNE,4238,2301,211,2090,2011,t2,cantonales
6118,52,HAUTE MARNE,3057,1784,170,1614,2011,t2,cantonales
6119,52,HAUTE MARNE,8443,2956,223,2733,2011,t2,cantonales
6120,52,HAUTE MARNE,5838,2709,150,2559,2011,t2,cantonales
6121,52,HAUTE MARNE,4510,1958,42,1916,2011,t2,cantonales
6122,52,HAUTE MARNE,8027,3426,309,3117,2011,t2,cantonales
6123,53,MAYENNE,3989,2364,105,2259,2011,t2,cantonales
6124,53,MAYENNE,7082,3559,153,3406,2011,t2,cantonales
6125,53,MAYENNE,7800,3431,197,3234,2011,t2,cantonales
6126,53,MAYENNE,5345,3222,104,3118,2011,t2,cantonales
6127,53,MAYENNE,8111,3325,165,3160,2011,t2,cantonales
6128,53,MAYENNE,11698,5145,287,4858,2011,t2,cantonales
6129,53,MAYENNE,11720,5456,295,5161,2011,t2,cantonales
6130,53,MAYENNE,5941,2791,131,2660,2011,t2,cantonales
6131,53,MAYENNE,8630,3505,249,3256,2011,t2,cantonales
6132,53,MAYENNE,4500,1749,108,1641,2011,t2,cantonales
6133,53,MAYENNE,12504,5596,272,5324,2011,t2,cantonales
6134,54,MEURTHE ET MOSELLE,15225,3691,1025,2666,2011,t2,cantonales
6135,54,MEURTHE ET MOSELLE,4456,2635,171,2464,2011,t2,cantonales
6136,54,MEURTHE ET MOSELLE,14790,6738,336,6402,2011,t2,cantonales
6137,54,MEURTHE ET MOSELLE,6548,3539,278,3261,2011,t2,cantonales
6138,54,MEURTHE ET MOSELLE,9580,4230,337,3893,2011,t2,cantonales
6139,54,MEURTHE ET MOSELLE,12120,3793,182,3611,2011,t2,cantonales
6140,54,MEURTHE ET MOSELLE,12239,4343,214,4129,2011,t2,cantonales
6141,54,MEURTHE ET MOSELLE,12370,4306,166,4140,2011,t2,cantonales
6142,54,MEURTHE ET MOSELLE,7565,3562,295,3267,2011,t2,cantonales
6143,54,MEURTHE ET MOSELLE,13784,5864,501,5363,2011,t2,cantonales
6144,54,MEURTHE ET MOSELLE,20317,8840,654,8186,2011,t2,cantonales
6145,54,MEURTHE ET MOSELLE,10000,4688,339,4349,2011,t2,cantonales
6146,54,MEURTHE ET MOSELLE,12048,2838,376,2462,2011,t2,cantonales
6147,54,MEURTHE ET MOSELLE,11170,2583,645,1938,2011,t2,cantonales
6148,54,MEURTHE ET MOSELLE,17809,7530,483,7047,2011,t2,cantonales
6149,54,MEURTHE ET MOSELLE,17422,7991,662,7329,2011,t2,cantonales
6150,54,MEURTHE ET MOSELLE,13408,6237,319,5918,2011,t2,cantonales
6151,55,MEUSE,7785,3639,273,3366,2011,t2,cantonales
6152,55,MEUSE,8143,3558,243,3315,2011,t2,cantonales
6153,55,MEUSE,2471,1643,102,1541,2011,t2,cantonales
6154,55,MEUSE,3699,2164,153,2011,2011,t2,cantonales
6155,55,MEUSE,5602,3106,327,2779,2011,t2,cantonales
6156,55,MEUSE,2363,1415,129,1286,2011,t2,cantonales
6157,55,MEUSE,7046,2796,182,2614,2011,t2,cantonales
6158,56,MORBIHAN,5248,3292,99,3193,2011,t2,cantonales
6159,56,MORBIHAN,11559,5910,301,5609,2011,t2,cantonales
6160,56,MORBIHAN,14592,5571,521,5050,2011,t2,cantonales
6161,56,MORBIHAN,10779,5737,226,5511,2011,t2,cantonales
6162,56,MORBIHAN,15955,7998,386,7612,2011,t2,cantonales
6163,56,MORBIHAN,18886,8911,679,8232,2011,t2,cantonales
6164,56,MORBIHAN,22288,11517,586,10931,2011,t2,cantonales
6165,56,MORBIHAN,12304,6798,280,6518,2011,t2,cantonales
6166,56,MORBIHAN,15071,6729,293,6436,2011,t2,cantonales
6167,56,MORBIHAN,11861,5594,218,5376,2011,t2,cantonales
6168,56,MORBIHAN,7040,2723,593,2130,2011,t2,cantonales
6169,56,MORBIHAN,7893,4720,163,4557,2011,t2,cantonales
6170,56,MORBIHAN,12195,6780,351,6429,2011,t2,cantonales
6171,56,MORBIHAN,23689,10900,509,10391,2011,t2,cantonales
6172,56,MORBIHAN,16622,7618,336,7282,2011,t2,cantonales
6173,56,MORBIHAN,16402,6451,752,5699,2011,t2,cantonales
6174,56,MORBIHAN,23530,10142,732,9410,2011,t2,cantonales
6175,57,MOSELLE,9948,4706,366,4340,2011,t2,cantonales
6176,57,MOSELLE,15221,7020,427,6593,2011,t2,cantonales
6177,57,MOSELLE,17271,6246,383,5863,2011,t2,cantonales
6178,57,MOSELLE,4896,2575,194,2381,2011,t2,cantonales
6179,57,MOSELLE,4219,2249,159,2090,2011,t2,cantonales
6180,57,MOSELLE,16725,6313,330,5983,2011,t2,cantonales
6181,57,MOSELLE,13961,5071,260,4811,2011,t2,cantonales
6182,57,MOSELLE,16469,7652,647,7005,2011,t2,cantonales
6183,57,MOSELLE,12615,5056,430,4626,2011,t2,cantonales
6184,57,MOSELLE,15859,5751,461,5290,2011,t2,cantonales
6185,57,MOSELLE,21556,8624,695,7929,2011,t2,cantonales
6186,57,MOSELLE,19907,8848,601,8247,2011,t2,cantonales
6187,57,MOSELLE,15029,5371,428,4943,2011,t2,cantonales
6188,57,MOSELLE,23285,9686,1131,8555,2011,t2,cantonales
6189,57,MOSELLE,22056,8055,323,7732,2011,t2,cantonales
6190,57,MOSELLE,18690,7569,283,7286,2011,t2,cantonales
6191,57,MOSELLE,14301,5577,436,5141,2011,t2,cantonales
6192,57,MOSELLE,21636,9228,607,8621,2011,t2,cantonales
6193,57,MOSELLE,12732,2659,565,2094,2011,t2,cantonales
6194,57,MOSELLE,14026,5533,276,5257,2011,t2,cantonales
6195,57,MOSELLE,17708,8225,490,7735,2011,t2,cantonales
6196,57,MOSELLE,16015,6658,346,6312,2011,t2,cantonales
6197,57,MOSELLE,20612,8603,660,7943,2011,t2,cantonales
6198,57,MOSELLE,19523,7701,357,7344,2011,t2,cantonales
6199,58,NIEVRE,8117,3739,392,3347,2011,t2,cantonales
6200,58,NIEVRE,3880,2323,123,2200,2011,t2,cantonales
6201,58,NIEVRE,6208,2760,250,2510,2011,t2,cantonales
6202,58,NIEVRE,3357,1720,142,1578,2011,t2,cantonales
6203,58,NIEVRE,3364,1945,115,1830,2011,t2,cantonales
6204,58,NIEVRE,2694,1580,99,1481,2011,t2,cantonales
6205,58,NIEVRE,8912,3609,293,3316,2011,t2,cantonales
6206,58,NIEVRE,5860,2230,235,1995,2011,t2,cantonales
6207,58,NIEVRE,12510,5025,498,4527,2011,t2,cantonales
6208,58,NIEVRE,6030,2667,188,2479,2011,t2,cantonales
6209,59,NORD,38200,16827,1519,15308,2011,t2,cantonales
6210,59,NORD,6529,2890,211,2679,2011,t2,cantonales
6211,59,NORD,14184,6636,618,6018,2011,t2,cantonales
6212,59,NORD,14304,7674,508,7166,2011,t2,cantonales
6213,59,NORD,19108,8951,544,8407,2011,t2,cantonales
6214,59,NORD,16970,7287,627,6660,2011,t2,cantonales
6215,59,NORD,14290,7480,675,6805,2011,t2,cantonales
6216,59,NORD,7686,4644,212,4432,2011,t2,cantonales
6217,59,NORD,12137,6321,402,5919,2011,t2,cantonales
6218,59,NORD,30876,12391,880,11511,2011,t2,cantonales
6219,59,NORD,21385,10260,1105,9155,2011,t2,cantonales
6220,59,NORD,36278,10914,3113,7801,2011,t2,cantonales
6221,59,NORD,28666,13508,965,12543,2011,t2,cantonales
6222,59,NORD,18508,8519,550,7969,2011,t2,cantonales
6223,59,NORD,8198,4643,287,4356,2011,t2,cantonales
6224,59,NORD,48783,20729,1468,19261,2011,t2,cantonales
6225,59,NORD,18399,7200,417,6783,2011,t2,cantonales
6226,59,NORD,29928,11703,938,10765,2011,t2,cantonales
6227,59,NORD,30821,13148,1128,12020,2011,t2,cantonales
6228,59,NORD,20942,6908,412,6496,2011,t2,cantonales
6229,59,NORD,24050,10123,630,9493,2011,t2,cantonales
6230,59,NORD,29035,13106,971,12135,2011,t2,cantonales
6231,59,NORD,8947,4207,230,3977,2011,t2,cantonales
6232,59,NORD,19750,6875,360,6515,2011,t2,cantonales
6233,59,NORD,23700,9444,505,8939,2011,t2,cantonales
6234,59,NORD,12782,4602,1146,3456,2011,t2,cantonales
6235,59,NORD,6598,2996,248,2748,2011,t2,cantonales
6236,59,NORD,45432,16592,1238,15354,2011,t2,cantonales
6237,59,NORD,34958,11244,828,10416,2011,t2,cantonales
6238,59,NORD,35408,13672,795,12877,2011,t2,cantonales
6239,59,NORD,22402,9012,522,8490,2011,t2,cantonales
6240,59,NORD,33563,15621,1209,14412,2011,t2,cantonales
6241,59,NORD,23123,9813,414,9399,2011,t2,cantonales
6242,59,NORD,20342,7064,589,6475,2011,t2,cantonales
6243,59,NORD,20162,8266,536,7730,2011,t2,cantonales
6244,59,NORD,22673,10059,553,9506,2011,t2,cantonales
6245,59,NORD,24765,10683,751,9932,2011,t2,cantonales
6246,60,OISE,10503,4476,276,4200,2011,t2,cantonales
6247,60,OISE,14634,6675,590,6085,2011,t2,cantonales
6248,60,OISE,12594,5792,644,5148,2011,t2,cantonales
6249,60,OISE,17131,7105,324,6781,2011,t2,cantonales
6250,60,OISE,21248,10014,868,9146,2011,t2,cantonales
6251,60,OISE,5678,3138,301,2837,2011,t2,cantonales
6252,60,OISE,4988,3151,218,2933,2011,t2,cantonales
6253,60,OISE,5494,2227,435,1792,2011,t2,cantonales
6254,60,OISE,6634,3529,227,3302,2011,t2,cantonales
6255,60,OISE,6166,3515,264,3251,2011,t2,cantonales
6256,60,OISE,10374,5066,335,4731,2011,t2,cantonales
6257,60,OISE,15250,7229,933,6296,2011,t2,cantonales
6258,60,OISE,15183,7541,556,6985,2011,t2,cantonales
6259,60,OISE,19184,7707,524,7183,2011,t2,cantonales
6260,60,OISE,12955,6738,401,6337,2011,t2,cantonales
6261,60,OISE,23422,9695,1101,8594,2011,t2,cantonales
6262,60,OISE,26610,10160,994,9166,2011,t2,cantonales
6263,61,ORNE,4637,2066,142,1924,2011,t2,cantonales
6264,61,ORNE,3562,2121,146,1975,2011,t2,cantonales
6265,61,ORNE,3933,2263,205,2058,2011,t2,cantonales
6266,61,ORNE,8109,3837,201,3636,2011,t2,cantonales
6267,61,ORNE,9752,4368,248,4120,2011,t2,cantonales
6268,61,ORNE,5407,2772,93,2679,2011,t2,cantonales
6269,61,ORNE,5373,2806,170,2636,2011,t2,cantonales
6270,61,ORNE,6301,3027,210,2817,2011,t2,cantonales
6271,61,ORNE,9457,4214,274,3940,2011,t2,cantonales
6272,61,ORNE,6954,3184,206,2978,2011,t2,cantonales
6273,62,PAS DE CALAIS,15039,8841,554,8287,2011,t2,cantonales
6274,62,PAS DE CALAIS,13727,6278,530,5748,2011,t2,cantonales
6275,62,PAS DE CALAIS,23074,11797,1307,10490,2011,t2,cantonales
6276,62,PAS DE CALAIS,18795,9714,643,9071,2011,t2,cantonales
6277,62,PAS DE CALAIS,6957,4085,372,3713,2011,t2,cantonales
6278,62,PAS DE CALAIS,9578,5650,630,5020,2011,t2,cantonales
6279,62,PAS DE CALAIS,17290,7748,662,7086,2011,t2,cantonales
6280,62,PAS DE CALAIS,20718,9527,674,8853,2011,t2,cantonales
6281,62,PAS DE CALAIS,20857,9027,940,8087,2011,t2,cantonales
6282,62,PAS DE CALAIS,14874,7017,415,6602,2011,t2,cantonales
6283,62,PAS DE CALAIS,8517,5605,347,5258,2011,t2,cantonales
6284,62,PAS DE CALAIS,18006,7937,535,7402,2011,t2,cantonales
6285,62,PAS DE CALAIS,11382,6786,614,6172,2011,t2,cantonales
6286,62,PAS DE CALAIS,15135,6410,534,5876,2011,t2,cantonales
6287,62,PAS DE CALAIS,15261,4139,971,3168,2011,t2,cantonales
6288,62,PAS DE CALAIS,17109,8719,828,7891,2011,t2,cantonales
6289,62,PAS DE CALAIS,5754,3245,285,2960,2011,t2,cantonales
6290,62,PAS DE CALAIS,11350,6413,458,5955,2011,t2,cantonales
6291,62,PAS DE CALAIS,18248,9861,1050,8811,2011,t2,cantonales
6292,62,PAS DE CALAIS,21601,10414,680,9734,2011,t2,cantonales
6293,62,PAS DE CALAIS,15508,6194,450,5744,2011,t2,cantonales
6294,62,PAS DE CALAIS,15812,6985,302,6683,2011,t2,cantonales
6295,62,PAS DE CALAIS,14867,6835,394,6441,2011,t2,cantonales
6296,62,PAS DE CALAIS,17773,8366,609,7757,2011,t2,cantonales
6297,62,PAS DE CALAIS,13656,6167,418,5749,2011,t2,cantonales
6298,62,PAS DE CALAIS,18060,8139,530,7609,2011,t2,cantonales
6299,62,PAS DE CALAIS,13853,6135,437,5698,2011,t2,cantonales
6300,62,PAS DE CALAIS,13623,5530,452,5078,2011,t2,cantonales
6301,62,PAS DE CALAIS,14657,6034,553,5481,2011,t2,cantonales
6302,62,PAS DE CALAIS,14897,6734,262,6472,2011,t2,cantonales
6303,62,PAS DE CALAIS,18584,9925,650,9275,2011,t2,cantonales
6304,62,PAS DE CALAIS,16170,7107,634,6473,2011,t2,cantonales
6305,62,PAS DE CALAIS,14790,6803,475,6328,2011,t2,cantonales
6306,62,PAS DE CALAIS,14079,6391,267,6124,2011,t2,cantonales
6307,62,PAS DE CALAIS,13308,5500,337,5163,2011,t2,cantonales
6308,63,PUY DE DOME,8594,4412,205,4207,2011,t2,cantonales
6309,63,PUY DE DOME,7616,3974,368,3606,2011,t2,cantonales
6310,63,PUY DE DOME,5306,2181,521,1660,2011,t2,cantonales
6311,63,PUY DE DOME,9563,3961,231,3730,2011,t2,cantonales
6312,63,PUY DE DOME,1978,1273,74,1199,2011,t2,cantonales
6313,63,PUY DE DOME,15887,7662,600,7062,2011,t2,cantonales
6314,63,PUY DE DOME,10646,5926,281,5645,2011,t2,cantonales
6315,63,PUY DE DOME,7963,4028,423,3605,2011,t2,cantonales
6316,63,PUY DE DOME,6552,3796,168,3628,2011,t2,cantonales
6317,63,PUY DE DOME,2206,1629,65,1564,2011,t2,cantonales
6318,63,PUY DE DOME,16227,6781,458,6323,2011,t2,cantonales
6319,63,PUY DE DOME,13597,6489,514,5975,2011,t2,cantonales
6320,63,PUY DE DOME,6795,3415,527,2888,2011,t2,cantonales
6321,63,PUY DE DOME,9783,2975,689,2286,2011,t2,cantonales
6322,63,PUY DE DOME,18900,8467,407,8060,2011,t2,cantonales
6323,63,PUY DE DOME,10489,4665,287,4378,2011,t2,cantonales
6324,63,PUY DE DOME,9796,3984,244,3740,2011,t2,cantonales
6325,63,PUY DE DOME,5917,2124,204,1920,2011,t2,cantonales
6326,63,PUY DE DOME,7353,2724,177,2547,2011,t2,cantonales
6327,63,PUY DE DOME,15731,6315,537,5778,2011,t2,cantonales
6328,63,PUY DE DOME,12837,5833,411,5422,2011,t2,cantonales
6329,64,PYRENEES ATLANTIQUES,2843,2401,60,2341,2011,t2,cantonales
6330,64,PYRENEES ATLANTIQUES,7446,2948,154,2794,2011,t2,cantonales
6331,64,PYRENEES ATLANTIQUES,12970,4732,680,4052,2011,t2,cantonales
6332,64,PYRENEES ATLANTIQUES,3600,2787,66,2721,2011,t2,cantonales
6333,64,PYRENEES ATLANTIQUES,5170,2904,202,2702,2011,t2,cantonales
6334,64,PYRENEES ATLANTIQUES,2436,1751,105,1646,2011,t2,cantonales
6335,64,PYRENEES ATLANTIQUES,25494,12638,935,11703,2011,t2,cantonales
6336,64,PYRENEES ATLANTIQUES,12555,6602,422,6180,2011,t2,cantonales
6337,64,PYRENEES ATLANTIQUES,9751,5798,323,5475,2011,t2,cantonales
6338,64,PYRENEES ATLANTIQUES,13038,5092,379,4713,2011,t2,cantonales
6339,64,PYRENEES ATLANTIQUES,5346,3802,304,3498,2011,t2,cantonales
6340,64,PYRENEES ATLANTIQUES,2886,2147,89,2058,2011,t2,cantonales
6341,64,PYRENEES ATLANTIQUES,12776,6235,256,5979,2011,t2,cantonales
6342,64,PYRENEES ATLANTIQUES,12789,5308,318,4990,2011,t2,cantonales
6343,64,PYRENEES ATLANTIQUES,10450,3643,249,3394,2011,t2,cantonales
6344,64,PYRENEES ATLANTIQUES,15486,8415,335,8080,2011,t2,cantonales
6345,64,PYRENEES ATLANTIQUES,10844,5228,282,4946,2011,t2,cantonales
6346,64,PYRENEES ATLANTIQUES,10554,4740,447,4293,2011,t2,cantonales
6347,65,HAUTES PYRENEES,2996,1939,120,1819,2011,t2,cantonales
6348,65,HAUTES PYRENEES,3844,2224,130,2094,2011,t2,cantonales
6349,65,HAUTES PYRENEES,7995,3931,378,3553,2011,t2,cantonales
6350,65,HAUTES PYRENEES,5925,2648,145,2503,2011,t2,cantonales
6351,65,HAUTES PYRENEES,6793,2803,197,2606,2011,t2,cantonales
6352,65,HAUTES PYRENEES,5193,2332,156,2176,2011,t2,cantonales
6353,65,HAUTES PYRENEES,9109,5082,516,4566,2011,t2,cantonales
6354,66,PYRENEES ORIENTALES,21635,12344,817,11527,2011,t2,cantonales
6355,66,PYRENEES ORIENTALES,3695,2038,141,1897,2011,t2,cantonales
6356,66,PYRENEES ORIENTALES,7601,3604,284,3320,2011,t2,cantonales
6357,66,PYRENEES ORIENTALES,5561,2660,229,2431,2011,t2,cantonales
6358,66,PYRENEES ORIENTALES,10259,6322,378,5944,2011,t2,cantonales
6359,66,PYRENEES ORIENTALES,2129,1498,80,1418,2011,t2,cantonales
6360,66,PYRENEES ORIENTALES,18286,9396,764,8632,2011,t2,cantonales
6361,66,PYRENEES ORIENTALES,18578,10277,876,9401,2011,t2,cantonales
6362,66,PYRENEES ORIENTALES,16154,8521,774,7747,2011,t2,cantonales
6363,66,PYRENEES ORIENTALES,10582,6411,363,6048,2011,t2,cantonales
6364,66,PYRENEES ORIENTALES,12187,5732,292,5440,2011,t2,cantonales
6365,66,PYRENEES ORIENTALES,14661,6824,768,6056,2011,t2,cantonales
6366,66,PYRENEES ORIENTALES,8147,3648,194,3454,2011,t2,cantonales
6367,66,PYRENEES ORIENTALES,17943,9214,919,8295,2011,t2,cantonales
6368,67,BAS RHIN,24801,10394,590,9804,2011,t2,cantonales
6369,67,BAS RHIN,9638,4577,428,4149,2011,t2,cantonales
6370,67,BAS RHIN,21490,8867,552,8315,2011,t2,cantonales
6371,67,BAS RHIN,15858,7011,417,6594,2011,t2,cantonales
6372,67,BAS RHIN,11453,4849,370,4479,2011,t2,cantonales
6373,67,BAS RHIN,17636,7445,593,6852,2011,t2,cantonales
6374,67,BAS RHIN,16955,6512,470,6042,2011,t2,cantonales
6375,67,BAS RHIN,10400,5133,238,4895,2011,t2,cantonales
6376,67,BAS RHIN,22603,10063,1013,9050,2011,t2,cantonales
6377,67,BAS RHIN,9969,3006,209,2797,2011,t2,cantonales
6378,67,BAS RHIN,17714,8275,460,7815,2011,t2,cantonales
6379,67,BAS RHIN,8900,4552,354,4198,2011,t2,cantonales
6380,67,BAS RHIN,17199,7367,709,6658,2011,t2,cantonales
6381,67,BAS RHIN,13044,6284,425,5859,2011,t2,cantonales
6382,67,BAS RHIN,20374,6857,329,6528,2011,t2,cantonales
6383,67,BAS RHIN,13586,5001,222,4779,2011,t2,cantonales
6384,67,BAS RHIN,14751,5482,304,5178,2011,t2,cantonales
6385,67,BAS RHIN,15207,5388,321,5067,2011,t2,cantonales
6386,67,BAS RHIN,11538,4135,242,3893,2011,t2,cantonales
6387,67,BAS RHIN,37023,14107,844,13263,2011,t2,cantonales
6388,67,BAS RHIN,35016,13759,1181,12578,2011,t2,cantonales
6389,68,HAUT RHIN,18511,7459,484,6975,2011,t2,cantonales
6390,68,HAUT RHIN,19045,8620,729,7891,2011,t2,cantonales
6391,68,HAUT RHIN,20004,9282,802,8480,2011,t2,cantonales
6392,68,HAUT RHIN,15213,6804,745,6059,2011,t2,cantonales
6393,68,HAUT RHIN,25212,8942,570,8372,2011,t2,cantonales
6394,68,HAUT RHIN,32272,12227,735,11492,2011,t2,cantonales
6395,68,HAUT RHIN,12998,6975,172,6803,2011,t2,cantonales
6396,68,HAUT RHIN,17169,6809,525,6284,2011,t2,cantonales
6397,68,HAUT RHIN,9111,4833,220,4613,2011,t2,cantonales
6398,68,HAUT RHIN,12993,5985,405,5580,2011,t2,cantonales
6399,68,HAUT RHIN,7159,3380,163,3217,2011,t2,cantonales
6400,68,HAUT RHIN,15584,7007,722,6285,2011,t2,cantonales
6401,69,RHONE,17795,7696,555,7141,2011,t2,cantonales
6402,69,RHONE,27151,11639,692,10947,2011,t2,cantonales
6403,69,RHONE,9414,4157,328,3829,2011,t2,cantonales
6404,69,RHONE,11804,5338,278,5060,2011,t2,cantonales
6405,69,RHONE,24424,10072,781,9291,2011,t2,cantonales
6406,69,RHONE,24362,8128,1122,7006,2011,t2,cantonales
6407,69,RHONE,30457,11274,500,10774,2011,t2,cantonales
6408,69,RHONE,16300,5495,623,4872,2011,t2,cantonales
6409,69,RHONE,16729,6229,260,5969,2011,t2,cantonales
6410,69,RHONE,19433,7204,261,6943,2011,t2,cantonales
6411,69,RHONE,21312,7458,432,7026,2011,t2,cantonales
6412,69,RHONE,9303,5342,193,5149,2011,t2,cantonales
6413,69,RHONE,35287,14873,658,14215,2011,t2,cantonales
6414,69,RHONE,23175,8906,514,8392,2011,t2,cantonales
6415,69,RHONE,24682,8855,580,8275,2011,t2,cantonales
6416,69,RHONE,36789,14738,1232,13506,2011,t2,cantonales
6417,69,RHONE,21362,8465,534,7931,2011,t2,cantonales
6418,69,RHONE,16258,6667,318,6349,2011,t2,cantonales
6419,69,RHONE,24691,10356,552,9804,2011,t2,cantonales
6420,69,RHONE,19673,6124,331,5793,2011,t2,cantonales
6421,69,RHONE,26913,8152,922,7230,2011,t2,cantonales
6422,69,RHONE,18158,7229,302,6927,2011,t2,cantonales
6423,69,RHONE,21865,8586,560,8026,2011,t2,cantonales
6424,69,RHONE,19334,5663,748,4915,2011,t2,cantonales
6425,69,RHONE,19389,6586,428,6158,2011,t2,cantonales
6426,70,HAUTE SAONE,9483,4634,392,4242,2011,t2,cantonales
6427,70,HAUTE SAONE,2270,1512,127,1385,2011,t2,cantonales
6428,70,HAUTE SAONE,3432,2297,77,2220,2011,t2,cantonales
6429,70,HAUTE SAONE,7268,3946,280,3666,2011,t2,cantonales
6430,70,HAUTE SAONE,4655,2807,170,2637,2011,t2,cantonales
6431,70,HAUTE SAONE,5073,2522,158,2364,2011,t2,cantonales
6432,70,HAUTE SAONE,4498,2844,268,2576,2011,t2,cantonales
6433,70,HAUTE SAONE,12927,6766,489,6277,2011,t2,cantonales
6434,70,HAUTE SAONE,7700,3580,676,2904,2011,t2,cantonales
6435,70,HAUTE SAONE,6791,3503,309,3194,2011,t2,cantonales
6436,71,SAONE ET LOIRE,7436,3784,385,3399,2011,t2,cantonales
6437,71,SAONE ET LOIRE,3569,2020,149,1871,2011,t2,cantonales
6438,71,SAONE ET LOIRE,18277,8411,799,7612,2011,t2,cantonales
6439,71,SAONE ET LOIRE,7126,3776,306,3470,2011,t2,cantonales
6440,71,SAONE ET LOIRE,5482,2639,140,2499,2011,t2,cantonales
6441,71,SAONE ET LOIRE,7824,4245,232,4013,2011,t2,cantonales
6442,71,SAONE ET LOIRE,9713,4838,344,4494,2011,t2,cantonales
6443,71,SAONE ET LOIRE,6563,3031,177,2854,2011,t2,cantonales
6444,71,SAONE ET LOIRE,9768,4014,268,3746,2011,t2,cantonales
6445,71,SAONE ET LOIRE,4962,2668,287,2381,2011,t2,cantonales
6446,71,SAONE ET LOIRE,2896,1835,92,1743,2011,t2,cantonales
6447,71,SAONE ET LOIRE,11897,4315,342,3973,2011,t2,cantonales
6448,71,SAONE ET LOIRE,11362,5177,282,4895,2011,t2,cantonales
6449,71,SAONE ET LOIRE,4884,2951,117,2834,2011,t2,cantonales
6450,71,SAONE ET LOIRE,6475,3149,166,2983,2011,t2,cantonales
6451,71,SAONE ET LOIRE,7125,3986,237,3749,2011,t2,cantonales
6452,71,SAONE ET LOIRE,13267,5299,416,4883,2011,t2,cantonales
6453,71,SAONE ET LOIRE,11385,4722,285,4437,2011,t2,cantonales
6454,72,SARTHE,6179,3564,224,3340,2011,t2,cantonales
6455,72,SARTHE,5406,3220,129,3091,2011,t2,cantonales
6456,72,SARTHE,7746,4399,219,4180,2011,t2,cantonales
6457,72,SARTHE,4173,2650,98,2552,2011,t2,cantonales
6458,72,SARTHE,7692,3924,220,3704,2011,t2,cantonales
6459,72,SARTHE,8935,4498,256,4242,2011,t2,cantonales
6460,72,SARTHE,12952,4979,253,4726,2011,t2,cantonales
6461,72,SARTHE,15435,7967,382,7585,2011,t2,cantonales
6462,72,SARTHE,18706,7878,533,7345,2011,t2,cantonales
6463,72,SARTHE,7691,4043,215,3828,2011,t2,cantonales
6464,72,SARTHE,8631,3926,192,3734,2011,t2,cantonales
6465,72,SARTHE,5652,2760,162,2598,2011,t2,cantonales
6466,72,SARTHE,23678,9815,570,9245,2011,t2,cantonales
6467,72,SARTHE,16123,6566,488,6078,2011,t2,cantonales
6468,72,SARTHE,22344,10344,709,9635,2011,t2,cantonales
6469,72,SARTHE,14492,6617,356,6261,2011,t2,cantonales
6470,72,SARTHE,12788,5692,420,5272,2011,t2,cantonales
6471,73,SAVOIE,11938,4529,566,3963,2011,t2,cantonales
6472,73,SAVOIE,10135,4259,272,3987,2011,t2,cantonales
6473,73,SAVOIE,11438,4764,362,4402,2011,t2,cantonales
6474,73,SAVOIE,8657,3442,256,3186,2011,t2,cantonales
6475,73,SAVOIE,5917,3084,142,2942,2011,t2,cantonales
6476,73,SAVOIE,3900,2206,72,2134,2011,t2,cantonales
6477,73,SAVOIE,2511,1611,61,1550,2011,t2,cantonales
6478,73,SAVOIE,10515,4681,289,4392,2011,t2,cantonales
6479,73,SAVOIE,7066,3183,360,2823,2011,t2,cantonales
6480,73,SAVOIE,5251,3013,107,2906,2011,t2,cantonales
6481,73,SAVOIE,12822,5475,382,5093,2011,t2,cantonales
6482,73,SAVOIE,9699,3482,200,3282,2011,t2,cantonales
6483,73,SAVOIE,12018,5003,461,4542,2011,t2,cantonales
6484,73,SAVOIE,15217,6607,339,6268,2011,t2,cantonales
6485,73,SAVOIE,12970,5223,381,4842,2011,t2,cantonales
6486,74,HAUTE SAVOIE,3985,2558,99,2459,2011,t2,cantonales
6487,74,HAUTE SAVOIE,8748,3870,234,3636,2011,t2,cantonales
6488,74,HAUTE SAVOIE,11043,3693,201,3492,2011,t2,cantonales
6489,74,HAUTE SAVOIE,22201,7516,415,7101,2011,t2,cantonales
6490,74,HAUTE SAVOIE,14257,5871,325,5546,2011,t2,cantonales
6491,74,HAUTE SAVOIE,16468,5769,539,5230,2011,t2,cantonales
6492,74,HAUTE SAVOIE,10214,4626,272,4354,2011,t2,cantonales
6493,74,HAUTE SAVOIE,5661,2546,119,2427,2011,t2,cantonales
6494,74,HAUTE SAVOIE,12740,5335,276,5059,2011,t2,cantonales
6495,74,HAUTE SAVOIE,15407,6695,615,6080,2011,t2,cantonales
6496,74,HAUTE SAVOIE,13237,5355,589,4766,2011,t2,cantonales
6497,74,HAUTE SAVOIE,21052,7354,464,6890,2011,t2,cantonales
6498,74,HAUTE SAVOIE,3683,2142,134,2008,2011,t2,cantonales
6499,74,HAUTE SAVOIE,31931,11989,771,11218,2011,t2,cantonales
6500,74,HAUTE SAVOIE,30497,12197,595,11602,2011,t2,cantonales
6501,74,HAUTE SAVOIE,24915,9518,662,8856,2011,t2,cantonales
6502,76,SEINE MARITIME,5323,2939,171,2768,2011,t2,cantonales
6503,76,SEINE MARITIME,8689,4504,258,4246,2011,t2,cantonales
6504,76,SEINE MARITIME,5665,2842,202,2640,2011,t2,cantonales
6505,76,SEINE MARITIME,7960,4481,278,4203,2011,t2,cantonales
6506,76,SEINE MARITIME,7115,4289,285,4004,2011,t2,cantonales
6507,76,SEINE MARITIME,11929,6519,351,6168,2011,t2,cantonales
6508,76,SEINE MARITIME,19598,9427,823,8604,2011,t2,cantonales
6509,76,SEINE MARITIME,13797,4402,1215,3187,2011,t2,cantonales
6510,76,SEINE MARITIME,19507,9998,759,9239,2011,t2,cantonales
6511,76,SEINE MARITIME,6384,3662,166,3496,2011,t2,cantonales
6512,76,SEINE MARITIME,21400,9554,429,9125,2011,t2,cantonales
6513,76,SEINE MARITIME,20469,7014,1674,5340,2011,t2,cantonales
6514,76,SEINE MARITIME,15097,5318,492,4826,2011,t2,cantonales
6515,76,SEINE MARITIME,10057,3549,243,3306,2011,t2,cantonales
6516,76,SEINE MARITIME,20933,9234,535,8699,2011,t2,cantonales
6517,76,SEINE MARITIME,6061,3204,216,2988,2011,t2,cantonales
6518,76,SEINE MARITIME,16564,7551,397,7154,2011,t2,cantonales
6519,76,SEINE MARITIME,22756,10904,799,10105,2011,t2,cantonales
6520,76,SEINE MARITIME,5747,2434,187,2247,2011,t2,cantonales
6521,76,SEINE MARITIME,7595,3005,185,2820,2011,t2,cantonales
6522,76,SEINE MARITIME,12087,5070,378,4692,2011,t2,cantonales
6523,76,SEINE MARITIME,7309,3537,207,3330,2011,t2,cantonales
6524,76,SEINE MARITIME,9403,5015,278,4737,2011,t2,cantonales
6525,76,SEINE MARITIME,8490,4462,234,4228,2011,t2,cantonales
6526,76,SEINE MARITIME,12733,2873,837,2036,2011,t2,cantonales
6527,76,SEINE MARITIME,13776,6151,242,5909,2011,t2,cantonales
6528,76,SEINE MARITIME,20526,8774,452,8322,2011,t2,cantonales
6529,76,SEINE MARITIME,7170,2818,343,2475,2011,t2,cantonales
6530,76,SEINE MARITIME,14787,6695,289,6406,2011,t2,cantonales
6531,76,SEINE MARITIME,13804,5989,383,5606,2011,t2,cantonales
6532,77,SEINE ET MARNE,10888,4736,345,4391,2011,t2,cantonales
6533,77,SEINE ET MARNE,17629,8194,731,7463,2011,t2,cantonales
6534,77,SEINE ET MARNE,19287,7227,683,6544,2011,t2,cantonales
6535,77,SEINE ET MARNE,10892,5731,109,5622,2011,t2,cantonales
6536,77,SEINE ET MARNE,24791,9815,1149,8666,2011,t2,cantonales
6537,77,SEINE ET MARNE,11779,4886,672,4214,2011,t2,cantonales
6538,77,SEINE ET MARNE,20274,8894,715,8179,2011,t2,cantonales
6539,77,SEINE ET MARNE,24256,10065,770,9295,2011,t2,cantonales
6540,77,SEINE ET MARNE,15454,6835,501,6334,2011,t2,cantonales
6541,77,SEINE ET MARNE,20074,8371,474,7897,2011,t2,cantonales
6542,77,SEINE ET MARNE,13301,5543,373,5170,2011,t2,cantonales
6543,77,SEINE ET MARNE,9381,4177,369,3808,2011,t2,cantonales
6544,77,SEINE ET MARNE,16742,7191,643,6548,2011,t2,cantonales
6545,77,SEINE ET MARNE,16521,6940,444,6496,2011,t2,cantonales
6546,77,SEINE ET MARNE,5690,2891,255,2636,2011,t2,cantonales
6547,77,SEINE ET MARNE,27678,11042,499,10543,2011,t2,cantonales
6548,77,SEINE ET MARNE,30380,11049,701,10348,2011,t2,cantonales
6549,77,SEINE ET MARNE,20537,7998,444,7554,2011,t2,cantonales
6550,77,SEINE ET MARNE,18849,7386,435,6951,2011,t2,cantonales
6551,77,SEINE ET MARNE,20241,8124,532,7592,2011,t2,cantonales
6552,77,SEINE ET MARNE,30579,11498,834,10664,2011,t2,cantonales
6553,77,SEINE ET MARNE,23801,9928,487,9441,2011,t2,cantonales
6554,77,SEINE ET MARNE,31241,11737,794,10943,2011,t2,cantonales
6555,78,YVELINES,21395,7994,824,7170,2011,t2,cantonales
6556,78,YVELINES,20513,7156,273,6883,2011,t2,cantonales
6557,78,YVELINES,23591,10225,678,9547,2011,t2,cantonales
6558,78,YVELINES,13776,5793,419,5374,2011,t2,cantonales
6559,78,YVELINES,18343,8190,675,7515,2011,t2,cantonales
6560,78,YVELINES,27909,11316,895,10421,2011,t2,cantonales
6561,78,YVELINES,20433,8248,374,7874,2011,t2,cantonales
6562,78,YVELINES,31527,14185,648,13537,2011,t2,cantonales
6563,78,YVELINES,14138,5308,292,5016,2011,t2,cantonales
6564,78,YVELINES,15948,7315,429,6886,2011,t2,cantonales
6565,78,YVELINES,18564,5542,594,4948,2011,t2,cantonales
6566,78,YVELINES,28521,10317,354,9963,2011,t2,cantonales
6567,78,YVELINES,19091,6629,719,5910,2011,t2,cantonales
6568,78,YVELINES,27426,9829,808,9021,2011,t2,cantonales
6569,78,YVELINES,22016,8585,308,8277,2011,t2,cantonales
6570,78,YVELINES,23137,8614,558,8056,2011,t2,cantonales
6571,78,YVELINES,16970,6273,341,5932,2011,t2,cantonales
6572,78,YVELINES,26326,10508,616,9892,2011,t2,cantonales
6573,78,YVELINES,30580,11722,625,11097,2011,t2,cantonales
6574,78,YVELINES,16465,6799,286,6513,2011,t2,cantonales
6575,79,DEUX SEVRES,8565,3651,161,3490,2011,t2,cantonales
6576,79,DEUX SEVRES,4274,2236,122,2114,2011,t2,cantonales
6577,79,DEUX SEVRES,3682,2407,177,2230,2011,t2,cantonales
6578,79,DEUX SEVRES,17520,6260,303,5957,2011,t2,cantonales
6579,79,DEUX SEVRES,10770,4154,227,3927,2011,t2,cantonales
6580,79,DEUX SEVRES,6926,3453,165,3288,2011,t2,cantonales
6581,79,DEUX SEVRES,8563,3606,155,3451,2011,t2,cantonales
6582,79,DEUX SEVRES,12549,4329,332,3997,2011,t2,cantonales
6583,80,SOMME,13023,6058,512,5546,2011,t2,cantonales
6584,80,SOMME,13294,7346,412,6934,2011,t2,cantonales
6585,80,SOMME,15955,6345,624,5721,2011,t2,cantonales
6586,80,SOMME,8505,5029,302,4727,2011,t2,cantonales
6587,80,SOMME,3228,2010,92,1918,2011,t2,cantonales
6588,80,SOMME,7145,4231,325,3906,2011,t2,cantonales
6589,80,SOMME,15837,8486,462,8024,2011,t2,cantonales
6590,80,SOMME,9932,5051,418,4633,2011,t2,cantonales
6591,80,SOMME,9669,5618,722,4896,2011,t2,cantonales
6592,80,SOMME,9062,5087,170,4917,2011,t2,cantonales
6593,80,SOMME,7473,4283,421,3862,2011,t2,cantonales
6594,80,SOMME,6052,3432,68,3364,2011,t2,cantonales
6595,80,SOMME,5922,3481,131,3350,2011,t2,cantonales
6596,80,SOMME,9628,5328,135,5193,2011,t2,cantonales
6597,80,SOMME,9942,5119,484,4635,2011,t2,cantonales
6598,80,SOMME,14556,5839,205,5634,2011,t2,cantonales
6599,80,SOMME,10209,4549,254,4295,2011,t2,cantonales
6600,80,SOMME,11373,4434,262,4172,2011,t2,cantonales
6601,80,SOMME,9514,5591,294,5297,2011,t2,cantonales
6602,81,TARN,7223,3625,236,3389,2011,t2,cantonales
6603,81,TARN,3051,2044,106,1938,2011,t2,cantonales
6604,81,TARN,12150,6379,546,5833,2011,t2,cantonales
6605,81,TARN,9797,5288,416,4872,2011,t2,cantonales
6606,81,TARN,3715,2339,155,2184,2011,t2,cantonales
6607,81,TARN,4311,2617,127,2490,2011,t2,cantonales
6608,81,TARN,10782,5576,484,5092,2011,t2,cantonales
6609,81,TARN,7125,4316,241,4075,2011,t2,cantonales
6610,81,TARN,9292,3704,931,2773,2011,t2,cantonales
6611,81,TARN,9654,4437,514,3923,2011,t2,cantonales
6612,81,TARN,9202,4906,375,4531,2011,t2,cantonales
6613,81,TARN,7345,3854,348,3506,2011,t2,cantonales
6614,82,TARN ET GARONNE,5002,3405,130,3275,2011,t2,cantonales
6615,82,TARN ET GARONNE,4766,2292,140,2152,2011,t2,cantonales
6616,82,TARN ET GARONNE,10718,6372,365,6007,2011,t2,cantonales
6617,82,TARN ET GARONNE,11109,5092,844,4248,2011,t2,cantonales
6618,82,TARN ET GARONNE,4000,2329,177,2152,2011,t2,cantonales
6619,82,TARN ET GARONNE,3662,2568,84,2484,2011,t2,cantonales
6620,82,TARN ET GARONNE,2900,1887,77,1810,2011,t2,cantonales
6621,82,TARN ET GARONNE,1834,1241,88,1153,2011,t2,cantonales
6622,82,TARN ET GARONNE,7573,3796,277,3519,2011,t2,cantonales
6623,82,TARN ET GARONNE,3997,1770,679,1091,2011,t2,cantonales
6624,82,TARN ET GARONNE,5775,2968,209,2759,2011,t2,cantonales
6625,82,TARN ET GARONNE,6985,3259,239,3020,2011,t2,cantonales
6626,83,VAR,11045,5570,502,5068,2011,t2,cantonales
6627,83,VAR,19805,9557,748,8809,2011,t2,cantonales
6628,83,VAR,37922,17564,1402,16162,2011,t2,cantonales
6629,83,VAR,17652,7394,608,6786,2011,t2,cantonales
6630,83,VAR,14280,7338,598,6740,2011,t2,cantonales
6631,83,VAR,16419,7953,867,7086,2011,t2,cantonales
6632,83,VAR,33614,13974,1133,12841,2011,t2,cantonales
6633,83,VAR,10351,5150,234,4916,2011,t2,cantonales
6634,83,VAR,24658,11553,755,10798,2011,t2,cantonales
6635,83,VAR,18087,7330,355,6975,2011,t2,cantonales
6636,83,VAR,24494,9779,645,9134,2011,t2,cantonales
6637,83,VAR,4467,2483,184,2299,2011,t2,cantonales
6638,83,VAR,15021,5710,415,5295,2011,t2,cantonales
6639,83,VAR,6224,1878,109,1769,2011,t2,cantonales
6640,83,VAR,9362,3385,259,3126,2011,t2,cantonales
6641,83,VAR,21235,10851,909,9942,2011,t2,cantonales
6642,83,VAR,28963,13110,913,12197,2011,t2,cantonales
6643,83,VAR,28687,12573,1118,11455,2011,t2,cantonales
6644,83,VAR,19852,8561,829,7732,2011,t2,cantonales
6645,83,VAR,27614,11483,1480,10003,2011,t2,cantonales
6646,83,VAR,19929,8479,682,7797,2011,t2,cantonales
6647,84,VAUCLUSE,15089,7798,496,7302,2011,t2,cantonales
6648,84,VAUCLUSE,11446,5266,394,4872,2011,t2,cantonales
6649,84,VAUCLUSE,26200,12975,1022,11953,2011,t2,cantonales
6650,84,VAUCLUSE,3731,2158,145,2013,2011,t2,cantonales
6651,84,VAUCLUSE,14048,6499,383,6116,2011,t2,cantonales
6652,84,VAUCLUSE,21003,10531,654,9877,2011,t2,cantonales
6653,84,VAUCLUSE,30725,15692,1160,14532,2011,t2,cantonales
6654,84,VAUCLUSE,3948,2755,141,2614,2011,t2,cantonales
6655,84,VAUCLUSE,7679,4510,231,4279,2011,t2,cantonales
6656,84,VAUCLUSE,20138,9512,690,8822,2011,t2,cantonales
6657,84,VAUCLUSE,23120,10625,645,9980,2011,t2,cantonales
6658,85,VENDEE,7610,3587,257,3330,2011,t2,cantonales
6659,85,VENDEE,6211,3577,162,3415,2011,t2,cantonales
6660,85,VENDEE,23663,9496,507,8989,2011,t2,cantonales
6661,85,VENDEE,15672,6704,299,6405,2011,t2,cantonales
6662,85,VENDEE,4284,2066,58,2008,2011,t2,cantonales
6663,85,VENDEE,8666,5114,131,4983,2011,t2,cantonales
6664,85,VENDEE,22825,9333,529,8804,2011,t2,cantonales
6665,85,VENDEE,38344,16174,970,15204,2011,t2,cantonales
6666,85,VENDEE,6323,3267,194,3073,2011,t2,cantonales
6667,85,VENDEE,15077,7642,698,6944,2011,t2,cantonales
6668,86,VIENNE,8702,4894,233,4661,2011,t2,cantonales
6669,86,VIENNE,6494,3838,115,3723,2011,t2,cantonales
6670,86,VIENNE,5956,3222,217,3005,2011,t2,cantonales
6671,86,VIENNE,9346,4378,355,4023,2011,t2,cantonales
6672,86,VIENNE,8193,3982,207,3775,2011,t2,cantonales
6673,86,VIENNE,3672,2552,124,2428,2011,t2,cantonales
6674,86,VIENNE,12369,5300,378,4922,2011,t2,cantonales
6675,86,VIENNE,5331,2935,173,2762,2011,t2,cantonales
6676,86,VIENNE,10071,4806,303,4503,2011,t2,cantonales
6677,86,VIENNE,10632,4569,338,4231,2011,t2,cantonales
6678,86,VIENNE,11203,4896,205,4691,2011,t2,cantonales
6679,86,VIENNE,10828,4181,322,3859,2011,t2,cantonales
6680,87,HAUTE VIENNE,14808,7659,586,7073,2011,t2,cantonales
6681,87,HAUTE VIENNE,12570,5915,1037,4878,2011,t2,cantonales
6682,87,HAUTE VIENNE,5347,3175,203,2972,2011,t2,cantonales
6683,87,HAUTE VIENNE,3248,1984,132,1852,2011,t2,cantonales
6684,87,HAUTE VIENNE,4785,2039,200,1839,2011,t2,cantonales
6685,87,HAUTE VIENNE,5265,2175,128,2047,2011,t2,cantonales
6686,87,HAUTE VIENNE,2745,1822,106,1716,2011,t2,cantonales
6687,87,HAUTE VIENNE,5947,3165,421,2744,2011,t2,cantonales
6688,87,HAUTE VIENNE,5178,3212,199,3013,2011,t2,cantonales
6689,87,HAUTE VIENNE,8769,4388,456,3932,2011,t2,cantonales
6690,87,HAUTE VIENNE,3723,1591,349,1242,2011,t2,cantonales
6691,87,HAUTE VIENNE,7798,3025,751,2274,2011,t2,cantonales
6692,87,HAUTE VIENNE,8354,3506,228,3278,2011,t2,cantonales
6693,87,HAUTE VIENNE,9698,4921,442,4479,2011,t2,cantonales
6694,87,HAUTE VIENNE,8382,4145,381,3764,2011,t2,cantonales
6695,87,HAUTE VIENNE,16524,7454,767,6687,2011,t2,cantonales
6696,87,HAUTE VIENNE,5623,2297,219,2078,2011,t2,cantonales
6697,87,HAUTE VIENNE,6781,2930,255,2675,2011,t2,cantonales
6698,88,VOSGES,11585,5961,471,5490,2011,t2,cantonales
6699,88,VOSGES,15146,6768,738,6030,2011,t2,cantonales
6700,88,VOSGES,5186,2850,187,2663,2011,t2,cantonales
6701,88,VOSGES,4624,2866,259,2607,2011,t2,cantonales
6702,88,VOSGES,18653,7860,648,7212,2011,t2,cantonales
6703,88,VOSGES,9587,4799,349,4450,2011,t2,cantonales
6704,88,VOSGES,8676,4994,354,4640,2011,t2,cantonales
6705,88,VOSGES,9967,5689,266,5423,2011,t2,cantonales
6706,88,VOSGES,14104,7005,665,6340,2011,t2,cantonales
6707,88,VOSGES,12143,6267,519,5748,2011,t2,cantonales
6708,89,YONNE,10152,4255,293,3962,2011,t2,cantonales
6709,89,YONNE,8671,4632,275,4357,2011,t2,cantonales
6710,89,YONNE,3674,2151,157,1994,2011,t2,cantonales
6711,89,YONNE,4701,2772,270,2502,2011,t2,cantonales
6712,89,YONNE,2394,1510,103,1407,2011,t2,cantonales
6713,89,YONNE,3785,1883,143,1740,2011,t2,cantonales
6714,89,YONNE,11529,5466,358,5108,2011,t2,cantonales
6715,89,YONNE,1901,1165,89,1076,2011,t2,cantonales
6716,89,YONNE,4981,2297,236,2061,2011,t2,cantonales
6717,89,YONNE,8535,3688,283,3405,2011,t2,cantonales
6718,89,YONNE,8790,3425,258,3167,2011,t2,cantonales
6719,89,YONNE,5757,2899,203,2696,2011,t2,cantonales
6720,89,YONNE,3703,2196,124,2072,2011,t2,cantonales
6721,89,YONNE,6558,2821,158,2663,2011,t2,cantonales
6722,89,YONNE,11331,4377,492,3885,2011,t2,cantonales
6723,89,YONNE,8212,3863,367,3496,2011,t2,cantonales
6724,89,YONNE,8744,3787,304,3483,2011,t2,cantonales
6725,90,TERRITOIRE DE BELFORT,5627,2499,194,2305,2011,t2,cantonales
6726,90,TERRITOIRE DE BELFORT,7479,3921,283,3638,2011,t2,cantonales
6727,90,TERRITOIRE DE BELFORT,7500,2902,387,2515,2011,t2,cantonales
6728,90,TERRITOIRE DE BELFORT,4802,2153,190,1963,2011,t2,cantonales
6729,90,TERRITOIRE DE BELFORT,4243,1778,166,1612,2011,t2,cantonales
6730,90,TERRITOIRE DE BELFORT,7738,4148,424,3724,2011,t2,cantonales
6731,90,TERRITOIRE DE BELFORT,7777,4105,329,3776,2011,t2,cantonales
6732,90,TERRITOIRE DE BELFORT,4445,2389,233,2156,2011,t2,cantonales
6733,91,ESSONNE,26852,12296,865,11431,2011,t2,cantonales
6734,91,ESSONNE,21619,9326,559,8767,2011,t2,cantonales
6735,91,ESSONNE,13164,4718,252,4466,2011,t2,cantonales
6736,91,ESSONNE,11092,5131,339,4792,2011,t2,cantonales
6737,91,ESSONNE,14878,6640,482,6158,2011,t2,cantonales
6738,91,ESSONNE,24365,9614,644,8970,2011,t2,cantonales
6739,91,ESSONNE,13334,5862,250,5612,2011,t2,cantonales
6740,91,ESSONNE,10630,4822,450,4372,2011,t2,cantonales
6741,91,ESSONNE,10417,4584,283,4301,2011,t2,cantonales
6742,91,ESSONNE,25424,10162,681,9481,2011,t2,cantonales
6743,91,ESSONNE,17294,8314,313,8001,2011,t2,cantonales
6744,91,ESSONNE,20930,9034,611,8423,2011,t2,cantonales
6745,91,ESSONNE,23133,10143,626,9517,2011,t2,cantonales
6746,91,ESSONNE,18154,7755,1234,6521,2011,t2,cantonales
6747,91,ESSONNE,16452,7610,197,7413,2011,t2,cantonales
6748,91,ESSONNE,16445,6769,509,6260,2011,t2,cantonales
6749,91,ESSONNE,15955,6675,455,6220,2011,t2,cantonales
6750,91,ESSONNE,17687,7340,480,6860,2011,t2,cantonales
6751,91,ESSONNE,11187,2898,779,2119,2011,t2,cantonales
6752,91,ESSONNE,13941,6191,479,5712,2011,t2,cantonales
6753,91,ESSONNE,11052,4822,261,4561,2011,t2,cantonales
6754,92,HAUTS DE SEINE,22926,8481,507,7974,2011,t2,cantonales
6755,92,HAUTS DE SEINE,21651,7401,474,6927,2011,t2,cantonales
6756,92,HAUTS DE SEINE,22882,11282,412,10870,2011,t2,cantonales
6757,92,HAUTS DE SEINE,20909,9558,384,9174,2011,t2,cantonales
6758,92,HAUTS DE SEINE,26792,11150,657,10493,2011,t2,cantonales
6759,92,HAUTS DE SEINE,12899,4779,256,4523,2011,t2,cantonales
6760,92,HAUTS DE SEINE,29513,11206,691,10515,2011,t2,cantonales
6761,92,HAUTS DE SEINE,17045,6823,346,6477,2011,t2,cantonales
6762,92,HAUTS DE SEINE,11040,4544,143,4401,2011,t2,cantonales
6763,92,HAUTS DE SEINE,19095,7908,443,7465,2011,t2,cantonales
6764,92,HAUTS DE SEINE,26772,11380,689,10691,2011,t2,cantonales
6765,92,HAUTS DE SEINE,19536,8582,455,8127,2011,t2,cantonales
6766,92,HAUTS DE SEINE,25505,11323,381,10942,2011,t2,cantonales
6767,92,HAUTS DE SEINE,26490,11785,380,11405,2011,t2,cantonales
6768,92,HAUTS DE SEINE,9963,2719,466,2253,2011,t2,cantonales
6769,92,HAUTS DE SEINE,20398,7829,256,7573,2011,t2,cantonales
6770,92,HAUTS DE SEINE,30502,15425,584,14841,2011,t2,cantonales
6771,92,HAUTS DE SEINE,28117,13614,925,12689,2011,t2,cantonales
6772,92,HAUTS DE SEINE,35525,12533,1263,11270,2011,t2,cantonales
6773,92,HAUTS DE SEINE,19033,7716,684,7032,2011,t2,cantonales
6774,92,HAUTS DE SEINE,16615,7159,580,6579,2011,t2,cantonales
6775,92,HAUTS DE SEINE,17286,8584,283,8301,2011,t2,cantonales
6776,92,HAUTS DE SEINE,16043,7398,357,7041,2011,t2,cantonales
6777,92,HAUTS DE SEINE,16308,6662,459,6203,2011,t2,cantonales
6778,93,SEINE SAINT-DENIS,15162,4872,431,4441,2011,t2,cantonales
6779,93,SEINE SAINT-DENIS,26520,9344,451,8893,2011,t2,cantonales
6780,93,SEINE SAINT-DENIS,14056,4025,577,3448,2011,t2,cantonales
6781,93,SEINE SAINT-DENIS,19593,7406,574,6832,2011,t2,cantonales
6782,93,SEINE SAINT-DENIS,23602,7795,313,7482,2011,t2,cantonales
6783,93,SEINE SAINT-DENIS,21903,8343,428,7915,2011,t2,cantonales
6784,93,SEINE SAINT-DENIS,20239,7056,355,6701,2011,t2,cantonales
6785,93,SEINE SAINT-DENIS,17296,5775,559,5216,2011,t2,cantonales
6786,93,SEINE SAINT-DENIS,38605,14636,1026,13610,2011,t2,cantonales
6787,93,SEINE SAINT-DENIS,11216,4309,171,4138,2011,t2,cantonales
6788,93,SEINE SAINT-DENIS,21916,7761,454,7307,2011,t2,cantonales
6789,93,SEINE SAINT-DENIS,20091,8149,311,7838,2011,t2,cantonales
6790,93,SEINE SAINT-DENIS,12693,4381,281,4100,2011,t2,cantonales
6791,93,SEINE SAINT-DENIS,22083,8045,568,7477,2011,t2,cantonales
6792,93,SEINE SAINT-DENIS,12228,3598,326,3272,2011,t2,cantonales
6793,93,SEINE SAINT-DENIS,12479,4395,223,4172,2011,t2,cantonales
6794,93,SEINE SAINT-DENIS,22010,7927,469,7458,2011,t2,cantonales
6795,93,SEINE SAINT-DENIS,10310,4242,226,4016,2011,t2,cantonales
6796,93,SEINE SAINT-DENIS,16640,3947,828,3119,2011,t2,cantonales
6797,93,SEINE SAINT-DENIS,18216,6866,284,6582,2011,t2,cantonales
6798,94,VAL DE MARNE,8840,3756,213,3543,2011,t2,cantonales
6799,94,VAL DE MARNE,15782,4631,1308,3323,2011,t2,cantonales
6800,94,VAL DE MARNE,27601,10493,461,10032,2011,t2,cantonales
6801,94,VAL DE MARNE,9736,3462,294,3168,2011,t2,cantonales
6802,94,VAL DE MARNE,18533,7949,551,7398,2011,t2,cantonales
6803,94,VAL DE MARNE,15752,5237,484,4753,2011,t2,cantonales
6804,94,VAL DE MARNE,13140,3809,530,3279,2011,t2,cantonales
6805,94,VAL DE MARNE,14056,4308,355,3953,2011,t2,cantonales
6806,94,VAL DE MARNE,16741,6961,254,6707,2011,t2,cantonales
6807,94,VAL DE MARNE,17899,7054,423,6631,2011,t2,cantonales
6808,94,VAL DE MARNE,21441,7765,516,7249,2011,t2,cantonales
6809,94,VAL DE MARNE,21840,7764,359,7405,2011,t2,cantonales
6810,94,VAL DE MARNE,20214,7790,1024,6766,2011,t2,cantonales
6811,94,VAL DE MARNE,16193,6854,330,6524,2011,t2,cantonales
6812,94,VAL DE MARNE,12483,3486,899,2587,2011,t2,cantonales
6813,94,VAL DE MARNE,9894,3740,191,3549,2011,t2,cantonales
6814,94,VAL DE MARNE,15339,4003,933,3070,2011,t2,cantonales
6815,94,VAL DE MARNE,19525,6662,341,6321,2011,t2,cantonales
6816,94,VAL DE MARNE,16308,6841,266,6575,2011,t2,cantonales
6817,94,VAL DE MARNE,9458,3874,227,3647,2011,t2,cantonales
6818,94,VAL DE MARNE,13805,5236,283,4953,2011,t2,cantonales
6819,94,VAL DE MARNE,13891,4127,1253,2874,2011,t2,cantonales
6820,94,VAL DE MARNE,14223,5259,343,4916,2011,t2,cantonales
6821,94,VAL DE MARNE,10062,3595,131,3464,2011,t2,cantonales
6822,94,VAL DE MARNE,15310,4974,463,4511,2011,t2,cantonales
6823,95,VAL D'OISE,14000,5887,300,5587,2011,t2,cantonales
6824,95,VAL D'OISE,19225,7922,593,7329,2011,t2,cantonales
6825,95,VAL D'OISE,16049,7015,596,6419,2011,t2,cantonales
6826,95,VAL D'OISE,20410,7741,388,7353,2011,t2,cantonales
6827,95,VAL D'OISE,21303,7829,372,7457,2011,t2,cantonales
6828,95,VAL D'OISE,20331,7400,432,6968,2011,t2,cantonales
6829,95,VAL D'OISE,11435,5411,365,5046,2011,t2,cantonales
6830,95,VAL D'OISE,8283,4244,195,4049,2011,t2,cantonales
6831,95,VAL D'OISE,18389,7450,360,7090,2011,t2,cantonales
6832,95,VAL D'OISE,17518,6924,372,6552,2011,t2,cantonales
6833,95,VAL D'OISE,16209,6399,336,6063,2011,t2,cantonales
6834,95,VAL D'OISE,14532,4426,325,4101,2011,t2,cantonales
6835,95,VAL D'OISE,14891,6142,362,5780,2011,t2,cantonales
6836,95,VAL D'OISE,16101,6371,363,6008,2011,t2,cantonales
6837,95,VAL D'OISE,20185,7985,472,7513,2011,t2,cantonales
6838,95,VAL D'OISE,13187,3478,135,3343,2011,t2,cantonales
6839,95,VAL D'OISE,12922,6610,330,6280,2011,t2,cantonales
6840,95,VAL D'OISE,17738,6829,321,6508,2011,t2,cantonales
6841,95,VAL D'OISE,9528,3576,149,3427,2011,t2,cantonales
6842,971,GUADELOUPE,7297,3768,400,3368,2011,t2,cantonales
6843,971,GUADELOUPE,9868,5471,363,5108,2011,t2,cantonales
6844,971,GUADELOUPE,6113,2992,264,2728,2011,t2,cantonales
6845,971,GUADELOUPE,10923,7027,280,6747,2011,t2,cantonales
6846,971,GUADELOUPE,6170,3235,145,3090,2011,t2,cantonales
6847,971,GUADELOUPE,10852,4514,257,4257,2011,t2,cantonales
6848,971,GUADELOUPE,5841,2758,193,2565,2011,t2,cantonales
6849,971,GUADELOUPE,13298,5717,488,5229,2011,t2,cantonales
6850,971,GUADELOUPE,4167,1458,112,1346,2011,t2,cantonales
6851,971,GUADELOUPE,4216,1637,105,1532,2011,t2,cantonales
6852,971,GUADELOUPE,5985,2258,187,2071,2011,t2,cantonales
6853,971,GUADELOUPE,6917,4353,184,4169,2011,t2,cantonales
6854,971,GUADELOUPE,8557,3130,245,2885,2011,t2,cantonales
6855,971,GUADELOUPE,8871,4948,318,4630,2011,t2,cantonales
6856,971,GUADELOUPE,6759,2920,226,2694,2011,t2,cantonales
6857,972,MARTINIQUE,11698,5120,311,4809,2011,t2,cantonales
6858,972,MARTINIQUE,3527,953,52,901,2011,t2,cantonales
6859,972,MARTINIQUE,4860,1456,77,1379,2011,t2,cantonales
6860,972,MARTINIQUE,1979,1482,26,1456,2011,t2,cantonales
6861,972,MARTINIQUE,3235,2029,106,1923,2011,t2,cantonales
6862,972,MARTINIQUE,9137,4313,278,4035,2011,t2,cantonales
6863,972,MARTINIQUE,7876,2282,263,2019,2011,t2,cantonales
6864,972,MARTINIQUE,7104,3462,215,3247,2011,t2,cantonales
6865,972,MARTINIQUE,7582,2190,185,2005,2011,t2,cantonales
6866,972,MARTINIQUE,9941,2447,261,2186,2011,t2,cantonales
6867,972,MARTINIQUE,5229,2191,141,2050,2011,t2,cantonales
6868,972,MARTINIQUE,8017,3428,170,3258,2011,t2,cantonales
6869,972,MARTINIQUE,9084,2720,229,2491,2011,t2,cantonales
6870,972,MARTINIQUE,9499,2937,167,2770,2011,t2,cantonales
6871,972,MARTINIQUE,7256,2164,180,1984,2011,t2,cantonales
6872,972,MARTINIQUE,7525,3691,150,3541,2011,t2,cantonales
6873,972,MARTINIQUE,10387,3507,230,3277,2011,t2,cantonales
6874,972,MARTINIQUE,9386,4351,232,4119,2011,t2,cantonales
6875,972,MARTINIQUE,7907,2550,253,2297,2011,t2,cantonales
6876,973,GUYANE,2843,785,38,747,2011,t2,cantonales
6877,973,GUYANE,7796,3392,240,3152,2011,t2,cantonales
6878,973,GUYANE,9160,2890,161,2729,2011,t2,cantonales
6879,973,GUYANE,1951,1412,21,1391,2011,t2,cantonales
6880,973,GUYANE,4199,2274,38,2236,2011,t2,cantonales
6881,974,LA REUNION,11035,5655,539,5116,2011,t2,cantonales
6882,974,LA REUNION,18665,10354,418,9936,2011,t2,cantonales
6883,974,LA REUNION,10499,6475,385,6090,2011,t2,cantonales
6884,974,LA REUNION,11362,6987,375,6612,2011,t2,cantonales
6885,974,LA REUNION,13757,5691,531,5160,2011,t2,cantonales
6886,974,LA REUNION,19847,14350,861,13489,2011,t2,cantonales
6887,974,LA REUNION,17649,10641,913,9728,2011,t2,cantonales
6888,974,LA REUNION,9928,5762,460,5302,2011,t2,cantonales
6889,974,LA REUNION,16748,8805,719,8086,2011,t2,cantonales
6890,974,LA REUNION,21280,11338,758,10580,2011,t2,cantonales
6891,974,LA REUNION,10458,6900,562,6338,2011,t2,cantonales
6892,974,LA REUNION,11548,5847,461,5386,2011,t2,cantonales
6893,974,LA REUNION,13362,8199,465,7734,2011,t2,cantonales
6894,974,LA REUNION,17599,7805,827,6978,2011,t2,cantonales
6895,974,LA REUNION,15873,8218,756,7462,2011,t2,cantonales
6896,985,MAYOTTE,3729,2850,57,2793,2011,t2,cantonales
6897,985,MAYOTTE,3639,2393,35,2358,2011,t2,cantonales
6898,985,MAYOTTE,3907,2852,89,2763,2011,t2,cantonales
6899,985,MAYOTTE,3757,2628,36,2592,2011,t2,cantonales
6900,985,MAYOTTE,3425,2196,46,2150,2011,t2,cantonales
6901,985,MAYOTTE,4516,2276,47,2229,2011,t2,cantonales
6902,985,MAYOTTE,4091,2693,76,2617,2011,t2,cantonales
6903,985,MAYOTTE,3415,2129,37,2092,2011,t2,cantonales
6904,985,MAYOTTE,3567,1946,44,1902,2011,t2,cantonales
6905,1,AIN,9788,6716,306,6410,2004,t2,cantonales
6906,1,AIN,10955,7465,520,6945,2004,t2,cantonales
6907,1,AIN,11338,7444,350,7094,2004,t2,cantonales
6908,1,AIN,14488,8257,369,7888,2004,t2,cantonales
6909,1,AIN,3411,2474,113,2361,2004,t2,cantonales
6910,1,AIN,3798,2631,150,2481,2004,t2,cantonales
6911,1,AIN,12506,8407,338,8069,2004,t2,cantonales
6912,1,AIN,7281,4604,171,4433,2004,t2,cantonales
6913,1,AIN,4559,3070,87,2983,2004,t2,cantonales
6914,1,AIN,8370,5807,180,5627,2004,t2,cantonales
6915,1,AIN,8052,5193,266,4927,2004,t2,cantonales
6916,1,AIN,8937,5600,193,5407,2004,t2,cantonales
6917,1,AIN,10997,7112,176,6936,2004,t2,cantonales
6918,1,AIN,6105,4049,125,3924,2004,t2,cantonales
6919,1,AIN,3065,2140,99,2041,2004,t2,cantonales
6920,1,AIN,9122,6065,220,5845,2004,t2,cantonales
6921,1,AIN,11054,7830,271,7559,2004,t2,cantonales
6922,2,AISNE,10119,7013,274,6739,2004,t2,cantonales
6923,2,AISNE,7755,5204,576,4628,2004,t2,cantonales
6924,2,AISNE,6292,4467,180,4287,2004,t2,cantonales
6925,2,AISNE,16801,10975,729,10246,2004,t2,cantonales
6926,2,AISNE,4061,3110,139,2971,2004,t2,cantonales
6927,2,AISNE,6300,4487,119,4368,2004,t2,cantonales
6928,2,AISNE,4916,3500,165,3335,2004,t2,cantonales
6929,2,AISNE,3374,2603,120,2483,2004,t2,cantonales
6930,2,AISNE,12293,8045,452,7593,2004,t2,cantonales
6931,2,AISNE,7327,5101,548,4553,2004,t2,cantonales
6932,2,AISNE,7149,5071,112,4959,2004,t2,cantonales
6933,2,AISNE,7128,5207,225,4982,2004,t2,cantonales
6934,2,AISNE,7671,5369,169,5200,2004,t2,cantonales
6935,2,AISNE,15954,10767,287,10480,2004,t2,cantonales
6936,3,ALLIER,4954,3730,174,3556,2004,t2,cantonales
6937,3,ALLIER,5060,3646,166,3480,2004,t2,cantonales
6938,3,ALLIER,4249,3164,105,3059,2004,t2,cantonales
6939,3,ALLIER,8985,6321,487,5834,2004,t2,cantonales
6940,3,ALLIER,6946,4588,270,4318,2004,t2,cantonales
6941,3,ALLIER,14660,10028,621,9407,2004,t2,cantonales
6942,3,ALLIER,7051,5104,322,4782,2004,t2,cantonales
6943,3,ALLIER,3646,2531,137,2394,2004,t2,cantonales
6944,3,ALLIER,4632,3313,135,3178,2004,t2,cantonales
6945,3,ALLIER,3971,2883,120,2763,2004,t2,cantonales
6946,3,ALLIER,3916,3142,119,3023,2004,t2,cantonales
6947,3,ALLIER,9021,5814,342,5472,2004,t2,cantonales
6948,3,ALLIER,11128,6999,429,6570,2004,t2,cantonales
6949,3,ALLIER,5079,3841,188,3653,2004,t2,cantonales
6950,3,ALLIER,8263,4915,317,4598,2004,t2,cantonales
6951,3,ALLIER,8913,5940,357,5583,2004,t2,cantonales
6952,3,ALLIER,10240,7145,397,6748,2004,t2,cantonales
6953,4,ALPES DE HAUTE PROVENCE,5192,3737,155,3582,2004,t2,cantonales
6954,4,ALPES DE HAUTE PROVENCE,1207,987,32,955,2004,t2,cantonales
6955,4,ALPES DE HAUTE PROVENCE,9396,6713,472,6241,2004,t2,cantonales
6956,4,ALPES DE HAUTE PROVENCE,7959,5531,296,5235,2004,t2,cantonales
6957,4,ALPES DE HAUTE PROVENCE,1569,1283,95,1188,2004,t2,cantonales
6958,4,ALPES DE HAUTE PROVENCE,984,838,17,821,2004,t2,cantonales
6959,4,ALPES DE HAUTE PROVENCE,2805,2204,116,2088,2004,t2,cantonales
6960,4,ALPES DE HAUTE PROVENCE,4319,3276,169,3107,2004,t2,cantonales
6961,4,ALPES DE HAUTE PROVENCE,7999,5950,354,5596,2004,t2,cantonales
6962,4,ALPES DE HAUTE PROVENCE,5362,3910,236,3674,2004,t2,cantonales
6963,5,HAUTES ALPES,1902,1514,77,1437,2004,t2,cantonales
6964,5,HAUTES ALPES,3517,2465,169,2296,2004,t2,cantonales
6965,5,HAUTES ALPES,3184,2179,163,2016,2004,t2,cantonales
6966,5,HAUTES ALPES,975,869,15,854,2004,t2,cantonales
6967,5,HAUTES ALPES,1411,1149,28,1121,2004,t2,cantonales
6968,5,HAUTES ALPES,2019,1639,76,1563,2004,t2,cantonales
6969,5,HAUTES ALPES,4162,3462,88,3374,2004,t2,cantonales
6970,5,HAUTES ALPES,5170,3464,157,3307,2004,t2,cantonales
6971,5,HAUTES ALPES,5986,3880,294,3586,2004,t2,cantonales
6972,6,ALPES MARITIMES,23699,15331,515,14816,2004,t2,cantonales
6973,6,ALPES MARITIMES,18664,11832,318,11514,2004,t2,cantonales
6974,6,ALPES MARITIMES,14204,10263,341,9922,2004,t2,cantonales
6975,6,ALPES MARITIMES,19346,12723,432,12291,2004,t2,cantonales
6976,6,ALPES MARITIMES,2709,2043,632,1411,2004,t2,cantonales
6977,6,ALPES MARITIMES,13876,9475,962,8513,2004,t2,cantonales
6978,6,ALPES MARITIMES,16184,10151,340,9811,2004,t2,cantonales
6979,6,ALPES MARITIMES,17237,11004,285,10719,2004,t2,cantonales
6980,6,ALPES MARITIMES,26518,16246,2340,13906,2004,t2,cantonales
6981,6,ALPES MARITIMES,25236,15780,1715,14065,2004,t2,cantonales
6982,6,ALPES MARITIMES,13701,8606,226,8380,2004,t2,cantonales
6983,6,ALPES MARITIMES,12849,7845,172,7673,2004,t2,cantonales
6984,6,ALPES MARITIMES,18253,11168,294,10874,2004,t2,cantonales
6985,6,ALPES MARITIMES,17954,11492,290,11202,2004,t2,cantonales
6986,6,ALPES MARITIMES,11227,6858,175,6683,2004,t2,cantonales
6987,6,ALPES MARITIMES,12882,7765,501,7264,2004,t2,cantonales
6988,6,ALPES MARITIMES,19006,11327,289,11038,2004,t2,cantonales
6989,6,ALPES MARITIMES,16652,10554,882,9672,2004,t2,cantonales
6990,6,ALPES MARITIMES,13509,8380,216,8164,2004,t2,cantonales
6991,7,ARDECHE,13072,8349,625,7724,2004,t2,cantonales
6992,7,ARDECHE,7168,5213,295,4918,2004,t2,cantonales
6993,7,ARDECHE,1823,1530,91,1439,2004,t2,cantonales
6994,7,ARDECHE,13424,9333,461,8872,2004,t2,cantonales
6995,7,ARDECHE,3050,2400,76,2324,2004,t2,cantonales
6996,7,ARDECHE,2946,2310,67,2243,2004,t2,cantonales
6997,7,ARDECHE,2749,2206,88,2118,2004,t2,cantonales
6998,7,ARDECHE,6589,5037,246,4791,2004,t2,cantonales
6999,7,ARDECHE,9697,6920,281,6639,2004,t2,cantonales
7000,7,ARDECHE,10470,7453,376,7077,2004,t2,cantonales
7001,7,ARDECHE,10643,6941,695,6246,2004,t2,cantonales
7002,8,ARDENNES,9030,5612,394,5218,2004,t2,cantonales
7003,8,ARDENNES,1888,1387,34,1353,2004,t2,cantonales
7004,8,ARDENNES,2900,2142,313,1829,2004,t2,cantonales
7005,8,ARDENNES,5572,3940,101,3839,2004,t2,cantonales
7006,8,ARDENNES,9353,6425,141,6284,2004,t2,cantonales
7007,8,ARDENNES,3167,2574,75,2499,2004,t2,cantonales
7008,8,ARDENNES,7251,4618,258,4360,2004,t2,cantonales
7009,8,ARDENNES,9031,5769,175,5594,2004,t2,cantonales
7010,8,ARDENNES,4601,3250,127,3123,2004,t2,cantonales
7011,8,ARDENNES,6482,4515,231,4284,2004,t2,cantonales
7012,9,ARIEGE,10324,6910,589,6321,2004,t2,cantonales
7013,9,ARIEGE,7187,4817,414,4403,2004,t2,cantonales
7014,9,ARIEGE,1716,1483,35,1448,2004,t2,cantonales
7015,9,ARIEGE,8698,6100,486,5614,2004,t2,cantonales
7016,10,AUBE,6570,4489,257,4232,2004,t2,cantonales
7017,10,AUBE,7304,5101,190,4911,2004,t2,cantonales
7018,10,AUBE,5727,4071,250,3821,2004,t2,cantonales
7019,10,AUBE,4118,2977,116,2861,2004,t2,cantonales
7020,10,AUBE,4156,2940,276,2664,2004,t2,cantonales
7021,10,AUBE,2571,1803,144,1659,2004,t2,cantonales
7022,10,AUBE,7103,4527,441,4086,2004,t2,cantonales
7023,10,AUBE,2792,2118,127,1991,2004,t2,cantonales
7024,10,AUBE,9836,6185,149,6036,2004,t2,cantonales
7025,10,AUBE,8388,4601,322,4279,2004,t2,cantonales
7026,10,AUBE,2757,1858,100,1758,2004,t2,cantonales
7027,10,AUBE,6896,4269,311,3958,2004,t2,cantonales
7028,10,AUBE,5516,2975,169,2806,2004,t2,cantonales
7029,10,AUBE,10211,6328,317,6011,2004,t2,cantonales
7030,10,AUBE,5880,3762,93,3669,2004,t2,cantonales
7031,11,AUDE,3797,3003,225,2778,2004,t2,cantonales
7032,11,AUDE,12187,8703,414,8289,2004,t2,cantonales
7033,11,AUDE,6848,5303,216,5087,2004,t2,cantonales
7034,11,AUDE,17689,12410,1503,10907,2004,t2,cantonales
7035,11,AUDE,3012,2368,213,2155,2004,t2,cantonales
7036,11,AUDE,13238,9306,626,8680,2004,t2,cantonales
7037,11,AUDE,9467,6919,653,6266,2004,t2,cantonales
7038,11,AUDE,1648,1346,76,1270,2004,t2,cantonales
7039,11,AUDE,5880,4181,184,3997,2004,t2,cantonales
7040,12,AVEYRON,2202,1770,54,1716,2004,t2,cantonales
7041,12,AVEYRON,2229,1696,96,1600,2004,t2,cantonales
7042,12,AVEYRON,2670,2145,100,2045,2004,t2,cantonales
7043,12,AVEYRON,2066,1760,46,1714,2004,t2,cantonales
7044,12,AVEYRON,7318,5681,267,5414,2004,t2,cantonales
7045,12,AVEYRON,5494,4494,133,4361,2004,t2,cantonales
7046,12,AVEYRON,2677,2075,230,1845,2004,t2,cantonales
7047,12,AVEYRON,8950,6327,337,5990,2004,t2,cantonales
7048,12,AVEYRON,9284,7214,535,6679,2004,t2,cantonales
7049,12,AVEYRON,3089,2555,114,2441,2004,t2,cantonales
7050,12,AVEYRON,3342,2796,106,2690,2004,t2,cantonales
7051,12,AVEYRON,1486,1273,62,1211,2004,t2,cantonales
7052,12,AVEYRON,12438,8492,559,7933,2004,t2,cantonales
7053,12,AVEYRON,13180,9538,810,8728,2004,t2,cantonales
7054,13,BOUCHES DU RHONE,40651,26918,1752,25166,2004,t2,cantonales
7055,13,BOUCHES DU RHONE,21129,13633,996,12637,2004,t2,cantonales
7056,13,BOUCHES DU RHONE,28628,19592,568,19024,2004,t2,cantonales
7057,13,BOUCHES DU RHONE,15542,10585,351,10234,2004,t2,cantonales
7058,13,BOUCHES DU RHONE,17748,12504,582,11922,2004,t2,cantonales
7059,13,BOUCHES DU RHONE,16432,10521,390,10131,2004,t2,cantonales
7060,13,BOUCHES DU RHONE,17416,11228,269,10959,2004,t2,cantonales
7061,13,BOUCHES DU RHONE,15887,10268,223,10045,2004,t2,cantonales
7062,13,BOUCHES DU RHONE,16436,9847,572,9275,2004,t2,cantonales
7063,13,BOUCHES DU RHONE,20690,13194,301,12893,2004,t2,cantonales
7064,13,BOUCHES DU RHONE,17441,10719,258,10461,2004,t2,cantonales
7065,13,BOUCHES DU RHONE,12668,8735,291,8444,2004,t2,cantonales
7066,13,BOUCHES DU RHONE,5841,4812,105,4707,2004,t2,cantonales
7067,13,BOUCHES DU RHONE,11857,8525,601,7924,2004,t2,cantonales
7068,13,BOUCHES DU RHONE,12102,8141,277,7864,2004,t2,cantonales
7069,13,BOUCHES DU RHONE,20831,14981,622,14359,2004,t2,cantonales
7070,13,BOUCHES DU RHONE,25540,15482,3521,11961,2004,t2,cantonales
7071,13,BOUCHES DU RHONE,16987,11110,332,10778,2004,t2,cantonales
7072,13,BOUCHES DU RHONE,22641,14142,370,13772,2004,t2,cantonales
7073,13,BOUCHES DU RHONE,16013,9833,466,9367,2004,t2,cantonales
7074,13,BOUCHES DU RHONE,21303,13662,362,13300,2004,t2,cantonales
7075,13,BOUCHES DU RHONE,33472,22662,617,22045,2004,t2,cantonales
7076,13,BOUCHES DU RHONE,30979,21251,1346,19905,2004,t2,cantonales
7077,13,BOUCHES DU RHONE,30256,19445,689,18756,2004,t2,cantonales
7078,13,BOUCHES DU RHONE,21237,13650,687,12963,2004,t2,cantonales
7079,13,BOUCHES DU RHONE,28842,19448,524,18924,2004,t2,cantonales
7080,13,BOUCHES DU RHONE,17479,11322,295,11027,2004,t2,cantonales
7081,13,BOUCHES DU RHONE,21141,13372,318,13054,2004,t2,cantonales
7082,13,BOUCHES DU RHONE,18004,11105,690,10415,2004,t2,cantonales
7083,14,CALVADOS,5661,3842,299,3543,2004,t2,cantonales
7084,14,CALVADOS,14283,9097,407,8690,2004,t2,cantonales
7085,14,CALVADOS,9746,6957,441,6516,2004,t2,cantonales
7086,14,CALVADOS,10869,7477,279,7198,2004,t2,cantonales
7087,14,CALVADOS,4335,2796,186,2610,2004,t2,cantonales
7088,14,CALVADOS,14655,10299,459,9840,2004,t2,cantonales
7089,14,CALVADOS,10953,7351,366,6985,2004,t2,cantonales
7090,14,CALVADOS,7880,5424,388,5036,2004,t2,cantonales
7091,14,CALVADOS,6551,4237,226,4011,2004,t2,cantonales
7092,14,CALVADOS,8121,5063,257,4806,2004,t2,cantonales
7093,14,CALVADOS,4934,3452,105,3347,2004,t2,cantonales
7094,14,CALVADOS,7254,4603,292,4311,2004,t2,cantonales
7095,14,CALVADOS,10872,7109,267,6842,2004,t2,cantonales
7096,14,CALVADOS,6594,4325,149,4176,2004,t2,cantonales
7097,14,CALVADOS,9447,5911,219,5692,2004,t2,cantonales
7098,14,CALVADOS,13634,8878,551,8327,2004,t2,cantonales
7099,14,CALVADOS,9281,5870,359,5511,2004,t2,cantonales
7100,15,CANTAL,6177,4028,262,3766,2004,t2,cantonales
7101,15,CANTAL,2512,2003,78,1925,2004,t2,cantonales
7102,15,CANTAL,6490,4806,119,4687,2004,t2,cantonales
7103,16,CHARENTE,7724,4988,258,4730,2004,t2,cantonales
7104,16,CHARENTE,8255,5183,245,4938,2004,t2,cantonales
7105,16,CHARENTE,11220,7633,352,7281,2004,t2,cantonales
7106,16,CHARENTE,3662,2851,154,2697,2004,t2,cantonales
7107,16,CHARENTE,5130,3876,235,3641,2004,t2,cantonales
7108,16,CHARENTE,8938,6087,313,5774,2004,t2,cantonales
7109,16,CHARENTE,9262,6170,285,5885,2004,t2,cantonales
7110,16,CHARENTE,5682,4200,258,3942,2004,t2,cantonales
7111,16,CHARENTE,6685,4914,358,4556,2004,t2,cantonales
7112,16,CHARENTE,6515,4742,248,4494,2004,t2,cantonales
7113,16,CHARENTE,8363,6003,312,5691,2004,t2,cantonales
7114,16,CHARENTE,9134,6040,347,5693,2004,t2,cantonales
7115,16,CHARENTE,6015,4397,205,4192,2004,t2,cantonales
7116,16,CHARENTE,9073,5688,254,5434,2004,t2,cantonales
7117,17,CHARENTE MARITIME,8039,5538,323,5215,2004,t2,cantonales
7118,17,CHARENTE MARITIME,4990,3560,165,3395,2004,t2,cantonales
7119,17,CHARENTE MARITIME,4999,3564,201,3363,2004,t2,cantonales
7120,17,CHARENTE MARITIME,3867,2734,132,2602,2004,t2,cantonales
7121,17,CHARENTE MARITIME,7832,5077,288,4789,2004,t2,cantonales
7122,17,CHARENTE MARITIME,9826,6537,589,5948,2004,t2,cantonales
7123,17,CHARENTE MARITIME,4928,3581,185,3396,2004,t2,cantonales
7124,17,CHARENTE MARITIME,4727,3277,155,3122,2004,t2,cantonales
7125,17,CHARENTE MARITIME,9566,6479,338,6141,2004,t2,cantonales
7126,17,CHARENTE MARITIME,6817,4186,215,3971,2004,t2,cantonales
7127,17,CHARENTE MARITIME,6260,3858,163,3695,2004,t2,cantonales
7128,17,CHARENTE MARITIME,5681,3858,226,3632,2004,t2,cantonales
7129,17,CHARENTE MARITIME,12293,8166,466,7700,2004,t2,cantonales
7130,17,CHARENTE MARITIME,9888,6567,473,6094,2004,t2,cantonales
7131,17,CHARENTE MARITIME,10943,7556,468,7088,2004,t2,cantonales
7132,17,CHARENTE MARITIME,12142,8422,660,7762,2004,t2,cantonales
7133,17,CHARENTE MARITIME,10231,7008,319,6689,2004,t2,cantonales
7134,17,CHARENTE MARITIME,8643,5671,203,5468,2004,t2,cantonales
7135,17,CHARENTE MARITIME,15681,10085,622,9463,2004,t2,cantonales
7136,17,CHARENTE MARITIME,9040,5502,316,5186,2004,t2,cantonales
7137,18,CHER,6623,4635,187,4448,2004,t2,cantonales
7138,18,CHER,2122,1572,165,1407,2004,t2,cantonales
7139,18,CHER,3108,2241,84,2157,2004,t2,cantonales
7140,18,CHER,10322,6737,508,6229,2004,t2,cantonales
7141,18,CHER,2793,2028,169,1859,2004,t2,cantonales
7142,18,CHER,7619,5268,288,4980,2004,t2,cantonales
7143,18,CHER,3221,2447,116,2331,2004,t2,cantonales
7144,18,CHER,8034,5393,287,5106,2004,t2,cantonales
7145,18,CHER,3516,2490,149,2341,2004,t2,cantonales
7146,18,CHER,12762,8885,371,8514,2004,t2,cantonales
7147,18,CHER,4149,2967,236,2731,2004,t2,cantonales
7148,18,CHER,2994,2188,96,2092,2004,t2,cantonales
7149,18,CHER,10944,6936,323,6613,2004,t2,cantonales
7150,18,CHER,14767,9652,802,8850,2004,t2,cantonales
7151,18,CHER,10031,5992,300,5692,2004,t2,cantonales
7152,18,CHER,7017,4108,248,3860,2004,t2,cantonales
7153,19,CORREZE,6494,5358,179,5179,2004,t2,cantonales
7154,19,CORREZE,3355,2792,125,2667,2004,t2,cantonales
7155,19,CORREZE,2057,1785,48,1737,2004,t2,cantonales
7156,19,CORREZE,8030,6133,360,5773,2004,t2,cantonales
7157,19,CORREZE,2131,1656,146,1510,2004,t2,cantonales
7158,19,CORREZE,4200,3482,148,3334,2004,t2,cantonales
7159,19,CORREZE,8214,6009,331,5678,2004,t2,cantonales
7160,19,CORREZE,2875,2384,111,2273,2004,t2,cantonales
7161,19,CORREZE,5133,3693,276,3417,2004,t2,cantonales
7162,19,CORREZE,5412,4507,234,4273,2004,t2,cantonales
7163,19,CORREZE,5842,3360,175,3185,2004,t2,cantonales
7164,19,CORREZE,7252,4382,288,4094,2004,t2,cantonales
7165,19,CORREZE,10844,7812,647,7165,2004,t2,cantonales
7166,19,CORREZE,4470,3308,189,3119,2004,t2,cantonales
7167,2A,CORSE SUD,6179,3900,804,3096,2004,t2,cantonales
7168,2A,CORSE SUD,2495,2207,61,2146,2004,t2,cantonales
7169,2A,CORSE SUD,8760,6303,493,5810,2004,t2,cantonales
7170,2A,CORSE SUD,4136,3048,219,2829,2004,t2,cantonales
7171,2A,CORSE SUD,3165,2484,117,2367,2004,t2,cantonales
7172,2A,CORSE SUD,3965,2815,176,2639,2004,t2,cantonales
7173,2B,HAUTE CORSE,3176,2596,238,2358,2004,t2,cantonales
7174,2B,HAUTE CORSE,3369,3004,76,2928,2004,t2,cantonales
7175,2B,HAUTE CORSE,2964,2450,105,2345,2004,t2,cantonales
7176,2B,HAUTE CORSE,2570,2264,59,2205,2004,t2,cantonales
7177,2B,HAUTE CORSE,3512,3046,122,2924,2004,t2,cantonales
7178,2B,HAUTE CORSE,5162,4171,113,4058,2004,t2,cantonales
7179,2B,HAUTE CORSE,2723,2111,134,1977,2004,t2,cantonales
7180,2B,HAUTE CORSE,1798,1528,145,1383,2004,t2,cantonales
7181,21,COTE D'OR,9162,5923,582,5341,2004,t2,cantonales
7182,21,COTE D'OR,11163,7197,542,6655,2004,t2,cantonales
7183,21,COTE D'OR,9978,6157,358,5799,2004,t2,cantonales
7184,21,COTE D'OR,10649,7386,375,7011,2004,t2,cantonales
7185,21,COTE D'OR,8405,5871,282,5589,2004,t2,cantonales
7186,21,COTE D'OR,8289,5686,468,5218,2004,t2,cantonales
7187,21,COTE D'OR,2128,1532,126,1406,2004,t2,cantonales
7188,21,COTE D'OR,10392,7282,349,6933,2004,t2,cantonales
7189,21,COTE D'OR,5505,3737,162,3575,2004,t2,cantonales
7190,21,COTE D'OR,7470,4791,177,4614,2004,t2,cantonales
7191,21,COTE D'OR,2793,2074,167,1907,2004,t2,cantonales
7192,21,COTE D'OR,15699,10531,559,9972,2004,t2,cantonales
7193,21,COTE D'OR,12974,8792,360,8432,2004,t2,cantonales
7194,21,COTE D'OR,22674,15684,837,14847,2004,t2,cantonales
7195,22,COTES D'ARMOR,6084,4733,255,4478,2004,t2,cantonales
7196,22,COTES D'ARMOR,6749,5136,138,4998,2004,t2,cantonales
7197,22,COTES D'ARMOR,2381,2090,54,2036,2004,t2,cantonales
7198,22,COTES D'ARMOR,17759,12506,662,11844,2004,t2,cantonales
7199,22,COTES D'ARMOR,11058,7668,297,7371,2004,t2,cantonales
7200,22,COTES D'ARMOR,4586,3586,140,3446,2004,t2,cantonales
7201,22,COTES D'ARMOR,11405,8259,376,7883,2004,t2,cantonales
7202,22,COTES D'ARMOR,4176,3319,147,3172,2004,t2,cantonales
7203,22,COTES D'ARMOR,10741,8109,422,7687,2004,t2,cantonales
7204,22,COTES D'ARMOR,15187,10389,411,9978,2004,t2,cantonales
7205,22,COTES D'ARMOR,21753,15012,620,14392,2004,t2,cantonales
7206,22,COTES D'ARMOR,3891,3027,123,2904,2004,t2,cantonales
7207,22,COTES D'ARMOR,7921,6297,336,5961,2004,t2,cantonales
7208,22,COTES D'ARMOR,5604,4194,173,4021,2004,t2,cantonales
7209,22,COTES D'ARMOR,5023,4105,64,4041,2004,t2,cantonales
7210,22,COTES D'ARMOR,4652,3578,115,3463,2004,t2,cantonales
7211,22,COTES D'ARMOR,6600,5121,286,4835,2004,t2,cantonales
7212,22,COTES D'ARMOR,3251,2538,98,2440,2004,t2,cantonales
7213,22,COTES D'ARMOR,16608,11679,488,11191,2004,t2,cantonales
7214,22,COTES D'ARMOR,14686,10975,471,10504,2004,t2,cantonales
7215,22,COTES D'ARMOR,11437,7413,310,7103,2004,t2,cantonales
7216,23,CREUSE,3623,2758,166,2592,2004,t2,cantonales
7217,23,CREUSE,5443,3939,218,3721,2004,t2,cantonales
7218,23,CREUSE,4631,3252,168,3084,2004,t2,cantonales
7219,23,CREUSE,1334,1111,37,1074,2004,t2,cantonales
7220,24,DORDOGNE,15034,9991,702,9289,2004,t2,cantonales
7221,24,DORDOGNE,5617,4407,214,4193,2004,t2,cantonales
7222,24,DORDOGNE,3717,2960,129,2831,2004,t2,cantonales
7223,24,DORDOGNE,3057,2520,132,2388,2004,t2,cantonales
7224,24,DORDOGNE,2983,2265,108,2157,2004,t2,cantonales
7225,24,DORDOGNE,3300,2907,131,2776,2004,t2,cantonales
7226,24,DORDOGNE,4032,3274,177,3097,2004,t2,cantonales
7227,24,DORDOGNE,8658,6211,452,5759,2004,t2,cantonales
7228,24,DORDOGNE,6361,4808,588,4220,2004,t2,cantonales
7229,24,DORDOGNE,4573,3815,313,3502,2004,t2,cantonales
7230,24,DORDOGNE,6816,5327,279,5048,2004,t2,cantonales
7231,24,DORDOGNE,7771,5952,295,5657,2004,t2,cantonales
7232,24,DORDOGNE,7107,5682,500,5182,2004,t2,cantonales
7233,24,DORDOGNE,3045,2493,122,2371,2004,t2,cantonales
7234,24,DORDOGNE,11941,9131,514,8617,2004,t2,cantonales
7235,24,DORDOGNE,6970,5618,417,5201,2004,t2,cantonales
7236,24,DORDOGNE,6821,4948,331,4617,2004,t2,cantonales
7237,24,DORDOGNE,3701,3053,157,2896,2004,t2,cantonales
7238,24,DORDOGNE,1937,1704,76,1628,2004,t2,cantonales
7239,24,DORDOGNE,11653,8236,624,7612,2004,t2,cantonales
7240,24,DORDOGNE,12332,8991,672,8319,2004,t2,cantonales
7241,24,DORDOGNE,14650,10532,1055,9477,2004,t2,cantonales
7242,25,DOUBS,15681,9900,383,9517,2004,t2,cantonales
7243,25,DOUBS,12545,8495,455,8040,2004,t2,cantonales
7244,25,DOUBS,5588,3898,268,3630,2004,t2,cantonales
7245,25,DOUBS,21028,14248,580,13668,2004,t2,cantonales
7246,25,DOUBS,10841,7728,265,7463,2004,t2,cantonales
7247,25,DOUBS,6429,4872,254,4618,2004,t2,cantonales
7248,25,DOUBS,3103,2309,291,2018,2004,t2,cantonales
7249,25,DOUBS,6020,4500,245,4255,2004,t2,cantonales
7250,25,DOUBS,7836,5865,370,5495,2004,t2,cantonales
7251,25,DOUBS,12316,7969,472,7497,2004,t2,cantonales
7252,25,DOUBS,12511,8501,305,8196,2004,t2,cantonales
7253,25,DOUBS,8228,5023,313,4710,2004,t2,cantonales
7254,25,DOUBS,9307,6588,257,6331,2004,t2,cantonales
7255,26,DROME,19422,13097,437,12660,2004,t2,cantonales
7256,26,DROME,14672,10512,441,10071,2004,t2,cantonales
7257,26,DROME,1698,1324,72,1252,2004,t2,cantonales
7258,26,DROME,4609,3429,246,3183,2004,t2,cantonales
7259,26,DROME,5670,4295,183,4112,2004,t2,cantonales
7260,26,DROME,5815,4446,243,4203,2004,t2,cantonales
7261,26,DROME,1557,1239,44,1195,2004,t2,cantonales
7262,26,DROME,12537,8039,590,7449,2004,t2,cantonales
7263,26,DROME,9810,6973,212,6761,2004,t2,cantonales
7264,26,DROME,12373,8555,249,8306,2004,t2,cantonales
7265,26,DROME,1287,989,50,939,2004,t2,cantonales
7266,26,DROME,4970,3764,155,3609,2004,t2,cantonales
7267,26,DROME,14387,10163,518,9645,2004,t2,cantonales
7268,26,DROME,9910,6600,269,6331,2004,t2,cantonales
7269,26,DROME,16059,11037,508,10529,2004,t2,cantonales
7270,26,DROME,16736,11429,404,11025,2004,t2,cantonales
7271,26,DROME,8706,5725,238,5487,2004,t2,cantonales
7272,27,EURE,12739,8373,261,8112,2004,t2,cantonales
7273,27,EURE,3639,2663,164,2499,2004,t2,cantonales
7274,27,EURE,8985,6080,402,5678,2004,t2,cantonales
7275,27,EURE,6194,4311,160,4151,2004,t2,cantonales
7276,27,EURE,7394,5221,238,4983,2004,t2,cantonales
7277,27,EURE,10087,6995,435,6560,2004,t2,cantonales
7278,27,EURE,6241,4401,358,4043,2004,t2,cantonales
7279,27,EURE,11030,7435,221,7214,2004,t2,cantonales
7280,27,EURE,3606,2619,140,2479,2004,t2,cantonales
7281,27,EURE,5193,3557,182,3375,2004,t2,cantonales
7282,27,EURE,7219,4980,139,4841,2004,t2,cantonales
7283,27,EURE,16802,10925,613,10312,2004,t2,cantonales
7284,27,EURE,9019,5564,377,5187,2004,t2,cantonales
7285,27,EURE,7828,4891,135,4756,2004,t2,cantonales
7286,27,EURE,9819,6720,396,6324,2004,t2,cantonales
7287,27,EURE,12323,7947,462,7485,2004,t2,cantonales
7288,28,EURE ET LOIR,12644,8473,520,7953,2004,t2,cantonales
7289,28,EURE ET LOIR,15813,10580,341,10239,2004,t2,cantonales
7290,28,EURE ET LOIR,7539,4908,310,4598,2004,t2,cantonales
7291,28,EURE ET LOIR,6399,4310,157,4153,2004,t2,cantonales
7292,28,EURE ET LOIR,21037,13263,805,12458,2004,t2,cantonales
7293,28,EURE ET LOIR,11313,7332,390,6942,2004,t2,cantonales
7294,28,EURE ET LOIR,4201,2815,69,2746,2004,t2,cantonales
7295,28,EURE ET LOIR,20416,13304,707,12597,2004,t2,cantonales
7296,28,EURE ET LOIR,11028,6683,217,6466,2004,t2,cantonales
7297,28,EURE ET LOIR,12265,7557,427,7130,2004,t2,cantonales
7298,29,FINISTERE,4028,3083,112,2971,2004,t2,cantonales
7299,29,FINISTERE,11715,7891,250,7641,2004,t2,cantonales
7300,29,FINISTERE,8862,5326,140,5186,2004,t2,cantonales
7301,29,FINISTERE,12133,9205,522,8683,2004,t2,cantonales
7302,29,FINISTERE,21069,13483,626,12857,2004,t2,cantonales
7303,29,FINISTERE,13363,9457,411,9046,2004,t2,cantonales
7304,29,FINISTERE,19733,14056,472,13584,2004,t2,cantonales
7305,29,FINISTERE,20379,15103,470,14633,2004,t2,cantonales
7306,29,FINISTERE,9984,7046,254,6792,2004,t2,cantonales
7307,29,FINISTERE,12671,9024,155,8869,2004,t2,cantonales
7308,29,FINISTERE,14027,9901,295,9606,2004,t2,cantonales
7309,29,FINISTERE,6542,5001,168,4833,2004,t2,cantonales
7310,29,FINISTERE,12664,8797,282,8515,2004,t2,cantonales
7311,29,FINISTERE,7297,5381,165,5216,2004,t2,cantonales
7312,29,FINISTERE,14600,10365,215,10150,2004,t2,cantonales
7313,29,FINISTERE,14139,10050,385,9665,2004,t2,cantonales
7314,29,FINISTERE,10113,7275,300,6975,2004,t2,cantonales
7315,29,FINISTERE,15579,10855,287,10568,2004,t2,cantonales
7316,29,FINISTERE,12658,8572,254,8318,2004,t2,cantonales
7317,29,FINISTERE,11230,7270,233,7037,2004,t2,cantonales
7318,29,FINISTERE,14999,10821,428,10393,2004,t2,cantonales
7319,29,FINISTERE,9547,5346,168,5178,2004,t2,cantonales
7320,29,FINISTERE,13632,8683,232,8451,2004,t2,cantonales
7321,29,FINISTERE,8739,5013,122,4891,2004,t2,cantonales
7322,30,GARD,12883,9535,267,9268,2004,t2,cantonales
7323,30,GARD,14350,9689,665,9024,2004,t2,cantonales
7324,30,GARD,17836,11928,469,11459,2004,t2,cantonales
7325,30,GARD,2820,2491,91,2400,2004,t2,cantonales
7326,30,GARD,4405,3320,335,2985,2004,t2,cantonales
7327,30,GARD,13541,8840,813,8027,2004,t2,cantonales
7328,30,GARD,13748,10471,372,10099,2004,t2,cantonales
7329,30,GARD,14374,10434,472,9962,2004,t2,cantonales
7330,30,GARD,997,861,25,836,2004,t2,cantonales
7331,30,GARD,8760,6565,253,6312,2004,t2,cantonales
7332,30,GARD,2743,2212,110,2102,2004,t2,cantonales
7333,30,GARD,9862,6951,284,6667,2004,t2,cantonales
7334,30,GARD,17066,12239,508,11731,2004,t2,cantonales
7335,30,GARD,13997,10428,445,9983,2004,t2,cantonales
7336,30,GARD,13254,9240,261,8979,2004,t2,cantonales
7337,30,GARD,6028,4484,279,4205,2004,t2,cantonales
7338,30,GARD,6510,4919,207,4712,2004,t2,cantonales
7339,30,GARD,9557,6029,288,5741,2004,t2,cantonales
7340,30,GARD,8741,5971,156,5815,2004,t2,cantonales
7341,31,HAUTE GARONNE,4262,3379,184,3195,2004,t2,cantonales
7342,31,HAUTE GARONNE,25788,19189,1078,18111,2004,t2,cantonales
7343,31,HAUTE GARONNE,7937,5789,509,5280,2004,t2,cantonales
7344,31,HAUTE GARONNE,3952,3114,132,2982,2004,t2,cantonales
7345,31,HAUTE GARONNE,29418,19801,1443,18358,2004,t2,cantonales
7346,31,HAUTE GARONNE,9374,7056,338,6718,2004,t2,cantonales
7347,31,HAUTE GARONNE,5865,4473,283,4190,2004,t2,cantonales
7348,31,HAUTE GARONNE,15745,10205,845,9360,2004,t2,cantonales
7349,31,HAUTE GARONNE,2717,2009,222,1787,2004,t2,cantonales
7350,31,HAUTE GARONNE,16060,9349,426,8923,2004,t2,cantonales
7351,31,HAUTE GARONNE,20994,12844,631,12213,2004,t2,cantonales
7352,31,HAUTE GARONNE,17551,10464,512,9952,2004,t2,cantonales
7353,31,HAUTE GARONNE,17671,10325,518,9807,2004,t2,cantonales
7354,31,HAUTE GARONNE,20654,11726,672,11054,2004,t2,cantonales
7355,31,HAUTE GARONNE,30937,20474,1563,18911,2004,t2,cantonales
7356,31,HAUTE GARONNE,22103,14835,1161,13674,2004,t2,cantonales
7357,31,HAUTE GARONNE,32107,21608,1168,20440,2004,t2,cantonales
7358,32,GERS,3778,2850,202,2648,2004,t2,cantonales
7359,32,GERS,2139,1780,71,1709,2004,t2,cantonales
7360,32,GERS,7544,5638,378,5260,2004,t2,cantonales
7361,32,GERS,2668,2164,140,2024,2004,t2,cantonales
7362,32,GERS,3898,2966,160,2806,2004,t2,cantonales
7363,32,GERS,3800,2847,124,2723,2004,t2,cantonales
7364,32,GERS,1608,1292,52,1240,2004,t2,cantonales
7365,32,GERS,3277,2620,131,2489,2004,t2,cantonales
7366,32,GERS,5388,4236,166,4070,2004,t2,cantonales
7367,32,GERS,2190,1849,63,1786,2004,t2,cantonales
7368,32,GERS,2257,1881,79,1802,2004,t2,cantonales
7369,32,GERS,3541,2641,143,2498,2004,t2,cantonales
7370,32,GERS,6740,4857,493,4364,2004,t2,cantonales
7371,33,GIRONDE,38223,26199,1810,24389,2004,t2,cantonales
7372,33,GIRONDE,9421,6838,452,6386,2004,t2,cantonales
7373,33,GIRONDE,14006,8568,406,8162,2004,t2,cantonales
7374,33,GIRONDE,12703,7741,460,7281,2004,t2,cantonales
7375,33,GIRONDE,9110,6367,517,5850,2004,t2,cantonales
7376,33,GIRONDE,9138,6164,558,5606,2004,t2,cantonales
7377,33,GIRONDE,8577,6259,490,5769,2004,t2,cantonales
7378,33,GIRONDE,19752,13224,1170,12054,2004,t2,cantonales
7379,33,GIRONDE,23945,16859,1032,15827,2004,t2,cantonales
7380,33,GIRONDE,25849,17348,1012,16336,2004,t2,cantonales
7381,33,GIRONDE,8276,5675,342,5333,2004,t2,cantonales
7382,33,GIRONDE,16910,11160,667,10493,2004,t2,cantonales
7383,33,GIRONDE,5604,4198,250,3948,2004,t2,cantonales
7384,33,GIRONDE,6156,4549,269,4280,2004,t2,cantonales
7385,33,GIRONDE,6039,4251,355,3896,2004,t2,cantonales
7386,33,GIRONDE,2935,2346,135,2211,2004,t2,cantonales
7387,33,GIRONDE,4670,3674,148,3526,2004,t2,cantonales
7388,33,GIRONDE,3379,2633,125,2508,2004,t2,cantonales
7389,33,GIRONDE,15150,9912,1010,8902,2004,t2,cantonales
7390,33,GIRONDE,26146,16578,674,15904,2004,t2,cantonales
7391,33,GIRONDE,19672,13689,650,13039,2004,t2,cantonales
7392,33,GIRONDE,15844,9301,847,8454,2004,t2,cantonales
7393,33,GIRONDE,26180,17212,995,16217,2004,t2,cantonales
7394,34,HERAULT,12572,8605,395,8210,2004,t2,cantonales
7395,34,HERAULT,30281,22189,1047,21142,2004,t2,cantonales
7396,34,HERAULT,1040,905,31,874,2004,t2,cantonales
7397,34,HERAULT,13035,9497,630,8867,2004,t2,cantonales
7398,34,HERAULT,28938,20570,1387,19183,2004,t2,cantonales
7399,34,HERAULT,21524,16048,629,15419,2004,t2,cantonales
7400,34,HERAULT,25204,18297,564,17733,2004,t2,cantonales
7401,34,HERAULT,15384,10014,347,9667,2004,t2,cantonales
7402,34,HERAULT,7874,5949,244,5705,2004,t2,cantonales
7403,34,HERAULT,3456,2679,334,2345,2004,t2,cantonales
7404,34,HERAULT,10804,8375,404,7971,2004,t2,cantonales
7405,34,HERAULT,5953,4835,275,4560,2004,t2,cantonales
7406,34,HERAULT,8650,6484,332,6152,2004,t2,cantonales
7407,34,HERAULT,15629,10301,443,9858,2004,t2,cantonales
7408,34,HERAULT,19437,13118,508,12610,2004,t2,cantonales
7409,34,HERAULT,24919,17113,626,16487,2004,t2,cantonales
7410,34,HERAULT,9521,6125,371,5754,2004,t2,cantonales
7411,34,HERAULT,12731,7936,454,7482,2004,t2,cantonales
7412,34,HERAULT,22136,14528,853,13675,2004,t2,cantonales
7413,34,HERAULT,16661,11659,600,11059,2004,t2,cantonales
7414,34,HERAULT,22042,15758,828,14930,2004,t2,cantonales
7415,34,HERAULT,19482,13837,646,13191,2004,t2,cantonales
7416,35,ILLE ET VILAINE,12551,7975,329,7646,2004,t2,cantonales
7417,35,ILLE ET VILAINE,11705,7978,411,7567,2004,t2,cantonales
7418,35,ILLE ET VILAINE,9384,7008,220,6788,2004,t2,cantonales
7419,35,ILLE ET VILAINE,13654,8911,418,8493,2004,t2,cantonales
7420,35,ILLE ET VILAINE,16429,11612,549,11063,2004,t2,cantonales
7421,35,ILLE ET VILAINE,6735,4839,159,4680,2004,t2,cantonales
7422,35,ILLE ET VILAINE,9275,5980,239,5741,2004,t2,cantonales
7423,35,ILLE ET VILAINE,6025,4496,161,4335,2004,t2,cantonales
7424,35,ILLE ET VILAINE,10440,7323,237,7086,2004,t2,cantonales
7425,35,ILLE ET VILAINE,10195,6607,140,6467,2004,t2,cantonales
7426,35,ILLE ET VILAINE,11506,7447,224,7223,2004,t2,cantonales
7427,35,ILLE ET VILAINE,12076,7677,176,7501,2004,t2,cantonales
7428,35,ILLE ET VILAINE,8897,5660,169,5491,2004,t2,cantonales
7429,35,ILLE ET VILAINE,16063,10927,427,10500,2004,t2,cantonales
7430,35,ILLE ET VILAINE,18387,11895,509,11386,2004,t2,cantonales
7431,35,ILLE ET VILAINE,3884,2911,124,2787,2004,t2,cantonales
7432,35,ILLE ET VILAINE,8881,5678,164,5514,2004,t2,cantonales
7433,35,ILLE ET VILAINE,27127,18724,687,18037,2004,t2,cantonales
7434,35,ILLE ET VILAINE,11275,6692,233,6459,2004,t2,cantonales
7435,35,ILLE ET VILAINE,15864,11007,344,10663,2004,t2,cantonales
7436,36,INDRE,9842,7511,380,7131,2004,t2,cantonales
7437,36,INDRE,9362,6379,388,5991,2004,t2,cantonales
7438,36,INDRE,3030,2474,116,2358,2004,t2,cantonales
7439,36,INDRE,2934,1966,107,1859,2004,t2,cantonales
7440,36,INDRE,3818,2885,163,2722,2004,t2,cantonales
7441,36,INDRE,12766,8207,434,7773,2004,t2,cantonales
7442,36,INDRE,10788,7231,565,6666,2004,t2,cantonales
7443,37,INDRE ET LOIRE ,15442,10728,683,10045,2004,t2,cantonales
7444,37,INDRE ET LOIRE ,8805,5888,307,5581,2004,t2,cantonales
7445,37,INDRE ET LOIRE ,6574,4543,181,4362,2004,t2,cantonales
7446,37,INDRE ET LOIRE ,3389,2566,140,2426,2004,t2,cantonales
7447,37,INDRE ET LOIRE ,5751,4171,106,4065,2004,t2,cantonales
7448,37,INDRE ET LOIRE ,5569,4174,248,3926,2004,t2,cantonales
7449,37,INDRE ET LOIRE ,15989,10563,454,10109,2004,t2,cantonales
7450,37,INDRE ET LOIRE ,4389,3189,124,3065,2004,t2,cantonales
7451,37,INDRE ET LOIRE ,6553,4325,272,4053,2004,t2,cantonales
7452,37,INDRE ET LOIRE ,10165,6560,283,6277,2004,t2,cantonales
7453,37,INDRE ET LOIRE ,9268,5657,211,5446,2004,t2,cantonales
7454,37,INDRE ET LOIRE ,8917,5410,229,5181,2004,t2,cantonales
7455,37,INDRE ET LOIRE ,10763,6601,362,6239,2004,t2,cantonales
7456,37,INDRE ET LOIRE ,10158,6403,391,6012,2004,t2,cantonales
7457,37,INDRE ET LOIRE ,11280,6765,318,6447,2004,t2,cantonales
7458,37,INDRE ET LOIRE ,15011,10148,516,9632,2004,t2,cantonales
7459,37,INDRE ET LOIRE ,14316,9507,518,8989,2004,t2,cantonales
7460,38,ISERE,8664,5613,218,5395,2004,t2,cantonales
7461,38,ISERE,14411,9174,252,8922,2004,t2,cantonales
7462,38,ISERE,1639,1386,44,1342,2004,t2,cantonales
7463,38,ISERE,1923,1562,35,1527,2004,t2,cantonales
7464,38,ISERE,19300,12439,315,12124,2004,t2,cantonales
7465,38,ISERE,16259,9768,1363,8405,2004,t2,cantonales
7466,38,ISERE,12262,7621,417,7204,2004,t2,cantonales
7467,38,ISERE,13064,8605,200,8405,2004,t2,cantonales
7468,38,ISERE,2549,2026,119,1907,2004,t2,cantonales
7469,38,ISERE,16390,10567,260,10307,2004,t2,cantonales
7470,38,ISERE,9925,6899,401,6498,2004,t2,cantonales
7471,38,ISERE,29817,19084,600,18484,2004,t2,cantonales
7472,38,ISERE,6428,4256,197,4059,2004,t2,cantonales
7473,38,ISERE,15006,9930,395,9535,2004,t2,cantonales
7474,38,ISERE,16759,10888,578,10310,2004,t2,cantonales
7475,38,ISERE,1871,1498,18,1480,2004,t2,cantonales
7476,38,ISERE,11068,6971,197,6774,2004,t2,cantonales
7477,38,ISERE,20729,13818,406,13412,2004,t2,cantonales
7478,38,ISERE,8429,5936,218,5718,2004,t2,cantonales
7479,38,ISERE,29332,19619,1114,18505,2004,t2,cantonales
7480,38,ISERE,7913,4802,1184,3618,2004,t2,cantonales
7481,38,ISERE,17510,11580,601,10979,2004,t2,cantonales
7482,38,ISERE,8807,5585,353,5232,2004,t2,cantonales
7483,38,ISERE,10451,6104,368,5736,2004,t2,cantonales
7484,39,JURA,4854,3721,254,3467,2004,t2,cantonales
7485,39,JURA,3324,2505,94,2411,2004,t2,cantonales
7486,39,JURA,4706,3390,217,3173,2004,t2,cantonales
7487,39,JURA,1973,1404,72,1332,2004,t2,cantonales
7488,39,JURA,7541,5344,300,5044,2004,t2,cantonales
7489,39,JURA,4559,3232,120,3112,2004,t2,cantonales
7490,39,JURA,12718,8954,442,8512,2004,t2,cantonales
7491,39,JURA,10120,6474,375,6099,2004,t2,cantonales
7492,39,JURA,4128,2991,122,2869,2004,t2,cantonales
7493,39,JURA,3482,2734,156,2578,2004,t2,cantonales
7494,39,JURA,2273,1724,123,1601,2004,t2,cantonales
7495,39,JURA,9442,5800,279,5521,2004,t2,cantonales
7496,39,JURA,2420,1810,120,1690,2004,t2,cantonales
7497,39,JURA,2445,1842,78,1764,2004,t2,cantonales
7498,40,LANDES,5582,4497,192,4305,2004,t2,cantonales
7499,40,LANDES,7723,5965,233,5732,2004,t2,cantonales
7500,40,LANDES,14704,10028,701,9327,2004,t2,cantonales
7501,40,LANDES,2900,2366,146,2220,2004,t2,cantonales
7502,40,LANDES,3516,2788,83,2705,2004,t2,cantonales
7503,40,LANDES,7331,5952,207,5745,2004,t2,cantonales
7504,40,LANDES,12068,7709,637,7072,2004,t2,cantonales
7505,40,LANDES,7955,5951,343,5608,2004,t2,cantonales
7506,40,LANDES,19450,12930,828,12102,2004,t2,cantonales
7507,40,LANDES,22557,15066,1116,13950,2004,t2,cantonales
7508,41,LOIR ET CHER,9238,6229,311,5918,2004,t2,cantonales
7509,41,LOIR ET CHER,12118,8039,237,7802,2004,t2,cantonales
7510,41,LOIR ET CHER,4498,3193,333,2860,2004,t2,cantonales
7511,41,LOIR ET CHER,7256,5154,310,4844,2004,t2,cantonales
7512,41,LOIR ET CHER,3895,2948,159,2789,2004,t2,cantonales
7513,41,LOIR ET CHER,10926,6850,549,6301,2004,t2,cantonales
7514,41,LOIR ET CHER,4632,3156,179,2977,2004,t2,cantonales
7515,41,LOIR ET CHER,9709,6008,345,5663,2004,t2,cantonales
7516,41,LOIR ET CHER,5171,2620,112,2508,2004,t2,cantonales
7517,41,LOIR ET CHER,11084,7436,484,6952,2004,t2,cantonales
7518,41,LOIR ET CHER,6831,4354,166,4188,2004,t2,cantonales
7519,42,LOIRE,4867,3603,219,3384,2004,t2,cantonales
7520,42,LOIRE,7178,5116,231,4885,2004,t2,cantonales
7521,42,LOIRE,17704,11257,546,10711,2004,t2,cantonales
7522,42,LOIRE,19424,12881,689,12192,2004,t2,cantonales
7523,42,LOIRE,3398,2472,89,2383,2004,t2,cantonales
7524,42,LOIRE,11188,7319,431,6888,2004,t2,cantonales
7525,42,LOIRE,16531,10765,543,10222,2004,t2,cantonales
7526,42,LOIRE,21875,13364,794,12570,2004,t2,cantonales
7527,42,LOIRE,6022,4127,106,4021,2004,t2,cantonales
7528,42,LOIRE,12811,8060,207,7853,2004,t2,cantonales
7529,42,LOIRE,12122,6893,340,6553,2004,t2,cantonales
7530,42,LOIRE,20830,13233,287,12946,2004,t2,cantonales
7531,42,LOIRE,3464,2555,122,2433,2004,t2,cantonales
7532,42,LOIRE,20209,13944,684,13260,2004,t2,cantonales
7533,42,LOIRE,4048,2709,163,2546,2004,t2,cantonales
7534,42,LOIRE,13655,8114,401,7713,2004,t2,cantonales
7535,42,LOIRE,7070,4030,181,3849,2004,t2,cantonales
7536,42,LOIRE,10310,5873,335,5538,2004,t2,cantonales
7537,42,LOIRE,10243,6351,153,6198,2004,t2,cantonales
7538,43,HAUTE LOIRE,7262,4982,216,4766,2004,t2,cantonales
7539,43,HAUTE LOIRE,1877,1484,62,1422,2004,t2,cantonales
7540,43,HAUTE LOIRE,5495,4061,212,3849,2004,t2,cantonales
7541,43,HAUTE LOIRE,9610,6575,286,6289,2004,t2,cantonales
7542,43,HAUTE LOIRE,2744,2233,78,2155,2004,t2,cantonales
7543,43,HAUTE LOIRE,5349,3942,239,3703,2004,t2,cantonales
7544,43,HAUTE LOIRE,4862,3184,178,3006,2004,t2,cantonales
7545,44,LOIRE ATLANTIQUE,16313,11016,502,10514,2004,t2,cantonales
7546,44,LOIRE ATLANTIQUE,12024,8207,325,7882,2004,t2,cantonales
7547,44,LOIRE ATLANTIQUE,27388,18944,550,18394,2004,t2,cantonales
7548,44,LOIRE ATLANTIQUE,14453,9776,531,9245,2004,t2,cantonales
7549,44,LOIRE ATLANTIQUE,6265,4721,209,4512,2004,t2,cantonales
7550,44,LOIRE ATLANTIQUE,15572,10234,336,9898,2004,t2,cantonales
7551,44,LOIRE ATLANTIQUE,16454,10035,283,9752,2004,t2,cantonales
7552,44,LOIRE ATLANTIQUE,16412,9237,271,8966,2004,t2,cantonales
7553,44,LOIRE ATLANTIQUE,12907,7503,244,7259,2004,t2,cantonales
7554,44,LOIRE ATLANTIQUE,15679,10756,515,10241,2004,t2,cantonales
7555,44,LOIRE ATLANTIQUE,10870,7465,227,7238,2004,t2,cantonales
7556,44,LOIRE ATLANTIQUE,18665,12597,568,12029,2004,t2,cantonales
7557,44,LOIRE ATLANTIQUE,4818,3615,180,3435,2004,t2,cantonales
7558,44,LOIRE ATLANTIQUE,3157,2380,76,2304,2004,t2,cantonales
7559,44,LOIRE ATLANTIQUE,13327,7868,332,7536,2004,t2,cantonales
7560,44,LOIRE ATLANTIQUE,14320,9581,609,8972,2004,t2,cantonales
7561,44,LOIRE ATLANTIQUE,20354,14378,390,13988,2004,t2,cantonales
7562,44,LOIRE ATLANTIQUE,19609,12194,351,11843,2004,t2,cantonales
7563,44,LOIRE ATLANTIQUE,16094,9891,522,9369,2004,t2,cantonales
7564,44,LOIRE ATLANTIQUE,14421,8933,321,8612,2004,t2,cantonales
7565,44,LOIRE ATLANTIQUE,23926,16118,388,15730,2004,t2,cantonales
7566,44,LOIRE ATLANTIQUE,22619,13913,541,13372,2004,t2,cantonales
7567,44,LOIRE ATLANTIQUE,11319,6497,218,6279,2004,t2,cantonales
7568,45,LOIRET,6258,4224,125,4099,2004,t2,cantonales
7569,45,LOIRET,8548,5550,202,5348,2004,t2,cantonales
7570,45,LOIRET,13249,8849,285,8564,2004,t2,cantonales
7571,45,LOIRET,7410,4920,147,4773,2004,t2,cantonales
7572,45,LOIRET,12085,8087,500,7587,2004,t2,cantonales
7573,45,LOIRET,6096,4433,104,4329,2004,t2,cantonales
7574,45,LOIRET,7174,4492,139,4353,2004,t2,cantonales
7575,45,LOIRET,12929,8236,444,7792,2004,t2,cantonales
7576,45,LOIRET,8384,4791,892,3899,2004,t2,cantonales
7577,45,LOIRET,9660,5671,189,5482,2004,t2,cantonales
7578,45,LOIRET,11211,6826,288,6538,2004,t2,cantonales
7579,45,LOIRET,15048,9888,464,9424,2004,t2,cantonales
7580,45,LOIRET,4722,3151,351,2800,2004,t2,cantonales
7581,45,LOIRET,12937,8378,313,8065,2004,t2,cantonales
7582,45,LOIRET,13240,8538,476,8062,2004,t2,cantonales
7583,45,LOIRET,13378,8846,461,8385,2004,t2,cantonales
7584,45,LOIRET,13210,8775,406,8369,2004,t2,cantonales
7585,46,LOT,5183,3648,261,3387,2004,t2,cantonales
7586,46,LOT,2064,1623,113,1510,2004,t2,cantonales
7587,46,LOT,5694,4344,173,4171,2004,t2,cantonales
7588,46,LOT,1416,1177,34,1143,2004,t2,cantonales
7589,46,LOT,5799,4579,224,4355,2004,t2,cantonales
7590,46,LOT,1302,1095,24,1071,2004,t2,cantonales
7591,46,LOT,8221,5640,535,5105,2004,t2,cantonales
7592,47,LOT ET GARONNE ,7089,5061,164,4897,2004,t2,cantonales
7593,47,LOT ET GARONNE ,1885,1545,67,1478,2004,t2,cantonales
7594,47,LOT ET GARONNE ,2090,1697,116,1581,2004,t2,cantonales
7595,47,LOT ET GARONNE ,4469,3394,187,3207,2004,t2,cantonales
7596,47,LOT ET GARONNE ,3693,2936,200,2736,2004,t2,cantonales
7597,47,LOT ET GARONNE ,3667,2798,201,2597,2004,t2,cantonales
7598,47,LOT ET GARONNE ,8110,6337,311,6026,2004,t2,cantonales
7599,47,LOT ET GARONNE ,2995,2407,124,2283,2004,t2,cantonales
7600,47,LOT ET GARONNE ,11469,7900,759,7141,2004,t2,cantonales
7601,47,LOT ET GARONNE ,3603,2758,207,2551,2004,t2,cantonales
7602,47,LOT ET GARONNE ,3041,2434,101,2333,2004,t2,cantonales
7603,47,LOT ET GARONNE ,4487,3581,217,3364,2004,t2,cantonales
7604,47,LOT ET GARONNE ,5802,4270,248,4022,2004,t2,cantonales
7605,47,LOT ET GARONNE ,9947,7130,252,6878,2004,t2,cantonales
7606,47,LOT ET GARONNE ,11315,7738,670,7068,2004,t2,cantonales
7607,47,LOT ET GARONNE ,8689,6083,537,5546,2004,t2,cantonales
7608,47,LOT ET GARONNE ,11969,8427,422,8005,2004,t2,cantonales
7609,47,LOT ET GARONNE ,9155,6488,517,5971,2004,t2,cantonales
7610,48,LOZERE,1865,1536,52,1484,2004,t2,cantonales
7611,48,LOZERE,3739,2830,240,2590,2004,t2,cantonales
7612,48,LOZERE,1136,943,38,905,2004,t2,cantonales
7613,49,MAINE ET LOIRE ,7954,5261,286,4975,2004,t2,cantonales
7614,49,MAINE ET LOIRE ,8269,5873,205,5668,2004,t2,cantonales
7615,49,MAINE ET LOIRE ,18262,10582,2548,8034,2004,t2,cantonales
7616,49,MAINE ET LOIRE ,10046,6320,358,5962,2004,t2,cantonales
7617,49,MAINE ET LOIRE ,7004,4791,253,4538,2004,t2,cantonales
7618,49,MAINE ET LOIRE ,27959,19133,1043,18090,2004,t2,cantonales
7619,49,MAINE ET LOIRE ,7466,5362,323,5039,2004,t2,cantonales
7620,49,MAINE ET LOIRE ,12597,8666,614,8052,2004,t2,cantonales
7621,49,MAINE ET LOIRE ,7702,4865,238,4627,2004,t2,cantonales
7622,49,MAINE ET LOIRE ,20638,13405,636,12769,2004,t2,cantonales
7623,49,MAINE ET LOIRE ,17760,10673,552,10121,2004,t2,cantonales
7624,49,MAINE ET LOIRE ,15407,9040,395,8645,2004,t2,cantonales
7625,49,MAINE ET LOIRE ,20869,12929,541,12388,2004,t2,cantonales
7626,50,MANCHE,8404,5547,208,5339,2004,t2,cantonales
7627,50,MANCHE,8859,5584,335,5249,2004,t2,cantonales
7628,50,MANCHE,8547,5492,277,5215,2004,t2,cantonales
7629,50,MANCHE,6183,4144,153,3991,2004,t2,cantonales
7630,50,MANCHE,2451,2035,62,1973,2004,t2,cantonales
7631,50,MANCHE,4624,3279,138,3141,2004,t2,cantonales
7632,50,MANCHE,4844,3221,207,3014,2004,t2,cantonales
7633,50,MANCHE,5841,3705,237,3468,2004,t2,cantonales
7634,50,MANCHE,6705,4341,261,4080,2004,t2,cantonales
7635,50,MANCHE,3952,3019,137,2882,2004,t2,cantonales
7636,50,MANCHE,9058,6154,435,5719,2004,t2,cantonales
7637,50,MANCHE,9993,6636,313,6323,2004,t2,cantonales
7638,50,MANCHE,7112,4199,165,4034,2004,t2,cantonales
7639,50,MANCHE,17729,10835,661,10174,2004,t2,cantonales
7640,50,MANCHE,9617,6436,270,6166,2004,t2,cantonales
7641,51,MARNE,7325,4797,226,4571,2004,t2,cantonales
7642,51,MARNE,8980,5039,307,4732,2004,t2,cantonales
7643,51,MARNE,18369,10843,461,10382,2004,t2,cantonales
7644,51,MARNE,8890,5236,246,4990,2004,t2,cantonales
7645,51,MARNE,6659,4533,308,4225,2004,t2,cantonales
7646,51,MARNE,8615,5476,420,5056,2004,t2,cantonales
7647,51,MARNE,9595,6509,852,5657,2004,t2,cantonales
7648,51,MARNE,9173,6049,142,5907,2004,t2,cantonales
7649,51,MARNE,10667,6008,379,5629,2004,t2,cantonales
7650,51,MARNE,14707,8290,782,7508,2004,t2,cantonales
7651,51,MARNE,14088,8245,353,7892,2004,t2,cantonales
7652,51,MARNE,9010,5441,643,4798,2004,t2,cantonales
7653,51,MARNE,12945,6992,342,6650,2004,t2,cantonales
7654,51,MARNE,11511,6417,370,6047,2004,t2,cantonales
7655,52,HAUTE MARNE,2269,1762,130,1632,2004,t2,cantonales
7656,52,HAUTE MARNE,1575,1218,60,1158,2004,t2,cantonales
7657,52,HAUTE MARNE,9176,5733,370,5363,2004,t2,cantonales
7658,52,HAUTE MARNE,2075,1506,116,1390,2004,t2,cantonales
7659,52,HAUTE MARNE,2491,1781,156,1625,2004,t2,cantonales
7660,52,HAUTE MARNE,9710,6197,595,5602,2004,t2,cantonales
7661,52,HAUTE MARNE,8569,4716,176,4540,2004,t2,cantonales
7662,52,HAUTE MARNE,6060,3790,186,3604,2004,t2,cantonales
7663,52,HAUTE MARNE,7849,4946,150,4796,2004,t2,cantonales
7664,53,MAYENNE,4157,3035,160,2875,2004,t2,cantonales
7665,53,MAYENNE,6893,4713,295,4418,2004,t2,cantonales
7666,53,MAYENNE,6498,4269,190,4079,2004,t2,cantonales
7667,53,MAYENNE,8253,5519,363,5156,2004,t2,cantonales
7668,53,MAYENNE,5619,3675,274,3401,2004,t2,cantonales
7669,53,MAYENNE,10263,7019,256,6763,2004,t2,cantonales
7670,53,MAYENNE,7849,5043,230,4813,2004,t2,cantonales
7671,53,MAYENNE,11075,7559,302,7257,2004,t2,cantonales
7672,53,MAYENNE,10924,7367,540,6827,2004,t2,cantonales
7673,53,MAYENNE,9811,6715,328,6387,2004,t2,cantonales
7674,53,MAYENNE,4702,2918,127,2791,2004,t2,cantonales
7675,53,MAYENNE,11808,7947,329,7618,2004,t2,cantonales
7676,54,MEURTHE ET MOSELLE,1125,902,35,867,2004,t2,cantonales
7677,54,MEURTHE ET MOSELLE,14591,8269,2032,6237,2004,t2,cantonales
7678,54,MEURTHE ET MOSELLE,4274,3073,176,2897,2004,t2,cantonales
7679,54,MEURTHE ET MOSELLE,14210,8897,674,8223,2004,t2,cantonales
7680,54,MEURTHE ET MOSELLE,6316,4598,299,4299,2004,t2,cantonales
7681,54,MEURTHE ET MOSELLE,9394,5817,347,5470,2004,t2,cantonales
7682,54,MEURTHE ET MOSELLE,10373,5775,191,5584,2004,t2,cantonales
7683,54,MEURTHE ET MOSELLE,11414,6792,288,6504,2004,t2,cantonales
7684,54,MEURTHE ET MOSELLE,12041,7229,272,6957,2004,t2,cantonales
7685,54,MEURTHE ET MOSELLE,7102,4821,211,4610,2004,t2,cantonales
7686,54,MEURTHE ET MOSELLE,13125,8210,404,7806,2004,t2,cantonales
7687,54,MEURTHE ET MOSELLE,18773,12135,549,11586,2004,t2,cantonales
7688,54,MEURTHE ET MOSELLE,3282,2380,68,2312,2004,t2,cantonales
7689,54,MEURTHE ET MOSELLE,9555,6452,494,5958,2004,t2,cantonales
7690,54,MEURTHE ET MOSELLE,11501,6509,533,5976,2004,t2,cantonales
7691,54,MEURTHE ET MOSELLE,17374,11193,576,10617,2004,t2,cantonales
7692,54,MEURTHE ET MOSELLE,16167,10595,662,9933,2004,t2,cantonales
7693,54,MEURTHE ET MOSELLE,12694,8454,401,8053,2004,t2,cantonales
7694,55,MEUSE,7617,5169,164,5005,2004,t2,cantonales
7695,55,MEUSE,8009,5471,262,5209,2004,t2,cantonales
7696,55,MEUSE,2460,1985,49,1936,2004,t2,cantonales
7697,55,MEUSE,3703,2630,76,2554,2004,t2,cantonales
7698,55,MEUSE,5630,3885,173,3712,2004,t2,cantonales
7699,55,MEUSE,1621,1345,49,1296,2004,t2,cantonales
7700,55,MEUSE,2303,1710,139,1571,2004,t2,cantonales
7701,55,MEUSE,2998,2293,220,2073,2004,t2,cantonales
7702,55,MEUSE,7043,3985,155,3830,2004,t2,cantonales
7703,56,MORBIHAN,5434,4123,176,3947,2004,t2,cantonales
7704,56,MORBIHAN,14348,8739,524,8215,2004,t2,cantonales
7705,56,MORBIHAN,10729,7451,372,7079,2004,t2,cantonales
7706,56,MORBIHAN,13371,9104,397,8707,2004,t2,cantonales
7707,56,MORBIHAN,18770,13206,600,12606,2004,t2,cantonales
7708,56,MORBIHAN,20504,14250,637,13613,2004,t2,cantonales
7709,56,MORBIHAN,10667,8214,235,7979,2004,t2,cantonales
7710,56,MORBIHAN,14137,9659,1058,8601,2004,t2,cantonales
7711,56,MORBIHAN,10419,7341,294,7047,2004,t2,cantonales
7712,56,MORBIHAN,6436,4797,143,4654,2004,t2,cantonales
7713,56,MORBIHAN,7529,4985,1587,3398,2004,t2,cantonales
7714,56,MORBIHAN,10608,7779,398,7381,2004,t2,cantonales
7715,56,MORBIHAN,4130,3167,242,2925,2004,t2,cantonales
7716,56,MORBIHAN,21652,14699,587,14112,2004,t2,cantonales
7717,56,MORBIHAN,15884,10486,317,10169,2004,t2,cantonales
7718,56,MORBIHAN,16289,10166,1224,8942,2004,t2,cantonales
7719,56,MORBIHAN,22616,14923,620,14303,2004,t2,cantonales
7720,57,MOSELLE,10121,6380,511,5869,2004,t2,cantonales
7721,57,MOSELLE,15696,8702,605,8097,2004,t2,cantonales
7722,57,MOSELLE,4831,3433,147,3286,2004,t2,cantonales
7723,57,MOSELLE,3871,2710,165,2545,2004,t2,cantonales
7724,57,MOSELLE,16537,9393,358,9035,2004,t2,cantonales
7725,57,MOSELLE,13786,6782,393,6389,2004,t2,cantonales
7726,57,MOSELLE,15695,9727,583,9144,2004,t2,cantonales
7727,57,MOSELLE,13094,6947,340,6607,2004,t2,cantonales
7728,57,MOSELLE,15542,8063,488,7575,2004,t2,cantonales
7729,57,MOSELLE,19393,11743,383,11360,2004,t2,cantonales
7730,57,MOSELLE,16227,8022,572,7450,2004,t2,cantonales
7731,57,MOSELLE,22263,13301,777,12524,2004,t2,cantonales
7732,57,MOSELLE,19516,11331,693,10638,2004,t2,cantonales
7733,57,MOSELLE,19060,11695,604,11091,2004,t2,cantonales
7734,57,MOSELLE,12591,6606,427,6179,2004,t2,cantonales
7735,57,MOSELLE,13159,7572,396,7176,2004,t2,cantonales
7736,57,MOSELLE,16329,10525,808,9717,2004,t2,cantonales
7737,57,MOSELLE,16513,9639,536,9103,2004,t2,cantonales
7738,57,MOSELLE,19636,11757,910,10847,2004,t2,cantonales
7739,57,MOSELLE,19914,11125,265,10860,2004,t2,cantonales
7740,58,NIEVRE,8051,5316,401,4915,2004,t2,cantonales
7741,58,NIEVRE,6590,4246,422,3824,2004,t2,cantonales
7742,58,NIEVRE,3440,2361,134,2227,2004,t2,cantonales
7743,58,NIEVRE,3471,2560,118,2442,2004,t2,cantonales
7744,58,NIEVRE,9066,5845,385,5460,2004,t2,cantonales
7745,58,NIEVRE,12423,7884,553,7331,2004,t2,cantonales
7746,59,NORD,13600,10265,507,9758,2004,t2,cantonales
7747,59,NORD,37590,23860,1652,22208,2004,t2,cantonales
7748,59,NORD,6407,4286,306,3980,2004,t2,cantonales
7749,59,NORD,13271,9007,561,8446,2004,t2,cantonales
7750,59,NORD,13724,10123,848,9275,2004,t2,cantonales
7751,59,NORD,19098,12758,1255,11503,2004,t2,cantonales
7752,59,NORD,16426,10693,693,10000,2004,t2,cantonales
7753,59,NORD,14151,10525,590,9935,2004,t2,cantonales
7754,59,NORD,7382,5776,222,5554,2004,t2,cantonales
7755,59,NORD,12292,9035,397,8638,2004,t2,cantonales
7756,59,NORD,30498,17916,887,17029,2004,t2,cantonales
7757,59,NORD,20016,14030,832,13198,2004,t2,cantonales
7758,59,NORD,35338,21375,6050,15325,2004,t2,cantonales
7759,59,NORD,28707,19009,1108,17901,2004,t2,cantonales
7760,59,NORD,18441,13075,791,12284,2004,t2,cantonales
7761,59,NORD,17603,11769,1015,10754,2004,t2,cantonales
7762,59,NORD,8155,5956,348,5608,2004,t2,cantonales
7763,59,NORD,46636,30317,1033,29284,2004,t2,cantonales
7764,59,NORD,19033,10529,803,9726,2004,t2,cantonales
7765,59,NORD,30292,17416,1096,16320,2004,t2,cantonales
7766,59,NORD,29683,18935,1138,17797,2004,t2,cantonales
7767,59,NORD,22327,11873,675,11198,2004,t2,cantonales
7768,59,NORD,23488,14619,1005,13614,2004,t2,cantonales
7769,59,NORD,27613,18942,1077,17865,2004,t2,cantonales
7770,59,NORD,19838,10856,618,10238,2004,t2,cantonales
7771,59,NORD,13121,9378,613,8765,2004,t2,cantonales
7772,59,NORD,6896,4589,318,4271,2004,t2,cantonales
7773,59,NORD,42248,26204,879,25325,2004,t2,cantonales
7774,59,NORD,33222,18459,556,17903,2004,t2,cantonales
7775,59,NORD,34072,21388,1157,20231,2004,t2,cantonales
7776,59,NORD,22225,13584,495,13089,2004,t2,cantonales
7777,59,NORD,33568,22264,1582,20682,2004,t2,cantonales
7778,59,NORD,23383,14007,755,13252,2004,t2,cantonales
7779,59,NORD,20765,11127,739,10388,2004,t2,cantonales
7780,59,NORD,19322,12109,751,11358,2004,t2,cantonales
7781,59,NORD,21835,14069,891,13178,2004,t2,cantonales
7782,59,NORD,23853,15484,915,14569,2004,t2,cantonales
7783,60,OISE,10271,6484,191,6293,2004,t2,cantonales
7784,60,OISE,14352,9118,520,8598,2004,t2,cantonales
7785,60,OISE,12252,8253,270,7983,2004,t2,cantonales
7786,60,OISE,16161,10024,277,9747,2004,t2,cantonales
7787,60,OISE,20676,13394,406,12988,2004,t2,cantonales
7788,60,OISE,5297,3955,128,3827,2004,t2,cantonales
7789,60,OISE,4587,3514,120,3394,2004,t2,cantonales
7790,60,OISE,5170,3606,94,3512,2004,t2,cantonales
7791,60,OISE,5636,4127,145,3982,2004,t2,cantonales
7792,60,OISE,10053,6821,215,6606,2004,t2,cantonales
7793,60,OISE,14506,9867,334,9533,2004,t2,cantonales
7794,60,OISE,14723,9957,216,9741,2004,t2,cantonales
7795,60,OISE,17482,11455,282,11173,2004,t2,cantonales
7796,60,OISE,12211,8896,294,8602,2004,t2,cantonales
7797,60,OISE,22651,13812,807,13005,2004,t2,cantonales
7798,60,OISE,5247,3946,253,3693,2004,t2,cantonales
7799,61,ORNE,4543,2949,165,2784,2004,t2,cantonales
7800,61,ORNE,3532,2498,139,2359,2004,t2,cantonales
7801,61,ORNE,9931,6421,331,6090,2004,t2,cantonales
7802,61,ORNE,5447,3807,326,3481,2004,t2,cantonales
7803,61,ORNE,3396,2317,96,2221,2004,t2,cantonales
7804,61,ORNE,5368,3378,246,3132,2004,t2,cantonales
7805,61,ORNE,6578,4662,154,4508,2004,t2,cantonales
7806,61,ORNE,5611,3827,319,3508,2004,t2,cantonales
7807,61,ORNE,6480,4260,117,4143,2004,t2,cantonales
7808,61,ORNE,9533,6641,227,6414,2004,t2,cantonales
7809,61,ORNE,7286,4722,464,4258,2004,t2,cantonales
7810,62,PAS DE CALAIS,13888,9975,819,9156,2004,t2,cantonales
7811,62,PAS DE CALAIS,13082,8681,657,8024,2004,t2,cantonales
7812,62,PAS DE CALAIS,22743,15880,1551,14329,2004,t2,cantonales
7813,62,PAS DE CALAIS,17797,11965,1149,10816,2004,t2,cantonales
7814,62,PAS DE CALAIS,6651,5122,396,4726,2004,t2,cantonales
7815,62,PAS DE CALAIS,9532,7355,457,6898,2004,t2,cantonales
7816,62,PAS DE CALAIS,16808,10720,748,9972,2004,t2,cantonales
7817,62,PAS DE CALAIS,18926,11420,821,10599,2004,t2,cantonales
7818,62,PAS DE CALAIS,19722,11364,952,10412,2004,t2,cantonales
7819,62,PAS DE CALAIS,13967,9548,886,8662,2004,t2,cantonales
7820,62,PAS DE CALAIS,8146,6842,390,6452,2004,t2,cantonales
7821,62,PAS DE CALAIS,16872,10905,875,10030,2004,t2,cantonales
7822,62,PAS DE CALAIS,11008,8616,534,8082,2004,t2,cantonales
7823,62,PAS DE CALAIS,14575,8921,560,8361,2004,t2,cantonales
7824,62,PAS DE CALAIS,15084,9214,2562,6652,2004,t2,cantonales
7825,62,PAS DE CALAIS,16777,12336,1148,11188,2004,t2,cantonales
7826,62,PAS DE CALAIS,5960,4496,343,4153,2004,t2,cantonales
7827,62,PAS DE CALAIS,11196,8304,674,7630,2004,t2,cantonales
7828,62,PAS DE CALAIS,17611,12981,841,12140,2004,t2,cantonales
7829,62,PAS DE CALAIS,20862,13819,3765,10054,2004,t2,cantonales
7830,62,PAS DE CALAIS,16153,9833,692,9141,2004,t2,cantonales
7831,62,PAS DE CALAIS,15394,9032,2125,6907,2004,t2,cantonales
7832,62,PAS DE CALAIS,15248,10008,987,9021,2004,t2,cantonales
7833,62,PAS DE CALAIS,16377,9103,2741,6362,2004,t2,cantonales
7834,62,PAS DE CALAIS,13866,9238,543,8695,2004,t2,cantonales
7835,62,PAS DE CALAIS,18214,11301,2504,8797,2004,t2,cantonales
7836,62,PAS DE CALAIS,13698,8639,646,7993,2004,t2,cantonales
7837,62,PAS DE CALAIS,13518,7878,471,7407,2004,t2,cantonales
7838,62,PAS DE CALAIS,14249,7208,2349,4859,2004,t2,cantonales
7839,62,PAS DE CALAIS,17865,11877,621,11256,2004,t2,cantonales
7840,62,PAS DE CALAIS,15607,10226,938,9288,2004,t2,cantonales
7841,62,PAS DE CALAIS,14007,10227,535,9692,2004,t2,cantonales
7842,62,PAS DE CALAIS,14308,9418,777,8641,2004,t2,cantonales
7843,62,PAS DE CALAIS,14159,8590,512,8078,2004,t2,cantonales
7844,62,PAS DE CALAIS,13166,8434,333,8101,2004,t2,cantonales
7845,63,PUY DE DOME,8540,5945,323,5622,2004,t2,cantonales
7846,63,PUY DE DOME,7069,5171,361,4810,2004,t2,cantonales
7847,63,PUY DE DOME,10248,6533,306,6227,2004,t2,cantonales
7848,63,PUY DE DOME,5177,3891,168,3723,2004,t2,cantonales
7849,63,PUY DE DOME,1924,1546,84,1462,2004,t2,cantonales
7850,63,PUY DE DOME,15046,9966,3840,6126,2004,t2,cantonales
7851,63,PUY DE DOME,9730,6992,461,6531,2004,t2,cantonales
7852,63,PUY DE DOME,7690,5646,477,5169,2004,t2,cantonales
7853,63,PUY DE DOME,6744,5214,184,5030,2004,t2,cantonales
7854,63,PUY DE DOME,2343,1885,102,1783,2004,t2,cantonales
7855,63,PUY DE DOME,15001,10393,639,9754,2004,t2,cantonales
7856,63,PUY DE DOME,4442,3628,97,3531,2004,t2,cantonales
7857,63,PUY DE DOME,12894,9193,573,8620,2004,t2,cantonales
7858,63,PUY DE DOME,1300,977,39,938,2004,t2,cantonales
7859,63,PUY DE DOME,2235,1617,44,1573,2004,t2,cantonales
7860,63,PUY DE DOME,3680,2833,157,2676,2004,t2,cantonales
7861,63,PUY DE DOME,6885,4893,295,4598,2004,t2,cantonales
7862,63,PUY DE DOME,10014,6789,641,6148,2004,t2,cantonales
7863,63,PUY DE DOME,17470,12561,499,12062,2004,t2,cantonales
7864,63,PUY DE DOME,9632,6986,399,6587,2004,t2,cantonales
7865,63,PUY DE DOME,9689,6561,315,6246,2004,t2,cantonales
7866,63,PUY DE DOME,6363,3767,134,3633,2004,t2,cantonales
7867,63,PUY DE DOME,8050,4992,292,4700,2004,t2,cantonales
7868,63,PUY DE DOME,14760,10143,605,9538,2004,t2,cantonales
7869,63,PUY DE DOME,12365,8471,591,7880,2004,t2,cantonales
7870,63,PUY DE DOME,12946,9062,582,8480,2004,t2,cantonales
7871,64,PYRENEES ATLANTIQUES,2769,2383,167,2216,2004,t2,cantonales
7872,64,PYRENEES ATLANTIQUES,6930,4222,245,3977,2004,t2,cantonales
7873,64,PYRENEES ATLANTIQUES,11838,7255,519,6736,2004,t2,cantonales
7874,64,PYRENEES ATLANTIQUES,6410,4814,1030,3784,2004,t2,cantonales
7875,64,PYRENEES ATLANTIQUES,4720,3530,119,3411,2004,t2,cantonales
7876,64,PYRENEES ATLANTIQUES,3035,2569,92,2477,2004,t2,cantonales
7877,64,PYRENEES ATLANTIQUES,22746,16319,894,15425,2004,t2,cantonales
7878,64,PYRENEES ATLANTIQUES,4697,3645,194,3451,2004,t2,cantonales
7879,64,PYRENEES ATLANTIQUES,11675,8761,635,8126,2004,t2,cantonales
7880,64,PYRENEES ATLANTIQUES,9347,7289,357,6932,2004,t2,cantonales
7881,64,PYRENEES ATLANTIQUES,13794,8562,532,8030,2004,t2,cantonales
7882,64,PYRENEES ATLANTIQUES,5267,4274,200,4074,2004,t2,cantonales
7883,64,PYRENEES ATLANTIQUES,3005,2288,129,2159,2004,t2,cantonales
7884,64,PYRENEES ATLANTIQUES,12381,8271,436,7835,2004,t2,cantonales
7885,64,PYRENEES ATLANTIQUES,12567,7665,428,7237,2004,t2,cantonales
7886,64,PYRENEES ATLANTIQUES,10543,5742,382,5360,2004,t2,cantonales
7887,64,PYRENEES ATLANTIQUES,14672,10612,475,10137,2004,t2,cantonales
7888,64,PYRENEES ATLANTIQUES,10967,7299,335,6964,2004,t2,cantonales
7889,65,HAUTES PYRENEES,3007,2302,127,2175,2004,t2,cantonales
7890,65,HAUTES PYRENEES,1872,1558,56,1502,2004,t2,cantonales
7891,65,HAUTES PYRENEES,9348,6812,398,6414,2004,t2,cantonales
7892,65,HAUTES PYRENEES,3574,2652,70,2582,2004,t2,cantonales
7893,65,HAUTES PYRENEES,1684,1436,50,1386,2004,t2,cantonales
7894,65,HAUTES PYRENEES,7340,5173,365,4808,2004,t2,cantonales
7895,65,HAUTES PYRENEES,5481,3683,142,3541,2004,t2,cantonales
7896,65,HAUTES PYRENEES,6195,4084,225,3859,2004,t2,cantonales
7897,65,HAUTES PYRENEES,4975,3387,166,3221,2004,t2,cantonales
7898,65,HAUTES PYRENEES,8235,5860,795,5065,2004,t2,cantonales
7899,66,PYRENEES ORIENTALES,19245,13819,507,13312,2004,t2,cantonales
7900,66,PYRENEES ORIENTALES,3641,2841,98,2743,2004,t2,cantonales
7901,66,PYRENEES ORIENTALES,7351,4993,140,4853,2004,t2,cantonales
7902,66,PYRENEES ORIENTALES,5403,3247,196,3051,2004,t2,cantonales
7903,66,PYRENEES ORIENTALES,9866,6968,530,6438,2004,t2,cantonales
7904,66,PYRENEES ORIENTALES,2289,1908,52,1856,2004,t2,cantonales
7905,66,PYRENEES ORIENTALES,16091,12063,593,11470,2004,t2,cantonales
7906,66,PYRENEES ORIENTALES,15189,11322,287,11035,2004,t2,cantonales
7907,66,PYRENEES ORIENTALES,1065,915,38,877,2004,t2,cantonales
7908,66,PYRENEES ORIENTALES,14090,10540,577,9963,2004,t2,cantonales
7909,66,PYRENEES ORIENTALES,10684,7688,509,7179,2004,t2,cantonales
7910,66,PYRENEES ORIENTALES,11687,7641,473,7168,2004,t2,cantonales
7911,66,PYRENEES ORIENTALES,13224,9148,264,8884,2004,t2,cantonales
7912,66,PYRENEES ORIENTALES,7907,4627,815,3812,2004,t2,cantonales
7913,66,PYRENEES ORIENTALES,15438,10981,318,10663,2004,t2,cantonales
7914,67,BAS RHIN,23271,14296,820,13476,2004,t2,cantonales
7915,67,BAS RHIN,8626,5898,449,5449,2004,t2,cantonales
7916,67,BAS RHIN,20973,12258,461,11797,2004,t2,cantonales
7917,67,BAS RHIN,2890,2160,37,2123,2004,t2,cantonales
7918,67,BAS RHIN,16853,10120,705,9415,2004,t2,cantonales
7919,67,BAS RHIN,15542,8860,531,8329,2004,t2,cantonales
7920,67,BAS RHIN,10101,6870,268,6602,2004,t2,cantonales
7921,67,BAS RHIN,20850,13419,758,12661,2004,t2,cantonales
7922,67,BAS RHIN,9449,5454,700,4754,2004,t2,cantonales
7923,67,BAS RHIN,15624,10773,537,10236,2004,t2,cantonales
7924,67,BAS RHIN,8238,5717,590,5127,2004,t2,cantonales
7925,67,BAS RHIN,15809,10375,413,9962,2004,t2,cantonales
7926,67,BAS RHIN,17199,9848,502,9346,2004,t2,cantonales
7927,67,BAS RHIN,12519,7282,376,6906,2004,t2,cantonales
7928,67,BAS RHIN,14051,8482,400,8082,2004,t2,cantonales
7929,67,BAS RHIN,10269,5765,612,5153,2004,t2,cantonales
7930,67,BAS RHIN,35561,20988,1358,19630,2004,t2,cantonales
7931,67,BAS RHIN,33578,20568,1384,19184,2004,t2,cantonales
7932,68,HAUT RHIN,16841,10885,562,10323,2004,t2,cantonales
7933,68,HAUT RHIN,17582,12030,1311,10719,2004,t2,cantonales
7934,68,HAUT RHIN,17843,12211,491,11720,2004,t2,cantonales
7935,68,HAUT RHIN,14070,9106,391,8715,2004,t2,cantonales
7936,68,HAUT RHIN,23388,14228,857,13371,2004,t2,cantonales
7937,68,HAUT RHIN,30853,17622,1697,15925,2004,t2,cantonales
7938,68,HAUT RHIN,12351,8648,370,8278,2004,t2,cantonales
7939,68,HAUT RHIN,15480,9735,1042,8693,2004,t2,cantonales
7940,68,HAUT RHIN,8554,5926,211,5715,2004,t2,cantonales
7941,68,HAUT RHIN,12567,8224,493,7731,2004,t2,cantonales
7942,68,HAUT RHIN,10244,7529,342,7187,2004,t2,cantonales
7943,68,HAUT RHIN,7305,5042,217,4825,2004,t2,cantonales
7944,68,HAUT RHIN,14488,10003,1017,8986,2004,t2,cantonales
7945,69,RHONE,16345,10868,230,10638,2004,t2,cantonales
7946,69,RHONE,24844,16451,818,15633,2004,t2,cantonales
7947,69,RHONE,8715,5854,581,5273,2004,t2,cantonales
7948,69,RHONE,21884,14230,1082,13148,2004,t2,cantonales
7949,69,RHONE,4543,3241,265,2976,2004,t2,cantonales
7950,69,RHONE,20831,14266,602,13664,2004,t2,cantonales
7951,69,RHONE,26633,17569,715,16854,2004,t2,cantonales
7952,69,RHONE,14191,9470,331,9139,2004,t2,cantonales
7953,69,RHONE,15425,9996,424,9572,2004,t2,cantonales
7954,69,RHONE,18128,11161,668,10493,2004,t2,cantonales
7955,69,RHONE,8606,6258,362,5896,2004,t2,cantonales
7956,69,RHONE,31937,21043,929,20114,2004,t2,cantonales
7957,69,RHONE,20398,12356,996,11360,2004,t2,cantonales
7958,69,RHONE,20729,12352,768,11584,2004,t2,cantonales
7959,69,RHONE,32643,20737,476,20261,2004,t2,cantonales
7960,69,RHONE,19109,11831,735,11096,2004,t2,cantonales
7961,69,RHONE,15303,9992,478,9514,2004,t2,cantonales
7962,69,RHONE,22649,13512,369,13143,2004,t2,cantonales
7963,69,RHONE,15328,8454,530,7924,2004,t2,cantonales
7964,69,RHONE,23057,14036,1312,12724,2004,t2,cantonales
7965,69,RHONE,19968,12382,420,11962,2004,t2,cantonales
7966,69,RHONE,14597,9467,415,9052,2004,t2,cantonales
7967,69,RHONE,16003,9880,689,9191,2004,t2,cantonales
7968,70,HAUTE SAONE,4040,3142,122,3020,2004,t2,cantonales
7969,70,HAUTE SAONE,9006,6319,357,5962,2004,t2,cantonales
7970,70,HAUTE SAONE,2319,1892,74,1818,2004,t2,cantonales
7971,70,HAUTE SAONE,2669,2141,111,2030,2004,t2,cantonales
7972,70,HAUTE SAONE,3598,2983,169,2814,2004,t2,cantonales
7973,70,HAUTE SAONE,3414,2680,206,2474,2004,t2,cantonales
7974,70,HAUTE SAONE,6935,4945,478,4467,2004,t2,cantonales
7975,70,HAUTE SAONE,4843,3607,202,3405,2004,t2,cantonales
7976,70,HAUTE SAONE,5079,3366,187,3179,2004,t2,cantonales
7977,70,HAUTE SAONE,4353,3353,417,2936,2004,t2,cantonales
7978,70,HAUTE SAONE,12645,8764,577,8187,2004,t2,cantonales
7979,70,HAUTE SAONE,6562,4490,645,3845,2004,t2,cantonales
7980,71,SAONE ET LOIRE ,7601,5291,524,4767,2004,t2,cantonales
7981,71,SAONE ET LOIRE ,3353,2519,106,2413,2004,t2,cantonales
7982,71,SAONE ET LOIRE ,17212,11488,851,10637,2004,t2,cantonales
7983,71,SAONE ET LOIRE ,4854,3643,171,3472,2004,t2,cantonales
7984,71,SAONE ET LOIRE ,7972,5385,221,5164,2004,t2,cantonales
7985,71,SAONE ET LOIRE ,9075,6106,356,5750,2004,t2,cantonales
7986,71,SAONE ET LOIRE ,1880,1473,58,1415,2004,t2,cantonales
7987,71,SAONE ET LOIRE ,3495,2472,206,2266,2004,t2,cantonales
7988,71,SAONE ET LOIRE ,6100,4223,222,4001,2004,t2,cantonales
7989,71,SAONE ET LOIRE ,9024,5448,278,5170,2004,t2,cantonales
7990,71,SAONE ET LOIRE ,2830,2190,87,2103,2004,t2,cantonales
7991,71,SAONE ET LOIRE ,12001,7031,389,6642,2004,t2,cantonales
7992,71,SAONE ET LOIRE ,10944,7090,398,6692,2004,t2,cantonales
7993,71,SAONE ET LOIRE ,4761,3707,139,3568,2004,t2,cantonales
7994,71,SAONE ET LOIRE ,5948,4235,221,4014,2004,t2,cantonales
7995,71,SAONE ET LOIRE ,4216,3057,122,2935,2004,t2,cantonales
7996,71,SAONE ET LOIRE ,13611,8241,554,7687,2004,t2,cantonales
7997,71,SAONE ET LOIRE ,10935,6650,454,6196,2004,t2,cantonales
7998,72,SARTHE,5929,4304,230,4074,2004,t2,cantonales
7999,72,SARTHE,5533,4036,176,3860,2004,t2,cantonales
8000,72,SARTHE,7308,4888,235,4653,2004,t2,cantonales
8001,72,SARTHE,4143,2947,357,2590,2004,t2,cantonales
8002,72,SARTHE,6699,4360,280,4080,2004,t2,cantonales
8003,72,SARTHE,7224,4699,278,4421,2004,t2,cantonales
8004,72,SARTHE,8796,5764,286,5478,2004,t2,cantonales
8005,72,SARTHE,12675,7517,268,7249,2004,t2,cantonales
8006,72,SARTHE,4809,3414,405,3009,2004,t2,cantonales
8007,72,SARTHE,14397,9326,574,8752,2004,t2,cantonales
8008,72,SARTHE,18097,11269,561,10708,2004,t2,cantonales
8009,72,SARTHE,8000,5331,360,4971,2004,t2,cantonales
8010,72,SARTHE,8446,5437,289,5148,2004,t2,cantonales
8011,72,SARTHE,15749,9494,484,9010,2004,t2,cantonales
8012,72,SARTHE,20725,13673,651,13022,2004,t2,cantonales
8013,72,SARTHE,14292,9179,448,8731,2004,t2,cantonales
8014,72,SARTHE,12582,7898,470,7428,2004,t2,cantonales
8015,73,SAVOIE,10903,6640,498,6142,2004,t2,cantonales
8016,73,SAVOIE,9469,6080,301,5779,2004,t2,cantonales
8017,73,SAVOIE,10463,6566,443,6123,2004,t2,cantonales
8018,73,SAVOIE,7466,4751,214,4537,2004,t2,cantonales
8019,73,SAVOIE,5596,3750,156,3594,2004,t2,cantonales
8020,73,SAVOIE,3349,2570,120,2450,2004,t2,cantonales
8021,73,SAVOIE,3532,2793,68,2725,2004,t2,cantonales
8022,73,SAVOIE,2460,1769,131,1638,2004,t2,cantonales
8023,73,SAVOIE,9697,6890,487,6403,2004,t2,cantonales
8024,73,SAVOIE,6409,4132,308,3824,2004,t2,cantonales
8025,73,SAVOIE,4558,3237,86,3151,2004,t2,cantonales
8026,73,SAVOIE,4857,3376,188,3188,2004,t2,cantonales
8027,73,SAVOIE,11774,7326,427,6899,2004,t2,cantonales
8028,73,SAVOIE,9143,5891,297,5594,2004,t2,cantonales
8029,73,SAVOIE,10829,6933,387,6546,2004,t2,cantonales
8030,73,SAVOIE,13550,9157,437,8720,2004,t2,cantonales
8031,73,SAVOIE,11181,6982,471,6511,2004,t2,cantonales
8032,74,HAUTE SAVOIE,3689,2698,208,2490,2004,t2,cantonales
8033,74,HAUTE SAVOIE,7496,5040,221,4819,2004,t2,cantonales
8034,74,HAUTE SAVOIE,9783,5695,272,5423,2004,t2,cantonales
8035,74,HAUTE SAVOIE,19569,11092,475,10617,2004,t2,cantonales
8036,74,HAUTE SAVOIE,13424,8211,535,7676,2004,t2,cantonales
8037,74,HAUTE SAVOIE,14197,8111,383,7728,2004,t2,cantonales
8038,74,HAUTE SAVOIE,9148,6135,416,5719,2004,t2,cantonales
8039,74,HAUTE SAVOIE,4959,3404,261,3143,2004,t2,cantonales
8040,74,HAUTE SAVOIE,10684,7102,361,6741,2004,t2,cantonales
8041,74,HAUTE SAVOIE,13296,9047,368,8679,2004,t2,cantonales
8042,74,HAUTE SAVOIE,11893,7588,1134,6454,2004,t2,cantonales
8043,74,HAUTE SAVOIE,6944,4984,272,4712,2004,t2,cantonales
8044,74,HAUTE SAVOIE,18066,10300,490,9810,2004,t2,cantonales
8045,74,HAUTE SAVOIE,3582,2450,242,2208,2004,t2,cantonales
8046,74,HAUTE SAVOIE,28064,18118,1080,17038,2004,t2,cantonales
8047,74,HAUTE SAVOIE,27514,17625,846,16779,2004,t2,cantonales
8048,74,HAUTE SAVOIE,21829,13011,749,12262,2004,t2,cantonales
8049,76,SEINE MARITIME ,5277,3889,189,3700,2004,t2,cantonales
8050,76,SEINE MARITIME ,8252,6094,245,5849,2004,t2,cantonales
8051,76,SEINE MARITIME ,5487,3932,233,3699,2004,t2,cantonales
8052,76,SEINE MARITIME ,8059,5808,342,5466,2004,t2,cantonales
8053,76,SEINE MARITIME ,6906,4793,194,4599,2004,t2,cantonales
8054,76,SEINE MARITIME ,11319,8211,394,7817,2004,t2,cantonales
8055,76,SEINE MARITIME ,18274,12629,618,12011,2004,t2,cantonales
8056,76,SEINE MARITIME ,13591,9493,358,9135,2004,t2,cantonales
8057,76,SEINE MARITIME ,18564,12771,889,11882,2004,t2,cantonales
8058,76,SEINE MARITIME ,20997,13540,517,13023,2004,t2,cantonales
8059,76,SEINE MARITIME ,3834,2989,118,2871,2004,t2,cantonales
8060,76,SEINE MARITIME ,19428,12523,3111,9412,2004,t2,cantonales
8061,76,SEINE MARITIME ,15116,8984,810,8174,2004,t2,cantonales
8062,76,SEINE MARITIME ,9798,6038,251,5787,2004,t2,cantonales
8063,76,SEINE MARITIME ,20037,13015,602,12413,2004,t2,cantonales
8064,76,SEINE MARITIME ,5647,4341,203,4138,2004,t2,cantonales
8065,76,SEINE MARITIME ,16478,10108,2254,7854,2004,t2,cantonales
8066,76,SEINE MARITIME ,21819,14733,865,13868,2004,t2,cantonales
8067,76,SEINE MARITIME ,6090,3961,138,3823,2004,t2,cantonales
8068,76,SEINE MARITIME ,7660,4939,217,4722,2004,t2,cantonales
8069,76,SEINE MARITIME ,11248,7003,385,6618,2004,t2,cantonales
8070,76,SEINE MARITIME ,7061,5170,207,4963,2004,t2,cantonales
8071,76,SEINE MARITIME ,8833,6204,372,5832,2004,t2,cantonales
8072,76,SEINE MARITIME ,12384,6454,1538,4916,2004,t2,cantonales
8073,76,SEINE MARITIME ,18190,11234,803,10431,2004,t2,cantonales
8074,76,SEINE MARITIME ,13481,8732,523,8209,2004,t2,cantonales
8075,76,SEINE MARITIME ,20254,13118,733,12385,2004,t2,cantonales
8076,76,SEINE MARITIME ,7200,4787,176,4611,2004,t2,cantonales
8077,76,SEINE MARITIME ,14010,8855,1721,7134,2004,t2,cantonales
8078,76,SEINE MARITIME ,13643,9017,609,8408,2004,t2,cantonales
8079,77,SEINE ET MARNE ,10091,7125,192,6933,2004,t2,cantonales
8080,77,SEINE ET MARNE ,15782,10336,383,9953,2004,t2,cantonales
8081,77,SEINE ET MARNE ,18133,11184,401,10783,2004,t2,cantonales
8082,77,SEINE ET MARNE ,10035,6741,172,6569,2004,t2,cantonales
8083,77,SEINE ET MARNE ,23589,15975,910,15065,2004,t2,cantonales
8084,77,SEINE ET MARNE ,11492,7519,392,7127,2004,t2,cantonales
8085,77,SEINE ET MARNE ,18850,12911,396,12515,2004,t2,cantonales
8086,77,SEINE ET MARNE ,22477,14941,735,14206,2004,t2,cantonales
8087,77,SEINE ET MARNE ,13816,9336,294,9042,2004,t2,cantonales
8088,77,SEINE ET MARNE ,18752,12394,831,11563,2004,t2,cantonales
8089,77,SEINE ET MARNE ,12307,8164,245,7919,2004,t2,cantonales
8090,77,SEINE ET MARNE ,15141,10168,290,9878,2004,t2,cantonales
8091,77,SEINE ET MARNE ,14866,9682,517,9165,2004,t2,cantonales
8092,77,SEINE ET MARNE ,5318,3806,124,3682,2004,t2,cantonales
8093,77,SEINE ET MARNE ,24098,15564,824,14740,2004,t2,cantonales
8094,77,SEINE ET MARNE ,22776,14798,662,14136,2004,t2,cantonales
8095,77,SEINE ET MARNE ,18751,11734,825,10909,2004,t2,cantonales
8096,77,SEINE ET MARNE ,16047,10627,526,10101,2004,t2,cantonales
8097,77,SEINE ET MARNE ,25480,16116,1016,15100,2004,t2,cantonales
8098,77,SEINE ET MARNE ,22248,14342,892,13450,2004,t2,cantonales
8099,77,SEINE ET MARNE ,23501,15470,938,14532,2004,t2,cantonales
8100,78,YVELINES,19800,12906,735,12171,2004,t2,cantonales
8101,78,YVELINES,19340,12339,445,11894,2004,t2,cantonales
8102,78,YVELINES,12911,9005,198,8807,2004,t2,cantonales
8103,78,YVELINES,16881,11668,601,11067,2004,t2,cantonales
8104,78,YVELINES,24985,16718,582,16136,2004,t2,cantonales
8105,78,YVELINES,16196,9748,416,9332,2004,t2,cantonales
8106,78,YVELINES,29218,20226,830,19396,2004,t2,cantonales
8107,78,YVELINES,12969,8506,603,7903,2004,t2,cantonales
8108,78,YVELINES,14709,10240,395,9845,2004,t2,cantonales
8109,78,YVELINES,24992,16204,552,15652,2004,t2,cantonales
8110,78,YVELINES,17827,11970,314,11656,2004,t2,cantonales
8111,78,YVELINES,25640,16858,638,16220,2004,t2,cantonales
8112,78,YVELINES,21738,14130,1155,12975,2004,t2,cantonales
8113,78,YVELINES,15954,10658,346,10312,2004,t2,cantonales
8114,78,YVELINES,24231,16091,653,15438,2004,t2,cantonales
8115,78,YVELINES,27748,18279,619,17660,2004,t2,cantonales
8116,78,YVELINES,14552,9812,371,9441,2004,t2,cantonales
8117,79,DEUX SEVRES,10374,7286,418,6868,2004,t2,cantonales
8118,79,DEUX SEVRES,4244,3167,260,2907,2004,t2,cantonales
8119,79,DEUX SEVRES,7569,5359,284,5075,2004,t2,cantonales
8120,79,DEUX SEVRES,4627,3400,137,3263,2004,t2,cantonales
8121,79,DEUX SEVRES,3689,2849,163,2686,2004,t2,cantonales
8122,79,DEUX SEVRES,3999,3069,142,2927,2004,t2,cantonales
8123,79,DEUX SEVRES,17439,11124,595,10529,2004,t2,cantonales
8124,79,DEUX SEVRES,4391,3279,223,3056,2004,t2,cantonales
8125,79,DEUX SEVRES,8693,5705,269,5436,2004,t2,cantonales
8126,80,SOMME,12563,8660,507,8153,2004,t2,cantonales
8127,80,SOMME,13230,9595,523,9072,2004,t2,cantonales
8128,80,SOMME,15824,10859,680,10179,2004,t2,cantonales
8129,80,SOMME,8699,6433,423,6010,2004,t2,cantonales
8130,80,SOMME,7063,5324,237,5087,2004,t2,cantonales
8131,80,SOMME,15015,11426,365,11061,2004,t2,cantonales
8132,80,SOMME,9737,6931,463,6468,2004,t2,cantonales
8133,80,SOMME,9704,7380,635,6745,2004,t2,cantonales
8134,80,SOMME,7778,5895,251,5644,2004,t2,cantonales
8135,80,SOMME,8829,6430,341,6089,2004,t2,cantonales
8136,80,SOMME,7231,5543,543,5000,2004,t2,cantonales
8137,80,SOMME,5980,4481,178,4303,2004,t2,cantonales
8138,80,SOMME,9320,6719,235,6484,2004,t2,cantonales
8139,80,SOMME,9679,6989,281,6708,2004,t2,cantonales
8140,80,SOMME,14851,9647,579,9068,2004,t2,cantonales
8141,80,SOMME,10375,7101,348,6753,2004,t2,cantonales
8142,80,SOMME,11565,7315,370,6945,2004,t2,cantonales
8143,80,SOMME,9568,6933,570,6363,2004,t2,cantonales
8144,81,TARN,7280,5115,303,4812,2004,t2,cantonales
8145,81,TARN,690,586,43,543,2004,t2,cantonales
8146,81,TARN,3034,2410,68,2342,2004,t2,cantonales
8147,81,TARN,11533,8201,575,7626,2004,t2,cantonales
8148,81,TARN,8885,6748,472,6276,2004,t2,cantonales
8149,81,TARN,3478,2955,242,2713,2004,t2,cantonales
8150,81,TARN,3730,2816,236,2580,2004,t2,cantonales
8151,81,TARN,10452,7452,475,6977,2004,t2,cantonales
8152,81,TARN,2135,1881,50,1831,2004,t2,cantonales
8153,81,TARN,6727,5330,284,5046,2004,t2,cantonales
8154,81,TARN,3124,2492,126,2366,2004,t2,cantonales
8155,81,TARN,8812,6356,453,5903,2004,t2,cantonales
8156,81,TARN,9183,6646,515,6131,2004,t2,cantonales
8157,81,TARN,8993,6317,276,6041,2004,t2,cantonales
8158,81,TARN,7205,5214,386,4828,2004,t2,cantonales
8159,82,TARN ET GARONNE,4825,3699,258,3441,2004,t2,cantonales
8160,82,TARN ET GARONNE,4628,3000,241,2759,2004,t2,cantonales
8161,82,TARN ET GARONNE,10133,7667,462,7205,2004,t2,cantonales
8162,82,TARN ET GARONNE,9344,6682,957,5725,2004,t2,cantonales
8163,82,TARN ET GARONNE,3615,2854,94,2760,2004,t2,cantonales
8164,82,TARN ET GARONNE,3643,2924,149,2775,2004,t2,cantonales
8165,82,TARN ET GARONNE,2542,2031,87,1944,2004,t2,cantonales
8166,82,TARN ET GARONNE,1922,1584,91,1493,2004,t2,cantonales
8167,82,TARN ET GARONNE,6306,4761,372,4389,2004,t2,cantonales
8168,82,TARN ET GARONNE,4067,3179,227,2952,2004,t2,cantonales
8169,82,TARN ET GARONNE,7178,5252,367,4885,2004,t2,cantonales
8170,82,TARN ET GARONNE,5614,3991,172,3819,2004,t2,cantonales
8171,82,TARN ET GARONNE,6679,4477,355,4122,2004,t2,cantonales
8172,83,VAR,8919,6544,205,6339,2004,t2,cantonales
8173,83,VAR,16660,10983,369,10614,2004,t2,cantonales
8174,83,VAR,33091,21439,533,20906,2004,t2,cantonales
8175,83,VAR,16489,10171,320,9851,2004,t2,cantonales
8176,83,VAR,13594,9616,280,9336,2004,t2,cantonales
8177,83,VAR,30582,19731,553,19178,2004,t2,cantonales
8178,83,VAR,20745,14383,399,13984,2004,t2,cantonales
8179,83,VAR,16779,10852,704,10148,2004,t2,cantonales
8180,83,VAR,3993,3023,117,2906,2004,t2,cantonales
8181,83,VAR,23374,13567,802,12765,2004,t2,cantonales
8182,83,VAR,3459,2658,87,2571,2004,t2,cantonales
8183,83,VAR,14666,8561,281,8280,2004,t2,cantonales
8184,83,VAR,6069,3140,202,2938,2004,t2,cantonales
8185,83,VAR,8998,5169,284,4885,2004,t2,cantonales
8186,83,VAR,19157,12989,822,12167,2004,t2,cantonales
8187,83,VAR,26534,16982,395,16587,2004,t2,cantonales
8188,83,VAR,26518,16074,2129,13945,2004,t2,cantonales
8189,83,VAR,18984,11741,1587,10154,2004,t2,cantonales
8190,83,VAR,25689,17013,515,16498,2004,t2,cantonales
8191,83,VAR,17596,11114,472,10642,2004,t2,cantonales
8192,84,VAUCLUSE,15033,9987,331,9656,2004,t2,cantonales
8193,84,VAUCLUSE,12000,7727,238,7489,2004,t2,cantonales
8194,84,VAUCLUSE,23856,16370,1930,14440,2004,t2,cantonales
8195,84,VAUCLUSE,3714,2815,145,2670,2004,t2,cantonales
8196,84,VAUCLUSE,12573,8718,471,8247,2004,t2,cantonales
8197,84,VAUCLUSE,19353,13293,341,12952,2004,t2,cantonales
8198,84,VAUCLUSE,26528,18906,800,18106,2004,t2,cantonales
8199,84,VAUCLUSE,3597,3014,125,2889,2004,t2,cantonales
8200,84,VAUCLUSE,6976,5508,357,5151,2004,t2,cantonales
8201,84,VAUCLUSE,18035,12725,938,11787,2004,t2,cantonales
8202,84,VAUCLUSE,21758,14526,370,14156,2004,t2,cantonales
8203,85,VENDEE,5626,3917,189,3728,2004,t2,cantonales
8204,85,VENDEE,18460,13017,487,12530,2004,t2,cantonales
8205,85,VENDEE,20915,13632,566,13066,2004,t2,cantonales
8206,85,VENDEE,35928,21470,1060,20410,2004,t2,cantonales
8207,85,VENDEE,12975,8905,479,8426,2004,t2,cantonales
8208,86,VIENNE,3134,2284,142,2142,2004,t2,cantonales
8209,86,VIENNE,6767,5048,168,4880,2004,t2,cantonales
8210,86,VIENNE,5794,4316,234,4082,2004,t2,cantonales
8211,86,VIENNE,9270,6378,365,6013,2004,t2,cantonales
8212,86,VIENNE,8072,5930,282,5648,2004,t2,cantonales
8213,86,VIENNE,6652,4844,213,4631,2004,t2,cantonales
8214,86,VIENNE,4740,3613,163,3450,2004,t2,cantonales
8215,86,VIENNE,3810,2958,88,2870,2004,t2,cantonales
8216,86,VIENNE,11575,8465,311,8154,2004,t2,cantonales
8217,86,VIENNE,5229,3848,144,3704,2004,t2,cantonales
8218,86,VIENNE,11805,7952,532,7420,2004,t2,cantonales
8219,86,VIENNE,9202,6933,344,6589,2004,t2,cantonales
8220,86,VIENNE,2597,2006,126,1880,2004,t2,cantonales
8221,86,VIENNE,10145,6863,417,6446,2004,t2,cantonales
8222,86,VIENNE,11107,7757,241,7516,2004,t2,cantonales
8223,86,VIENNE,10458,6826,783,6043,2004,t2,cantonales
8224,87,HAUTE VIENNE,11610,8013,1160,6853,2004,t2,cantonales
8225,87,HAUTE VIENNE,5640,4215,298,3917,2004,t2,cantonales
8226,87,HAUTE VIENNE,3396,2455,179,2276,2004,t2,cantonales
8227,87,HAUTE VIENNE,4809,2928,221,2707,2004,t2,cantonales
8228,87,HAUTE VIENNE,5740,3523,251,3272,2004,t2,cantonales
8229,87,HAUTE VIENNE,2967,2112,180,1932,2004,t2,cantonales
8230,87,HAUTE VIENNE,5616,3943,1141,2802,2004,t2,cantonales
8231,87,HAUTE VIENNE,8344,5932,363,5569,2004,t2,cantonales
8232,87,HAUTE VIENNE,3584,2700,303,2397,2004,t2,cantonales
8233,87,HAUTE VIENNE,7865,5480,310,5170,2004,t2,cantonales
8234,87,HAUTE VIENNE,8724,5542,299,5243,2004,t2,cantonales
8235,87,HAUTE VIENNE,9398,6727,355,6372,2004,t2,cantonales
8236,87,HAUTE VIENNE,7315,5528,222,5306,2004,t2,cantonales
8237,87,HAUTE VIENNE,8342,5568,491,5077,2004,t2,cantonales
8238,88,VOSGES,11416,7640,1120,6520,2004,t2,cantonales
8239,88,VOSGES,14752,9358,603,8755,2004,t2,cantonales
8240,88,VOSGES,18856,11810,816,10994,2004,t2,cantonales
8241,88,VOSGES,9242,6154,251,5903,2004,t2,cantonales
8242,88,VOSGES,8780,6264,434,5830,2004,t2,cantonales
8243,88,VOSGES,10475,7114,403,6711,2004,t2,cantonales
8244,88,VOSGES,14143,9552,354,9198,2004,t2,cantonales
8245,88,VOSGES,12364,8388,280,8108,2004,t2,cantonales
8246,89,YONNE,9589,6151,454,5697,2004,t2,cantonales
8247,89,YONNE,8572,5899,293,5606,2004,t2,cantonales
8248,89,YONNE,2186,1688,79,1609,2004,t2,cantonales
8249,89,YONNE,4524,3325,226,3099,2004,t2,cantonales
8250,89,YONNE,2327,1820,49,1771,2004,t2,cantonales
8251,89,YONNE,3736,2463,120,2343,2004,t2,cantonales
8252,89,YONNE,2422,1918,46,1872,2004,t2,cantonales
8253,89,YONNE,10960,7240,222,7018,2004,t2,cantonales
8254,89,YONNE,1911,1538,36,1502,2004,t2,cantonales
8255,89,YONNE,4984,3168,120,3048,2004,t2,cantonales
8256,89,YONNE,8045,5224,362,4862,2004,t2,cantonales
8257,89,YONNE,8382,5138,189,4949,2004,t2,cantonales
8258,89,YONNE,5314,3598,122,3476,2004,t2,cantonales
8259,89,YONNE,3752,2697,180,2517,2004,t2,cantonales
8260,89,YONNE,6154,4208,185,4023,2004,t2,cantonales
8261,89,YONNE,10600,6515,354,6161,2004,t2,cantonales
8262,89,YONNE,8185,5426,445,4981,2004,t2,cantonales
8263,89,YONNE,8666,5501,412,5089,2004,t2,cantonales
8264,90,TERRITOIRE DE BELFORT,5537,3684,269,3415,2004,t2,cantonales
8265,90,TERRITOIRE DE BELFORT,7194,5226,387,4839,2004,t2,cantonales
8266,90,TERRITOIRE DE BELFORT,6911,4570,268,4302,2004,t2,cantonales
8267,90,TERRITOIRE DE BELFORT,4791,3103,137,2966,2004,t2,cantonales
8268,90,TERRITOIRE DE BELFORT,3967,2578,286,2292,2004,t2,cantonales
8269,90,TERRITOIRE DE BELFORT,7686,5574,284,5290,2004,t2,cantonales
8270,90,TERRITOIRE DE BELFORT,7367,5366,238,5128,2004,t2,cantonales
8271,90,TERRITOIRE DE BELFORT,4137,2849,141,2708,2004,t2,cantonales
8272,91,ESSONNE,24544,16424,652,15772,2004,t2,cantonales
8273,91,ESSONNE,20593,12966,1382,11584,2004,t2,cantonales
8274,91,ESSONNE,10974,7091,371,6720,2004,t2,cantonales
8275,91,ESSONNE,10060,6991,352,6639,2004,t2,cantonales
8276,91,ESSONNE,14330,9854,509,9345,2004,t2,cantonales
8277,91,ESSONNE,22244,14194,676,13518,2004,t2,cantonales
8278,91,ESSONNE,11088,7768,186,7582,2004,t2,cantonales
8279,91,ESSONNE,9899,6807,467,6340,2004,t2,cantonales
8280,91,ESSONNE,10135,6926,380,6546,2004,t2,cantonales
8281,91,ESSONNE,22258,15007,852,14155,2004,t2,cantonales
8282,91,ESSONNE,16693,12271,366,11905,2004,t2,cantonales
8283,91,ESSONNE,21328,13622,576,13046,2004,t2,cantonales
8284,91,ESSONNE,17324,11562,406,11156,2004,t2,cantonales
8285,91,ESSONNE,14941,9425,478,8947,2004,t2,cantonales
8286,91,ESSONNE,14056,9107,992,8115,2004,t2,cantonales
8287,91,ESSONNE,15968,10525,501,10024,2004,t2,cantonales
8288,91,ESSONNE,9467,5078,1303,3775,2004,t2,cantonales
8289,91,ESSONNE,12956,8804,406,8398,2004,t2,cantonales
8290,91,ESSONNE,10102,6788,269,6519,2004,t2,cantonales
8291,92,HAUTS DE SEINE,20065,13100,737,12363,2004,t2,cantonales
8292,92,HAUTS DE SEINE,20209,13000,577,12423,2004,t2,cantonales
8293,92,HAUTS DE SEINE,20750,14917,574,14343,2004,t2,cantonales
8294,92,HAUTS DE SEINE,18705,12970,470,12500,2004,t2,cantonales
8295,92,HAUTS DE SEINE,26120,17803,882,16921,2004,t2,cantonales
8296,92,HAUTS DE SEINE,11497,7636,284,7352,2004,t2,cantonales
8297,92,HAUTS DE SEINE,23868,15994,523,15471,2004,t2,cantonales
8298,92,HAUTS DE SEINE,17166,12102,471,11631,2004,t2,cantonales
8299,92,HAUTS DE SEINE,23567,15501,1015,14486,2004,t2,cantonales
8300,92,HAUTS DE SEINE,23409,15989,461,15528,2004,t2,cantonales
8301,92,HAUTS DE SEINE,8623,4827,1138,3689,2004,t2,cantonales
8302,92,HAUTS DE SEINE,25611,17013,632,16381,2004,t2,cantonales
8303,92,HAUTS DE SEINE,17324,11882,343,11539,2004,t2,cantonales
8304,92,HAUTS DE SEINE,15466,10952,445,10507,2004,t2,cantonales
8305,92,HAUTS DE SEINE,15699,11408,392,11016,2004,t2,cantonales
8306,92,HAUTS DE SEINE,14080,10019,356,9663,2004,t2,cantonales
8307,92,HAUTS DE SEINE,14856,8919,2965,5954,2004,t2,cantonales
8308,93,SEINE SAINT-DENIS,13564,7189,2061,5128,2004,t2,cantonales
8309,93,SEINE SAINT-DENIS,22233,12810,543,12267,2004,t2,cantonales
8310,93,SEINE SAINT-DENIS,12224,6816,1569,5247,2004,t2,cantonales
8311,93,SEINE SAINT-DENIS,16873,10234,395,9839,2004,t2,cantonales
8312,93,SEINE SAINT-DENIS,20143,12213,455,11758,2004,t2,cantonales
8313,93,SEINE SAINT-DENIS,21044,13242,633,12609,2004,t2,cantonales
8314,93,SEINE SAINT-DENIS,17281,11190,279,10911,2004,t2,cantonales
8315,93,SEINE SAINT-DENIS,14251,8610,2369,6241,2004,t2,cantonales
8316,93,SEINE SAINT-DENIS,32411,20867,1695,19172,2004,t2,cantonales
8317,93,SEINE SAINT-DENIS,19522,12411,577,11834,2004,t2,cantonales
8318,93,SEINE SAINT-DENIS,16454,10422,391,10031,2004,t2,cantonales
8319,93,SEINE SAINT-DENIS,11436,6398,2564,3834,2004,t2,cantonales
8320,93,SEINE SAINT-DENIS,21031,12638,645,11993,2004,t2,cantonales
8321,93,SEINE SAINT-DENIS,10780,6047,1830,4217,2004,t2,cantonales
8322,93,SEINE SAINT-DENIS,9697,5617,1924,3693,2004,t2,cantonales
8323,93,SEINE SAINT-DENIS,18757,11411,706,10705,2004,t2,cantonales
8324,93,SEINE SAINT-DENIS,14144,7767,1991,5776,2004,t2,cantonales
8325,93,SEINE SAINT-DENIS,14658,8812,477,8335,2004,t2,cantonales
8326,94,VAL DE MARNE,7545,4505,1447,3058,2004,t2,cantonales
8327,94,VAL DE MARNE,13538,9018,438,8580,2004,t2,cantonales
8328,94,VAL DE MARNE,9343,5880,414,5466,2004,t2,cantonales
8329,94,VAL DE MARNE,17530,11228,605,10623,2004,t2,cantonales
8330,94,VAL DE MARNE,14599,8699,426,8273,2004,t2,cantonales
8331,94,VAL DE MARNE,11724,6973,1626,5347,2004,t2,cantonales
8332,94,VAL DE MARNE,12843,7691,391,7300,2004,t2,cantonales
8333,94,VAL DE MARNE,15759,10364,481,9883,2004,t2,cantonales
8334,94,VAL DE MARNE,17161,11141,559,10582,2004,t2,cantonales
8335,94,VAL DE MARNE,18766,12347,653,11694,2004,t2,cantonales
8336,94,VAL DE MARNE,19067,13273,336,12937,2004,t2,cantonales
8337,94,VAL DE MARNE,14514,10003,379,9624,2004,t2,cantonales
8338,94,VAL DE MARNE,11652,6832,375,6457,2004,t2,cantonales
8339,94,VAL DE MARNE,8837,5326,150,5176,2004,t2,cantonales
8340,94,VAL DE MARNE,14005,8420,2264,6156,2004,t2,cantonales
8341,94,VAL DE MARNE,17099,10156,604,9552,2004,t2,cantonales
8342,94,VAL DE MARNE,14191,9651,371,9280,2004,t2,cantonales
8343,94,VAL DE MARNE,8284,5338,399,4939,2004,t2,cantonales
8344,94,VAL DE MARNE,12103,7837,339,7498,2004,t2,cantonales
8345,94,VAL DE MARNE,13083,8533,494,8039,2004,t2,cantonales
8346,94,VAL DE MARNE,13155,8013,434,7579,2004,t2,cantonales
8347,94,VAL DE MARNE,8769,4993,1026,3967,2004,t2,cantonales
8348,94,VAL DE MARNE,13960,8227,396,7831,2004,t2,cantonales
8349,95,VAL D'OISE,12203,7415,332,7083,2004,t2,cantonales
8350,95,VAL D'OISE,17930,10959,525,10434,2004,t2,cantonales
8351,95,VAL D'OISE,15003,10068,454,9614,2004,t2,cantonales
8352,95,VAL D'OISE,17997,11432,563,10869,2004,t2,cantonales
8353,95,VAL D'OISE,19700,12219,676,11543,2004,t2,cantonales
8354,95,VAL D'OISE,17301,10411,861,9550,2004,t2,cantonales
8355,95,VAL D'OISE,10356,7335,494,6841,2004,t2,cantonales
8356,95,VAL D'OISE,7712,5563,339,5224,2004,t2,cantonales
8357,95,VAL D'OISE,16334,10850,592,10258,2004,t2,cantonales
8358,95,VAL D'OISE,15032,9290,1202,8088,2004,t2,cantonales
8359,95,VAL D'OISE,14085,9145,390,8755,2004,t2,cantonales
8360,95,VAL D'OISE,13400,9268,260,9008,2004,t2,cantonales
8361,95,VAL D'OISE,14694,9709,436,9273,2004,t2,cantonales
8362,95,VAL D'OISE,17465,11650,512,11138,2004,t2,cantonales
8363,95,VAL D'OISE,11468,5803,305,5498,2004,t2,cantonales
8364,95,VAL D'OISE,12218,8967,306,8661,2004,t2,cantonales
8365,95,VAL D'OISE,15720,9409,435,8974,2004,t2,cantonales
8366,95,VAL D'OISE,8120,4721,308,4413,2004,t2,cantonales
8367,971,GUADELOUPE,9323,6421,352,6069,2004,t2,cantonales
8368,971,GUADELOUPE,5766,3819,240,3579,2004,t2,cantonales
8369,971,GUADELOUPE,1567,1281,19,1262,2004,t2,cantonales
8370,971,GUADELOUPE,9121,6771,235,6536,2004,t2,cantonales
8371,971,GUADELOUPE,6442,4207,276,3931,2004,t2,cantonales
8372,971,GUADELOUPE,6123,4091,330,3761,2004,t2,cantonales
8373,971,GUADELOUPE,10002,6245,332,5913,2004,t2,cantonales
8374,971,GUADELOUPE,5109,3245,299,2946,2004,t2,cantonales
8375,971,GUADELOUPE,11070,6328,770,5558,2004,t2,cantonales
8376,971,GUADELOUPE,4244,2726,233,2493,2004,t2,cantonales
8377,971,GUADELOUPE,4847,2895,315,2580,2004,t2,cantonales
8378,971,GUADELOUPE,6286,3830,475,3355,2004,t2,cantonales
8379,971,GUADELOUPE,7576,4562,257,4305,2004,t2,cantonales
8380,971,GUADELOUPE,7476,3021,218,2803,2004,t2,cantonales
8381,971,GUADELOUPE,8238,5544,384,5160,2004,t2,cantonales
8382,971,GUADELOUPE,8168,5534,452,5082,2004,t2,cantonales
8383,971,GUADELOUPE,5275,3527,216,3311,2004,t2,cantonales
8384,971,GUADELOUPE,6448,2516,155,2361,2004,t2,cantonales
8385,972,MARTINIQUE,3666,1592,66,1526,2004,t2,cantonales
8386,972,MARTINIQUE,4916,2289,210,2079,2004,t2,cantonales
8387,972,MARTINIQUE,6118,4516,120,4396,2004,t2,cantonales
8388,972,MARTINIQUE,2025,1681,33,1648,2004,t2,cantonales
8389,972,MARTINIQUE,6636,3706,346,3360,2004,t2,cantonales
8390,972,MARTINIQUE,6780,3650,284,3366,2004,t2,cantonales
8391,972,MARTINIQUE,9784,4180,444,3736,2004,t2,cantonales
8392,972,MARTINIQUE,6723,3510,318,3192,2004,t2,cantonales
8393,972,MARTINIQUE,7513,4530,405,4125,2004,t2,cantonales
8394,972,MARTINIQUE,9162,4879,526,4353,2004,t2,cantonales
8395,973,GUYANE,6042,3382,234,3148,2004,t2,cantonales
8396,973,GUYANE,6644,3753,269,3484,2004,t2,cantonales
8397,973,GUYANE,1408,1198,14,1184,2004,t2,cantonales
8398,973,GUYANE,3197,1984,47,1937,2004,t2,cantonales
8399,974,LA REUNION,8374,6793,324,6469,2004,t2,cantonales
8400,974,LA REUNION,8201,6085,331,5754,2004,t2,cantonales
8401,974,LA REUNION,9056,6772,282,6490,2004,t2,cantonales
8402,974,LA REUNION,11082,6610,539,6071,2004,t2,cantonales
8403,974,LA REUNION,16097,13624,413,13211,2004,t2,cantonales
8404,974,LA REUNION,8802,6206,478,5728,2004,t2,cantonales
8405,974,LA REUNION,13360,9364,1105,8259,2004,t2,cantonales
8406,974,LA REUNION,3925,3175,169,3006,2004,t2,cantonales
8407,974,LA REUNION,8314,6789,236,6553,2004,t2,cantonales
8408,974,LA REUNION,7482,4944,242,4702,2004,t2,cantonales
8409,974,LA REUNION,11149,7935,750,7185,2004,t2,cantonales
8410,974,LA REUNION,13577,8730,902,7828,2004,t2,cantonales
8411,974,LA REUNION,12179,8668,653,8015,2004,t2,cantonales
8412,985,MAYOTTE,2961,1891,25,1866,2004,t2,cantonales
8413,985,MAYOTTE,2575,1728,31,1697,2004,t2,cantonales
8414,985,MAYOTTE,3598,2378,59,2319,2004,t2,cantonales
8415,985,MAYOTTE,2799,1823,59,1764,2004,t2,cantonales
8416,985,MAYOTTE,2398,1779,20,1759,2004,t2,cantonales
8417,985,MAYOTTE,3074,1748,36,1712,2004,t2,cantonales
8418,985,MAYOTTE,3180,2112,41,2071,2004,t2,cantonales
8419,985,MAYOTTE,2372,1462,22,1440,2004,t2,cantonales
8420,985,MAYOTTE,2644,1735,17,1718,2004,t2,cantonales
8421,1,AIN,14427,7788,216,7572,2008,t2,cantonales
8422,1,AIN,8769,3506,98,3408,2008,t2,cantonales
8423,1,AIN,2778,1997,72,1925,2008,t2,cantonales
8424,1,AIN,4490,2793,138,2655,2008,t2,cantonales
8425,1,AIN,3863,2581,94,2487,2008,t2,cantonales
8426,1,AIN,3873,2327,48,2279,2008,t2,cantonales
8427,1,AIN,13947,6189,216,5973,2008,t2,cantonales
8428,1,AIN,11038,6213,181,6032,2008,t2,cantonales
8429,1,AIN,9888,4786,163,4623,2008,t2,cantonales
8430,1,AIN,6727,3215,59,3156,2008,t2,cantonales
8431,1,AIN,15015,7776,157,7619,2008,t2,cantonales
8432,2,AISNE,5625,4042,177,3865,2008,t2,cantonales
8433,2,AISNE,8455,4833,210,4623,2008,t2,cantonales
8434,2,AISNE,6113,3949,124,3825,2008,t2,cantonales
8435,2,AISNE,7173,4050,199,3851,2008,t2,cantonales
8436,2,AISNE,5913,4221,108,4113,2008,t2,cantonales
8437,2,AISNE,15157,8730,283,8447,2008,t2,cantonales
8438,2,AISNE,10165,6492,161,6331,2008,t2,cantonales
8439,2,AISNE,4955,3394,179,3215,2008,t2,cantonales
8440,2,AISNE,15691,8252,260,7992,2008,t2,cantonales
8441,2,AISNE,17637,8425,253,8172,2008,t2,cantonales
8442,2,AISNE,16922,9240,412,8828,2008,t2,cantonales
8443,3,ALLIER,5657,4052,157,3895,2008,t2,cantonales
8444,3,ALLIER,4156,3045,202,2843,2008,t2,cantonales
8445,3,ALLIER,3665,2561,77,2484,2008,t2,cantonales
8446,3,ALLIER,7399,4748,152,4596,2008,t2,cantonales
8447,3,ALLIER,6079,4323,225,4098,2008,t2,cantonales
8448,3,ALLIER,7256,4763,161,4602,2008,t2,cantonales
8449,3,ALLIER,3832,2951,89,2862,2008,t2,cantonales
8450,3,ALLIER,11152,6777,179,6598,2008,t2,cantonales
8451,3,ALLIER,10205,6140,202,5938,2008,t2,cantonales
8452,3,ALLIER,10900,7029,204,6825,2008,t2,cantonales
8453,3,ALLIER,9367,5807,299,5508,2008,t2,cantonales
8454,3,ALLIER,7463,3992,121,3871,2008,t2,cantonales
8455,3,ALLIER,12388,7260,218,7042,2008,t2,cantonales
8456,4,ALPES DE HAUTE PROVENCE,2037,1593,49,1544,2008,t2,cantonales
8457,4,ALPES DE HAUTE PROVENCE,6803,4449,446,4003,2008,t2,cantonales
8458,4,ALPES DE HAUTE PROVENCE,7855,4669,204,4465,2008,t2,cantonales
8459,4,ALPES DE HAUTE PROVENCE,2876,2164,91,2073,2008,t2,cantonales
8460,4,ALPES DE HAUTE PROVENCE,6609,4580,133,4447,2008,t2,cantonales
8461,4,ALPES DE HAUTE PROVENCE,1034,898,24,874,2008,t2,cantonales
8462,4,ALPES DE HAUTE PROVENCE,9272,6152,620,5532,2008,t2,cantonales
8463,4,ALPES DE HAUTE PROVENCE,8963,5776,253,5523,2008,t2,cantonales
8464,5,HAUTES ALPES,1807,1581,69,1512,2008,t2,cantonales
8465,5,HAUTES ALPES,3726,2916,142,2774,2008,t2,cantonales
8466,5,HAUTES ALPES,7527,5301,237,5064,2008,t2,cantonales
8467,5,HAUTES ALPES,4532,3048,160,2888,2008,t2,cantonales
8468,5,HAUTES ALPES,7098,4527,223,4304,2008,t2,cantonales
8469,6,ALPES MARITIMES,8340,4401,424,3977,2008,t2,cantonales
8470,6,ALPES MARITIMES,19377,11209,849,10360,2008,t2,cantonales
8471,6,ALPES MARITIMES,18116,11417,944,10473,2008,t2,cantonales
8472,6,ALPES MARITIMES,11852,7218,386,6832,2008,t2,cantonales
8473,6,ALPES MARITIMES,12651,7175,360,6815,2008,t2,cantonales
8474,6,ALPES MARITIMES,11572,6216,295,5921,2008,t2,cantonales
8475,6,ALPES MARITIMES,20660,13267,553,12714,2008,t2,cantonales
8476,6,ALPES MARITIMES,17185,8644,2822,5822,2008,t2,cantonales
8477,6,ALPES MARITIMES,21209,12769,729,12040,2008,t2,cantonales
8478,6,ALPES MARITIMES,16531,8242,355,7887,2008,t2,cantonales
8479,6,ALPES MARITIMES,32467,15930,378,15552,2008,t2,cantonales
8480,6,ALPES MARITIMES,20485,12058,939,11119,2008,t2,cantonales
8481,6,ALPES MARITIMES,12007,6894,251,6643,2008,t2,cantonales
8482,7,ARDECHE,14206,8715,314,8401,2008,t2,cantonales
8483,7,ARDECHE,1234,1017,20,997,2008,t2,cantonales
8484,7,ARDECHE,7219,4582,126,4456,2008,t2,cantonales
8485,7,ARDECHE,1987,1770,68,1702,2008,t2,cantonales
8486,7,ARDECHE,20110,11137,215,10922,2008,t2,cantonales
8487,7,ARDECHE,17416,11868,387,11481,2008,t2,cantonales
8488,7,ARDECHE,6656,4886,150,4736,2008,t2,cantonales
8489,7,ARDECHE,3238,2491,54,2437,2008,t2,cantonales
8490,7,ARDECHE,7592,5546,207,5339,2008,t2,cantonales
8491,7,ARDECHE,9084,6116,247,5869,2008,t2,cantonales
8492,8,ARDENNES,7284,4829,267,4562,2008,t2,cantonales
8493,8,ARDENNES,8766,5164,188,4976,2008,t2,cantonales
8494,8,ARDENNES,10269,6804,168,6636,2008,t2,cantonales
8495,8,ARDENNES,9265,5060,307,4753,2008,t2,cantonales
8496,8,ARDENNES,4473,2670,67,2603,2008,t2,cantonales
8497,8,ARDENNES,8810,5241,215,5026,2008,t2,cantonales
8498,8,ARDENNES,9442,4745,261,4484,2008,t2,cantonales
8499,8,ARDENNES,5406,2721,72,2649,2008,t2,cantonales
8500,8,ARDENNES,10666,5862,209,5653,2008,t2,cantonales
8501,9,ARIEGE,2589,2096,54,2042,2008,t2,cantonales
8502,9,ARIEGE,6383,4399,284,4115,2008,t2,cantonales
8503,9,ARIEGE,2005,1395,48,1347,2008,t2,cantonales
8504,9,ARIEGE,10159,6523,383,6140,2008,t2,cantonales
8505,9,ARIEGE,7590,5311,221,5090,2008,t2,cantonales
8506,9,ARIEGE,8677,4724,1296,3428,2008,t2,cantonales
8507,10,AUBE,8463,5500,316,5184,2008,t2,cantonales
8508,10,AUBE,6794,3754,154,3600,2008,t2,cantonales
8509,10,AUBE,11510,5799,155,5644,2008,t2,cantonales
8510,10,AUBE,13021,5537,172,5365,2008,t2,cantonales
8511,11,AUDE,9875,6947,557,6390,2008,t2,cantonales
8512,11,AUDE,10133,7034,443,6591,2008,t2,cantonales
8513,11,AUDE,7709,4812,388,4424,2008,t2,cantonales
8514,11,AUDE,11361,8030,437,7593,2008,t2,cantonales
8515,11,AUDE,5215,3865,127,3738,2008,t2,cantonales
8516,11,AUDE,6687,4559,374,4185,2008,t2,cantonales
8517,11,AUDE,17375,11492,415,11077,2008,t2,cantonales
8518,11,AUDE,7528,4978,243,4735,2008,t2,cantonales
8519,11,AUDE,24056,15098,825,14273,2008,t2,cantonales
8520,11,AUDE,12227,8033,323,7710,2008,t2,cantonales
8521,12,AVEYRON,2199,1756,44,1712,2008,t2,cantonales
8522,12,AVEYRON,6745,4771,107,4664,2008,t2,cantonales
8523,12,AVEYRON,4603,3702,67,3635,2008,t2,cantonales
8524,12,AVEYRON,2400,1882,116,1766,2008,t2,cantonales
8525,12,AVEYRON,7951,5677,153,5524,2008,t2,cantonales
8526,12,AVEYRON,5849,4154,56,4098,2008,t2,cantonales
8527,12,AVEYRON,6811,4665,253,4412,2008,t2,cantonales
8528,12,AVEYRON,2290,2058,59,1999,2008,t2,cantonales
8529,12,AVEYRON,3361,2717,86,2631,2008,t2,cantonales
8530,12,AVEYRON,3874,2874,66,2808,2008,t2,cantonales
8531,12,AVEYRON,14282,8175,255,7920,2008,t2,cantonales
8532,12,AVEYRON,11411,6340,238,6102,2008,t2,cantonales
8533,13,BOUCHES DU RHONE,39895,24664,777,23887,2008,t2,cantonales
8534,13,BOUCHES DU RHONE,30414,10731,1215,9516,2008,t2,cantonales
8535,13,BOUCHES DU RHONE,29245,18196,580,17616,2008,t2,cantonales
8536,13,BOUCHES DU RHONE,33589,17432,750,16682,2008,t2,cantonales
8537,13,BOUCHES DU RHONE,23062,15978,1155,14823,2008,t2,cantonales
8538,13,BOUCHES DU RHONE,14692,9085,308,8777,2008,t2,cantonales
8539,13,BOUCHES DU RHONE,33325,18921,1004,17917,2008,t2,cantonales
8540,13,BOUCHES DU RHONE,30311,21177,772,20405,2008,t2,cantonales
8541,13,BOUCHES DU RHONE,18327,12381,346,12035,2008,t2,cantonales
8542,13,BOUCHES DU RHONE,17100,7700,337,7363,2008,t2,cantonales
8543,13,BOUCHES DU RHONE,18606,7720,1734,5986,2008,t2,cantonales
8544,13,BOUCHES DU RHONE,18521,10762,451,10311,2008,t2,cantonales
8545,13,BOUCHES DU RHONE,17510,10325,373,9952,2008,t2,cantonales
8546,13,BOUCHES DU RHONE,23281,12577,329,12248,2008,t2,cantonales
8547,13,BOUCHES DU RHONE,24430,14249,892,13357,2008,t2,cantonales
8548,13,BOUCHES DU RHONE,38025,25141,1748,23393,2008,t2,cantonales
8549,13,BOUCHES DU RHONE,20012,12464,498,11966,2008,t2,cantonales
8550,13,BOUCHES DU RHONE,19928,13098,364,12734,2008,t2,cantonales
8551,13,BOUCHES DU RHONE,17120,7077,1961,5116,2008,t2,cantonales
8552,13,BOUCHES DU RHONE,19532,9372,287,9085,2008,t2,cantonales
8553,14,CALVADOS,15463,8953,372,8581,2008,t2,cantonales
8554,14,CALVADOS,18341,9524,323,9201,2008,t2,cantonales
8555,14,CALVADOS,8047,4912,300,4612,2008,t2,cantonales
8556,14,CALVADOS,7027,4144,174,3970,2008,t2,cantonales
8557,14,CALVADOS,5434,3778,227,3551,2008,t2,cantonales
8558,14,CALVADOS,17029,8627,306,8321,2008,t2,cantonales
8559,14,CALVADOS,7633,4924,344,4580,2008,t2,cantonales
8560,14,CALVADOS,8454,5071,89,4982,2008,t2,cantonales
8561,14,CALVADOS,9826,4019,629,3390,2008,t2,cantonales
8562,14,CALVADOS,11623,6468,224,6244,2008,t2,cantonales
8563,14,CALVADOS,16207,8807,304,8503,2008,t2,cantonales
8564,14,CALVADOS,18023,9354,294,9060,2008,t2,cantonales
8565,15,CANTAL,3710,2974,54,2920,2008,t2,cantonales
8566,15,CANTAL,5281,4140,72,4068,2008,t2,cantonales
8567,16,CHARENTE,3634,2637,84,2553,2008,t2,cantonales
8568,16,CHARENTE,6068,3691,140,3551,2008,t2,cantonales
8569,16,CHARENTE,6814,4773,147,4626,2008,t2,cantonales
8570,16,CHARENTE,3166,2333,70,2263,2008,t2,cantonales
8571,16,CHARENTE,18300,10012,267,9745,2008,t2,cantonales
8572,17,CHARENTE MARITIME,5279,3363,203,3160,2008,t2,cantonales
8573,17,CHARENTE MARITIME,8491,5268,195,5073,2008,t2,cantonales
8574,17,CHARENTE MARITIME,9524,4536,825,3711,2008,t2,cantonales
8575,17,CHARENTE MARITIME,16097,7976,287,7689,2008,t2,cantonales
8576,17,CHARENTE MARITIME,7332,5302,109,5193,2008,t2,cantonales
8577,17,CHARENTE MARITIME,5967,3866,222,3644,2008,t2,cantonales
8578,17,CHARENTE MARITIME,7676,4799,149,4650,2008,t2,cantonales
8579,17,CHARENTE MARITIME,3551,2211,108,2103,2008,t2,cantonales
8580,17,CHARENTE MARITIME,5393,3535,93,3442,2008,t2,cantonales
8581,17,CHARENTE MARITIME,12045,7202,561,6641,2008,t2,cantonales
8582,17,CHARENTE MARITIME,13909,8339,212,8127,2008,t2,cantonales
8583,17,CHARENTE MARITIME,6950,2630,68,2562,2008,t2,cantonales
8584,17,CHARENTE MARITIME,13445,6840,119,6721,2008,t2,cantonales
8585,17,CHARENTE MARITIME,10590,6859,411,6448,2008,t2,cantonales
8586,18,CHER,6250,2458,82,2376,2008,t2,cantonales
8587,18,CHER,4518,3223,233,2990,2008,t2,cantonales
8588,18,CHER,7050,4522,233,4289,2008,t2,cantonales
8589,18,CHER,4916,3070,69,3001,2008,t2,cantonales
8590,18,CHER,8492,4853,161,4692,2008,t2,cantonales
8591,18,CHER,6002,3869,137,3732,2008,t2,cantonales
8592,18,CHER,14149,6934,245,6689,2008,t2,cantonales
8593,19,CORREZE,7556,5189,209,4980,2008,t2,cantonales
8594,19,CORREZE,5821,4513,230,4283,2008,t2,cantonales
8595,2A,CORSE SUD,1906,1709,28,1681,2008,t2,cantonales
8596,2A,CORSE SUD,7597,5781,106,5675,2008,t2,cantonales
8597,2A,CORSE SUD,3066,2779,118,2661,2008,t2,cantonales
8598,2A,CORSE SUD,3230,2665,24,2641,2008,t2,cantonales
8599,2A,CORSE SUD,2284,1895,47,1848,2008,t2,cantonales
8600,2A,CORSE SUD,2941,2484,49,2435,2008,t2,cantonales
8601,2A,CORSE SUD,9851,6276,758,5518,2008,t2,cantonales
8602,2B,HAUTE CORSE,5401,3797,564,3233,2008,t2,cantonales
8603,2B,HAUTE CORSE,3472,2865,59,2806,2008,t2,cantonales
8604,2B,HAUTE CORSE,2394,2045,15,2030,2008,t2,cantonales
8605,2B,HAUTE CORSE,1803,1000,64,936,2008,t2,cantonales
8606,21,COTE D'OR,8000,5138,95,5043,2008,t2,cantonales
8607,21,COTE D'OR,24015,10872,340,10532,2008,t2,cantonales
8608,21,COTE D'OR,2251,1470,128,1342,2008,t2,cantonales
8609,21,COTE D'OR,15701,8513,727,7786,2008,t2,cantonales
8610,21,COTE D'OR,2724,2139,104,2035,2008,t2,cantonales
8611,21,COTE D'OR,7114,5448,191,5257,2008,t2,cantonales
8612,21,COTE D'OR,6747,3748,186,3562,2008,t2,cantonales
8613,21,COTE D'OR,12689,6404,133,6271,2008,t2,cantonales
8614,21,COTE D'OR,10497,4661,98,4563,2008,t2,cantonales
8615,22,COTES D'ARMOR,6672,4754,95,4659,2008,t2,cantonales
8616,22,COTES D'ARMOR,4637,3883,386,3497,2008,t2,cantonales
8617,22,COTES D'ARMOR,6787,5077,195,4882,2008,t2,cantonales
8618,22,COTES D'ARMOR,4906,3977,256,3721,2008,t2,cantonales
8619,22,COTES D'ARMOR,11996,7174,198,6976,2008,t2,cantonales
8620,22,COTES D'ARMOR,2689,1685,279,1406,2008,t2,cantonales
8621,22,COTES D'ARMOR,16398,9594,455,9139,2008,t2,cantonales
8622,22,COTES D'ARMOR,19249,9673,562,9111,2008,t2,cantonales
8623,22,COTES D'ARMOR,6027,4996,292,4704,2008,t2,cantonales
8624,22,COTES D'ARMOR,11208,7599,211,7388,2008,t2,cantonales
8625,22,COTES D'ARMOR,9879,5871,224,5647,2008,t2,cantonales
8626,22,COTES D'ARMOR,10775,6332,334,5998,2008,t2,cantonales
8627,22,COTES D'ARMOR,10061,7204,359,6845,2008,t2,cantonales
8628,22,COTES D'ARMOR,2835,2323,60,2263,2008,t2,cantonales
8629,22,COTES D'ARMOR,16176,8510,2225,6285,2008,t2,cantonales
8630,23,CREUSE,4482,3185,89,3096,2008,t2,cantonales
8631,23,CREUSE,2913,1937,156,1781,2008,t2,cantonales
8632,23,CREUSE,3283,2527,80,2447,2008,t2,cantonales
8633,23,CREUSE,2429,1899,54,1845,2008,t2,cantonales
8634,23,CREUSE,8570,5575,192,5383,2008,t2,cantonales
8635,24,DORDOGNE,2611,2124,52,2072,2008,t2,cantonales
8636,24,DORDOGNE,4377,3482,279,3203,2008,t2,cantonales
8637,24,DORDOGNE,3291,2514,151,2363,2008,t2,cantonales
8638,24,DORDOGNE,3463,2460,78,2382,2008,t2,cantonales
8639,24,DORDOGNE,2736,2223,79,2144,2008,t2,cantonales
8640,24,DORDOGNE,5886,4416,122,4294,2008,t2,cantonales
8641,24,DORDOGNE,11056,7993,299,7694,2008,t2,cantonales
8642,24,DORDOGNE,3816,2837,180,2657,2008,t2,cantonales
8643,24,DORDOGNE,5901,4768,163,4605,2008,t2,cantonales
8644,24,DORDOGNE,7678,4881,233,4648,2008,t2,cantonales
8645,25,DOUBS,3106,2617,70,2547,2008,t2,cantonales
8646,25,DOUBS,19508,11390,418,10972,2008,t2,cantonales
8647,25,DOUBS,6755,4697,272,4425,2008,t2,cantonales
8648,25,DOUBS,14489,7605,214,7391,2008,t2,cantonales
8649,25,DOUBS,13015,7376,234,7142,2008,t2,cantonales
8650,25,DOUBS,4549,3598,73,3525,2008,t2,cantonales
8651,25,DOUBS,14724,9126,261,8865,2008,t2,cantonales
8652,25,DOUBS,16410,8411,205,8206,2008,t2,cantonales
8653,25,DOUBS,8671,4353,184,4169,2008,t2,cantonales
8654,25,DOUBS,10292,3324,252,3072,2008,t2,cantonales
8655,26,DROME,1730,1409,69,1340,2008,t2,cantonales
8656,26,DROME,12562,7755,224,7531,2008,t2,cantonales
8657,26,DROME,12439,6498,174,6324,2008,t2,cantonales
8658,26,DROME,20167,11930,422,11508,2008,t2,cantonales
8659,26,DROME,6056,3591,124,3467,2008,t2,cantonales
8660,26,DROME,14112,8464,246,8218,2008,t2,cantonales
8661,26,DROME,1990,1551,108,1443,2008,t2,cantonales
8662,26,DROME,10490,6434,170,6264,2008,t2,cantonales
8663,26,DROME,9865,6180,131,6049,2008,t2,cantonales
8664,26,DROME,15597,9592,228,9364,2008,t2,cantonales
8665,26,DROME,12914,7326,254,7072,2008,t2,cantonales
8666,27,EURE,8184,5074,197,4877,2008,t2,cantonales
8667,27,EURE,10900,5425,369,5056,2008,t2,cantonales
8668,27,EURE,13341,7874,354,7520,2008,t2,cantonales
8669,27,EURE,3708,2209,125,2084,2008,t2,cantonales
8670,27,EURE,4520,2864,189,2675,2008,t2,cantonales
8671,27,EURE,11300,6380,294,6086,2008,t2,cantonales
8672,27,EURE,5839,3531,110,3421,2008,t2,cantonales
8673,27,EURE,11689,6241,217,6024,2008,t2,cantonales
8674,27,EURE,12871,7248,307,6941,2008,t2,cantonales
8675,27,EURE,12073,7117,247,6870,2008,t2,cantonales
8676,27,EURE,11622,6781,244,6537,2008,t2,cantonales
8677,27,EURE,12202,6274,1182,5092,2008,t2,cantonales
8678,28,EURE ET LOIR,13992,7192,235,6957,2008,t2,cantonales
8679,28,EURE ET LOIR,10670,5944,354,5590,2008,t2,cantonales
8680,28,EURE ET LOIR,4762,3106,203,2903,2008,t2,cantonales
8681,28,EURE ET LOIR,12460,7005,236,6769,2008,t2,cantonales
8682,28,EURE ET LOIR,12334,6306,97,6209,2008,t2,cantonales
8683,28,EURE ET LOIR,15260,8845,312,8533,2008,t2,cantonales
8684,28,EURE ET LOIR,8660,4590,252,4338,2008,t2,cantonales
8685,28,EURE ET LOIR,12090,6580,353,6227,2008,t2,cantonales
8686,29,FINISTERE,11747,5957,554,5403,2008,t2,cantonales
8687,29,FINISTERE,4318,3219,196,3023,2008,t2,cantonales
8688,29,FINISTERE,19634,12682,351,12331,2008,t2,cantonales
8689,29,FINISTERE,12709,7474,114,7360,2008,t2,cantonales
8690,29,FINISTERE,17840,10899,294,10605,2008,t2,cantonales
8691,29,FINISTERE,18810,11971,247,11724,2008,t2,cantonales
8692,29,FINISTERE,8481,6010,141,5869,2008,t2,cantonales
8693,29,FINISTERE,14273,9614,270,9344,2008,t2,cantonales
8694,29,FINISTERE,18028,11811,440,11371,2008,t2,cantonales
8695,29,FINISTERE,24774,15281,202,15079,2008,t2,cantonales
8696,29,FINISTERE,8521,3793,1178,2615,2008,t2,cantonales
8697,29,FINISTERE,19901,13712,594,13118,2008,t2,cantonales
8698,29,FINISTERE,18146,11082,493,10589,2008,t2,cantonales
8699,29,FINISTERE,16169,10277,329,9948,2008,t2,cantonales
8700,30,GARD,9099,5713,185,5528,2008,t2,cantonales
8701,30,GARD,25185,15432,1188,14244,2008,t2,cantonales
8702,30,GARD,18769,12151,660,11491,2008,t2,cantonales
8703,30,GARD,8193,5561,310,5251,2008,t2,cantonales
8704,30,GARD,2644,1965,77,1888,2008,t2,cantonales
8705,30,GARD,21517,13027,381,12646,2008,t2,cantonales
8706,30,GARD,21097,13003,517,12486,2008,t2,cantonales
8707,30,GARD,18490,10981,488,10493,2008,t2,cantonales
8708,30,GARD,4629,3298,154,3144,2008,t2,cantonales
8709,30,GARD,11067,7098,370,6728,2008,t2,cantonales
8710,30,GARD,10992,7358,279,7079,2008,t2,cantonales
8711,30,GARD,1843,1403,67,1336,2008,t2,cantonales
8712,30,GARD,25557,14601,451,14150,2008,t2,cantonales
8713,30,GARD,20644,10356,491,9865,2008,t2,cantonales
8714,30,GARD,9835,5429,214,5215,2008,t2,cantonales
8715,30,GARD,17460,10728,361,10367,2008,t2,cantonales
8716,30,GARD,16551,9088,344,8744,2008,t2,cantonales
8717,31,HAUTE GARONNE,13649,8385,249,8136,2008,t2,cantonales
8718,31,HAUTE GARONNE,20614,11565,625,10940,2008,t2,cantonales
8719,31,HAUTE GARONNE,6503,4766,148,4618,2008,t2,cantonales
8720,31,HAUTE GARONNE,18986,12428,875,11553,2008,t2,cantonales
8721,31,HAUTE GARONNE,16014,9648,260,9388,2008,t2,cantonales
8722,31,HAUTE GARONNE,6914,5036,213,4823,2008,t2,cantonales
8723,31,HAUTE GARONNE,15149,8860,259,8601,2008,t2,cantonales
8724,31,HAUTE GARONNE,12841,7438,308,7130,2008,t2,cantonales
8725,31,HAUTE GARONNE,36209,21338,619,20719,2008,t2,cantonales
8726,31,HAUTE GARONNE,28837,17970,667,17303,2008,t2,cantonales
8727,31,HAUTE GARONNE,17819,10313,435,9878,2008,t2,cantonales
8728,31,HAUTE GARONNE,16253,9277,507,8770,2008,t2,cantonales
8729,31,HAUTE GARONNE,27355,15235,735,14500,2008,t2,cantonales
8730,32,GERS,2311,1769,84,1685,2008,t2,cantonales
8731,32,GERS,7957,6081,220,5861,2008,t2,cantonales
8732,32,GERS,4751,3406,90,3316,2008,t2,cantonales
8733,32,GERS,9112,5224,243,4981,2008,t2,cantonales
8734,32,GERS,2392,1923,78,1845,2008,t2,cantonales
8735,32,GERS,4823,3507,132,3375,2008,t2,cantonales
8736,32,GERS,6915,3887,242,3645,2008,t2,cantonales
8737,33,GIRONDE,37255,18114,489,17625,2008,t2,cantonales
8738,33,GIRONDE,10285,6099,208,5891,2008,t2,cantonales
8739,33,GIRONDE,14369,5442,116,5326,2008,t2,cantonales
8740,33,GIRONDE,18502,7101,143,6958,2008,t2,cantonales
8741,33,GIRONDE,12948,5127,81,5046,2008,t2,cantonales
8742,33,GIRONDE,7975,3504,93,3411,2008,t2,cantonales
8743,33,GIRONDE,31098,15154,506,14648,2008,t2,cantonales
8744,33,GIRONDE,12557,6966,306,6660,2008,t2,cantonales
8745,33,GIRONDE,12829,7917,258,7659,2008,t2,cantonales
8746,33,GIRONDE,13185,8395,396,7999,2008,t2,cantonales
8747,33,GIRONDE,9609,5990,189,5801,2008,t2,cantonales
8748,33,GIRONDE,13941,7085,258,6827,2008,t2,cantonales
8749,33,GIRONDE,8738,5833,285,5548,2008,t2,cantonales
8750,33,GIRONDE,13741,8173,311,7862,2008,t2,cantonales
8751,33,GIRONDE,7904,5593,171,5422,2008,t2,cantonales
8752,33,GIRONDE,36993,21410,590,20820,2008,t2,cantonales
8753,33,GIRONDE,23387,9194,242,8952,2008,t2,cantonales
8754,33,GIRONDE,19442,10279,225,10054,2008,t2,cantonales
8755,33,GIRONDE,32441,15019,456,14563,2008,t2,cantonales
8756,33,GIRONDE,37089,22835,1031,21804,2008,t2,cantonales
8757,34,HERAULT,33113,22905,1146,21759,2008,t2,cantonales
8758,34,HERAULT,6813,4602,281,4321,2008,t2,cantonales
8759,34,HERAULT,13143,4782,201,4581,2008,t2,cantonales
8760,34,HERAULT,23881,12810,859,11951,2008,t2,cantonales
8761,34,HERAULT,34072,21354,1048,20306,2008,t2,cantonales
8762,34,HERAULT,9238,6848,269,6579,2008,t2,cantonales
8763,34,HERAULT,3424,2202,175,2027,2008,t2,cantonales
8764,34,HERAULT,22632,13955,652,13303,2008,t2,cantonales
8765,34,HERAULT,7903,5001,241,4760,2008,t2,cantonales
8766,34,HERAULT,13730,6287,136,6151,2008,t2,cantonales
8767,34,HERAULT,15783,8181,156,8025,2008,t2,cantonales
8768,34,HERAULT,15423,11269,817,10452,2008,t2,cantonales
8769,34,HERAULT,16979,8896,436,8460,2008,t2,cantonales
8770,34,HERAULT,23261,13775,591,13184,2008,t2,cantonales
8771,35,ILLE ET VILAINE,6804,4962,199,4763,2008,t2,cantonales
8772,35,ILLE ET VILAINE,20204,12129,538,11591,2008,t2,cantonales
8773,35,ILLE ET VILAINE,18318,9605,329,9276,2008,t2,cantonales
8774,35,ILLE ET VILAINE,10935,6588,212,6376,2008,t2,cantonales
8775,35,ILLE ET VILAINE,5799,4291,217,4074,2008,t2,cantonales
8776,35,ILLE ET VILAINE,19589,11726,415,11311,2008,t2,cantonales
8777,35,ILLE ET VILAINE,20118,10929,252,10677,2008,t2,cantonales
8778,35,ILLE ET VILAINE,13353,7320,154,7166,2008,t2,cantonales
8779,35,ILLE ET VILAINE,16825,9453,258,9195,2008,t2,cantonales
8780,35,ILLE ET VILAINE,7437,4761,227,4534,2008,t2,cantonales
8781,35,ILLE ET VILAINE,7400,5678,133,5545,2008,t2,cantonales
8782,35,ILLE ET VILAINE,16544,8251,195,8056,2008,t2,cantonales
8783,35,ILLE ET VILAINE,10576,5507,190,5317,2008,t2,cantonales
8784,35,ILLE ET VILAINE,9883,5465,224,5241,2008,t2,cantonales
8785,35,ILLE ET VILAINE,19430,9843,270,9573,2008,t2,cantonales
8786,35,ILLE ET VILAINE,9021,4194,543,3651,2008,t2,cantonales
8787,36,INDRE,12819,7685,190,7495,2008,t2,cantonales
8788,36,INDRE,9197,6158,155,6003,2008,t2,cantonales
8789,36,INDRE,12385,5761,267,5494,2008,t2,cantonales
8790,36,INDRE,4978,3666,171,3495,2008,t2,cantonales
8791,36,INDRE,4457,3026,115,2911,2008,t2,cantonales
8792,36,INDRE,3615,2534,50,2484,2008,t2,cantonales
8793,36,INDRE,7105,2822,131,2691,2008,t2,cantonales
8794,37,INDRE ET LOIRE,14982,9176,264,8912,2008,t2,cantonales
8795,37,INDRE ET LOIRE,8372,5355,231,5124,2008,t2,cantonales
8796,37,INDRE ET LOIRE,9842,5855,207,5648,2008,t2,cantonales
8797,37,INDRE ET LOIRE,4257,2908,136,2772,2008,t2,cantonales
8798,37,INDRE ET LOIRE,8555,5453,179,5274,2008,t2,cantonales
8799,37,INDRE ET LOIRE,11549,6179,119,6060,2008,t2,cantonales
8800,37,INDRE ET LOIRE,19673,10543,274,10269,2008,t2,cantonales
8801,37,INDRE ET LOIRE,12243,5878,118,5760,2008,t2,cantonales
8802,37,INDRE ET LOIRE,10669,5030,170,4860,2008,t2,cantonales
8803,37,INDRE ET LOIRE,16455,8839,225,8614,2008,t2,cantonales
8804,37,INDRE ET LOIRE,14809,9518,343,9175,2008,t2,cantonales
8805,38,ISERE,5570,3472,58,3414,2008,t2,cantonales
8806,38,ISERE,14178,7447,358,7089,2008,t2,cantonales
8807,38,ISERE,8688,5360,249,5111,2008,t2,cantonales
8808,38,ISERE,17828,10528,333,10195,2008,t2,cantonales
8809,38,ISERE,19505,9961,454,9507,2008,t2,cantonales
8810,38,ISERE,23809,12912,398,12514,2008,t2,cantonales
8811,38,ISERE,21814,10770,479,10291,2008,t2,cantonales
8812,38,ISERE,10894,5707,141,5566,2008,t2,cantonales
8813,38,ISERE,16955,8541,213,8328,2008,t2,cantonales
8814,38,ISERE,21345,13149,714,12435,2008,t2,cantonales
8815,38,ISERE,17244,7772,425,7347,2008,t2,cantonales
8816,38,ISERE,12607,5094,224,4870,2008,t2,cantonales
8817,38,ISERE,13166,6466,316,6150,2008,t2,cantonales
8818,38,ISERE,19219,9230,280,8950,2008,t2,cantonales
8819,38,ISERE,19479,8741,310,8431,2008,t2,cantonales
8820,38,ISERE,6640,1924,325,1599,2008,t2,cantonales
8821,38,ISERE,14759,8614,264,8350,2008,t2,cantonales
8822,39,JURA,5101,3620,139,3481,2008,t2,cantonales
8823,39,JURA,4895,3507,154,3353,2008,t2,cantonales
8824,39,JURA,3464,2500,89,2411,2008,t2,cantonales
8825,39,JURA,3529,2663,95,2568,2008,t2,cantonales
8826,39,JURA,14107,7722,164,7558,2008,t2,cantonales
8827,39,JURA,4170,2664,176,2488,2008,t2,cantonales
8828,39,JURA,4485,2752,106,2646,2008,t2,cantonales
8829,39,JURA,5066,3532,149,3383,2008,t2,cantonales
8830,39,JURA,10241,5140,199,4941,2008,t2,cantonales
8831,40,LANDES,18993,12217,545,11672,2008,t2,cantonales
8832,40,LANDES,8242,5315,227,5088,2008,t2,cantonales
8833,40,LANDES,6120,4153,145,4008,2008,t2,cantonales
8834,40,LANDES,18549,10446,540,9906,2008,t2,cantonales
8835,40,LANDES,20789,12701,451,12250,2008,t2,cantonales
8836,41,LOIR ET CHER,11789,6471,302,6169,2008,t2,cantonales
8837,41,LOIR ET CHER,14639,8983,309,8674,2008,t2,cantonales
8838,41,LOIR ET CHER,11639,7415,286,7129,2008,t2,cantonales
8839,41,LOIR ET CHER,5438,3236,126,3110,2008,t2,cantonales
8840,41,LOIR ET CHER,7926,5492,306,5186,2008,t2,cantonales
8841,41,LOIR ET CHER,9353,6219,236,5983,2008,t2,cantonales
8842,41,LOIR ET CHER,7975,4797,168,4629,2008,t2,cantonales
8843,41,LOIR ET CHER,7564,4749,305,4444,2008,t2,cantonales
8844,42,LOIRE,13459,6811,134,6677,2008,t2,cantonales
8845,42,LOIRE,21498,14662,321,14341,2008,t2,cantonales
8846,42,LOIRE,6518,4337,173,4164,2008,t2,cantonales
8847,42,LOIRE,11334,6192,134,6058,2008,t2,cantonales
8848,42,LOIRE,18898,10258,669,9589,2008,t2,cantonales
8849,42,LOIRE,15569,8232,163,8069,2008,t2,cantonales
8850,42,LOIRE,21680,12992,396,12596,2008,t2,cantonales
8851,42,LOIRE,4624,3051,99,2952,2008,t2,cantonales
8852,42,LOIRE,15781,6608,548,6060,2008,t2,cantonales
8853,42,LOIRE,15900,9315,234,9081,2008,t2,cantonales
8854,42,LOIRE,12619,7041,206,6835,2008,t2,cantonales
8855,43,HAUTE LOIRE,2089,1726,28,1698,2008,t2,cantonales
8856,43,HAUTE LOIRE,3757,2973,112,2861,2008,t2,cantonales
8857,43,HAUTE LOIRE,3543,2744,79,2665,2008,t2,cantonales
8858,43,HAUTE LOIRE,1024,829,18,811,2008,t2,cantonales
8859,43,HAUTE LOIRE,8730,4886,154,4732,2008,t2,cantonales
8860,43,HAUTE LOIRE,2613,1981,41,1940,2008,t2,cantonales
8861,43,HAUTE LOIRE,10888,6186,376,5810,2008,t2,cantonales
8862,43,HAUTE LOIRE,4479,3315,83,3232,2008,t2,cantonales
8863,43,HAUTE LOIRE,3958,2654,106,2548,2008,t2,cantonales
8864,43,HAUTE LOIRE,5479,2948,74,2874,2008,t2,cantonales
8865,43,HAUTE LOIRE,5137,3400,197,3203,2008,t2,cantonales
8866,43,HAUTE LOIRE,6390,4392,204,4188,2008,t2,cantonales
8867,44,LOIRE ATLANTIQUE,9137,5857,188,5669,2008,t2,cantonales
8868,44,LOIRE ATLANTIQUE,26743,13259,528,12731,2008,t2,cantonales
8869,44,LOIRE ATLANTIQUE,11103,7029,134,6895,2008,t2,cantonales
8870,44,LOIRE ATLANTIQUE,24838,14935,344,14591,2008,t2,cantonales
8871,44,LOIRE ATLANTIQUE,10265,6551,162,6389,2008,t2,cantonales
8872,44,LOIRE ATLANTIQUE,22214,8218,146,8072,2008,t2,cantonales
8873,44,LOIRE ATLANTIQUE,17415,7064,108,6956,2008,t2,cantonales
8874,44,LOIRE ATLANTIQUE,19570,10220,337,9883,2008,t2,cantonales
8875,44,LOIRE ATLANTIQUE,16793,9709,453,9256,2008,t2,cantonales
8876,44,LOIRE ATLANTIQUE,4423,3089,107,2982,2008,t2,cantonales
8877,44,LOIRE ATLANTIQUE,8226,4733,168,4565,2008,t2,cantonales
8878,44,LOIRE ATLANTIQUE,12566,7347,217,7130,2008,t2,cantonales
8879,44,LOIRE ATLANTIQUE,16946,8364,293,8071,2008,t2,cantonales
8880,44,LOIRE ATLANTIQUE,14656,7672,548,7124,2008,t2,cantonales
8881,44,LOIRE ATLANTIQUE,17101,6022,279,5743,2008,t2,cantonales
8882,44,LOIRE ATLANTIQUE,16859,8769,361,8408,2008,t2,cantonales
8883,45,LOIRET,7808,4782,298,4484,2008,t2,cantonales
8884,45,LOIRET,17135,9085,355,8730,2008,t2,cantonales
8885,45,LOIRET,10657,6133,303,5830,2008,t2,cantonales
8886,45,LOIRET,10870,6311,192,6119,2008,t2,cantonales
8887,45,LOIRET,9465,5166,257,4909,2008,t2,cantonales
8888,45,LOIRET,12730,7311,206,7105,2008,t2,cantonales
8889,45,LOIRET,6332,3917,170,3747,2008,t2,cantonales
8890,45,LOIRET,19415,10573,241,10332,2008,t2,cantonales
8891,45,LOIRET,12972,7245,265,6980,2008,t2,cantonales
8892,45,LOIRET,25059,13198,394,12804,2008,t2,cantonales
8893,45,LOIRET,8974,5175,137,5038,2008,t2,cantonales
8894,46,LOT,6816,4842,264,4578,2008,t2,cantonales
8895,46,LOT,4157,2799,182,2617,2008,t2,cantonales
8896,46,LOT,6331,4271,217,4054,2008,t2,cantonales
8897,46,LOT,4442,3232,140,3092,2008,t2,cantonales
8898,46,LOT,6126,4679,125,4554,2008,t2,cantonales
8899,47,LOT ET GARONNE,8858,6009,239,5770,2008,t2,cantonales
8900,47,LOT ET GARONNE,8750,5300,238,5062,2008,t2,cantonales
8901,47,LOT ET GARONNE,7069,5222,125,5097,2008,t2,cantonales
8902,47,LOT ET GARONNE,6698,4589,163,4426,2008,t2,cantonales
8903,47,LOT ET GARONNE,4697,3397,88,3309,2008,t2,cantonales
8904,47,LOT ET GARONNE,3151,2385,56,2329,2008,t2,cantonales
8905,47,LOT ET GARONNE,7402,5058,128,4930,2008,t2,cantonales
8906,47,LOT ET GARONNE,5957,4047,160,3887,2008,t2,cantonales
8907,47,LOT ET GARONNE,6471,4322,171,4151,2008,t2,cantonales
8908,47,LOT ET GARONNE,5712,4114,135,3979,2008,t2,cantonales
8909,47,LOT ET GARONNE,5091,3811,116,3695,2008,t2,cantonales
8910,47,LOT ET GARONNE,2947,2128,86,2042,2008,t2,cantonales
8911,47,LOT ET GARONNE,10702,6503,229,6274,2008,t2,cantonales
8912,47,LOT ET GARONNE,10408,6282,201,6081,2008,t2,cantonales
8913,48,LOZERE,1206,931,51,880,2008,t2,cantonales
8914,48,LOZERE,3138,1879,540,1339,2008,t2,cantonales
8915,48,LOZERE,6562,5214,304,4910,2008,t2,cantonales
8916,48,LOZERE,1233,970,20,950,2008,t2,cantonales
8917,48,LOZERE,5132,4274,78,4196,2008,t2,cantonales
8918,48,LOZERE,4441,3296,183,3113,2008,t2,cantonales
8919,49,MAINE ET LOIRE,20541,11121,459,10662,2008,t2,cantonales
8920,49,MAINE ET LOIRE,19492,10417,575,9842,2008,t2,cantonales
8921,49,MAINE ET LOIRE,20600,10932,413,10519,2008,t2,cantonales
8922,49,MAINE ET LOIRE,8675,4692,108,4584,2008,t2,cantonales
8923,49,MAINE ET LOIRE,9636,6106,173,5933,2008,t2,cantonales
8924,49,MAINE ET LOIRE,7053,4709,105,4604,2008,t2,cantonales
8925,49,MAINE ET LOIRE,8401,4939,197,4742,2008,t2,cantonales
8926,49,MAINE ET LOIRE,17249,9589,321,9268,2008,t2,cantonales
8927,49,MAINE ET LOIRE,19509,8420,212,8208,2008,t2,cantonales
8928,50,MANCHE,14615,7406,360,7046,2008,t2,cantonales
8929,50,MANCHE,5255,3214,171,3043,2008,t2,cantonales
8930,50,MANCHE,7383,2903,82,2821,2008,t2,cantonales
8931,50,MANCHE,19158,12377,568,11809,2008,t2,cantonales
8932,50,MANCHE,5152,3238,116,3122,2008,t2,cantonales
8933,50,MANCHE,6941,4467,109,4358,2008,t2,cantonales
8934,50,MANCHE,4813,3532,180,3352,2008,t2,cantonales
8935,50,MANCHE,9677,5304,203,5101,2008,t2,cantonales
8936,50,MANCHE,7496,4262,144,4118,2008,t2,cantonales
8937,50,MANCHE,5726,3454,93,3361,2008,t2,cantonales
8938,50,MANCHE,10044,5132,79,5053,2008,t2,cantonales
8939,50,MANCHE,2292,1737,105,1632,2008,t2,cantonales
8940,50,MANCHE,6115,3953,223,3730,2008,t2,cantonales
8941,51,MARNE,5127,3307,191,3116,2008,t2,cantonales
8942,51,MARNE,8438,4190,168,4022,2008,t2,cantonales
8943,51,MARNE,2583,1825,125,1700,2008,t2,cantonales
8944,51,MARNE,10802,6070,205,5865,2008,t2,cantonales
8945,51,MARNE,13696,7414,199,7215,2008,t2,cantonales
8946,51,MARNE,10527,5202,150,5052,2008,t2,cantonales
8947,51,MARNE,9039,4733,212,4521,2008,t2,cantonales
8948,51,MARNE,11612,5554,120,5434,2008,t2,cantonales
8949,51,MARNE,10858,5399,181,5218,2008,t2,cantonales
8950,51,MARNE,13335,6923,221,6702,2008,t2,cantonales
8951,52,HAUTE MARNE,5027,3545,131,3414,2008,t2,cantonales
8952,52,HAUTE MARNE,5639,3307,121,3186,2008,t2,cantonales
8953,52,HAUTE MARNE,2380,1657,48,1609,2008,t2,cantonales
8954,52,HAUTE MARNE,3713,2322,122,2200,2008,t2,cantonales
8955,52,HAUTE MARNE,12496,5408,246,5162,2008,t2,cantonales
8956,53,MAYENNE,12580,7080,255,6825,2008,t2,cantonales
8957,53,MAYENNE,2663,1953,98,1855,2008,t2,cantonales
8958,53,MAYENNE,5856,3596,161,3435,2008,t2,cantonales
8959,53,MAYENNE,7962,4138,81,4057,2008,t2,cantonales
8960,54,MEURTHE ET MOSELLE,8080,4488,280,4208,2008,t2,cantonales
8961,54,MEURTHE ET MOSELLE,2713,1764,89,1675,2008,t2,cantonales
8962,54,MEURTHE ET MOSELLE,8434,4342,170,4172,2008,t2,cantonales
8963,54,MEURTHE ET MOSELLE,15802,7882,349,7533,2008,t2,cantonales
8964,54,MEURTHE ET MOSELLE,17844,8719,335,8384,2008,t2,cantonales
8965,54,MEURTHE ET MOSELLE,7312,4275,1574,2701,2008,t2,cantonales
8966,54,MEURTHE ET MOSELLE,13719,5358,171,5187,2008,t2,cantonales
8967,54,MEURTHE ET MOSELLE,19880,8939,214,8725,2008,t2,cantonales
8968,54,MEURTHE ET MOSELLE,7408,4334,139,4195,2008,t2,cantonales
8969,54,MEURTHE ET MOSELLE,20129,10286,302,9984,2008,t2,cantonales
8970,54,MEURTHE ET MOSELLE,14826,7160,320,6840,2008,t2,cantonales
8971,54,MEURTHE ET MOSELLE,8144,4777,199,4578,2008,t2,cantonales
8972,55,MEUSE,3381,2525,83,2442,2008,t2,cantonales
8973,55,MEUSE,9438,4899,265,4634,2008,t2,cantonales
8974,55,MEUSE,1985,1570,25,1545,2008,t2,cantonales
8975,55,MEUSE,3913,3068,106,2962,2008,t2,cantonales
8976,55,MEUSE,8389,4708,272,4436,2008,t2,cantonales
8977,55,MEUSE,2180,1579,79,1500,2008,t2,cantonales
8978,55,MEUSE,4452,2987,103,2884,2008,t2,cantonales
8979,55,MEUSE,4416,2863,178,2685,2008,t2,cantonales
8980,55,MEUSE,7128,4484,205,4279,2008,t2,cantonales
8981,55,MEUSE,4570,2750,125,2625,2008,t2,cantonales
8982,56,MORBIHAN,25512,15706,352,15354,2008,t2,cantonales
8983,56,MORBIHAN,11902,7132,359,6773,2008,t2,cantonales
8984,56,MORBIHAN,8302,6373,169,6204,2008,t2,cantonales
8985,56,MORBIHAN,14000,8761,164,8597,2008,t2,cantonales
8986,56,MORBIHAN,2294,1933,44,1889,2008,t2,cantonales
8987,56,MORBIHAN,7673,5112,138,4974,2008,t2,cantonales
8988,56,MORBIHAN,22285,13348,551,12797,2008,t2,cantonales
8989,56,MORBIHAN,10214,4293,182,4111,2008,t2,cantonales
8990,56,MORBIHAN,12286,7838,130,7708,2008,t2,cantonales
8991,56,MORBIHAN,4316,3018,87,2931,2008,t2,cantonales
8992,56,MORBIHAN,27263,16491,748,15743,2008,t2,cantonales
8993,56,MORBIHAN,14346,5992,319,5673,2008,t2,cantonales
8994,57,MOSELLE,5120,3482,113,3369,2008,t2,cantonales
8995,57,MOSELLE,23068,11381,209,11172,2008,t2,cantonales
8996,57,MOSELLE,14862,6000,1680,4320,2008,t2,cantonales
8997,57,MOSELLE,26368,13587,988,12599,2008,t2,cantonales
8998,57,MOSELLE,25778,12307,505,11802,2008,t2,cantonales
8999,57,MOSELLE,14734,7413,376,7037,2008,t2,cantonales
9000,57,MOSELLE,13119,9059,263,8796,2008,t2,cantonales
9001,57,MOSELLE,19948,11106,452,10654,2008,t2,cantonales
9002,57,MOSELLE,14562,8470,230,8240,2008,t2,cantonales
9003,57,MOSELLE,4656,3527,77,3450,2008,t2,cantonales
9004,57,MOSELLE,12197,5923,184,5739,2008,t2,cantonales
9005,57,MOSELLE,17646,8324,413,7911,2008,t2,cantonales
9006,57,MOSELLE,20221,10549,535,10014,2008,t2,cantonales
9007,57,MOSELLE,12506,6720,200,6520,2008,t2,cantonales
9008,58,NIEVRE,2283,1574,34,1540,2008,t2,cantonales
9009,58,NIEVRE,6181,3085,213,2872,2008,t2,cantonales
9010,58,NIEVRE,6853,4198,151,4047,2008,t2,cantonales
9011,58,NIEVRE,6603,3886,291,3595,2008,t2,cantonales
9012,58,NIEVRE,8983,3874,826,3048,2008,t2,cantonales
9013,58,NIEVRE,4203,2964,109,2855,2008,t2,cantonales
9014,58,NIEVRE,6221,3681,145,3536,2008,t2,cantonales
9015,59,NORD,12004,6631,251,6380,2008,t2,cantonales
9016,59,NORD,19230,10498,312,10186,2008,t2,cantonales
9017,59,NORD,14242,6794,216,6578,2008,t2,cantonales
9018,59,NORD,28740,13673,525,13148,2008,t2,cantonales
9019,59,NORD,31981,9082,1265,7817,2008,t2,cantonales
9020,59,NORD,30546,14812,3746,11066,2008,t2,cantonales
9021,59,NORD,34580,14066,1011,13055,2008,t2,cantonales
9022,59,NORD,34200,14348,489,13859,2008,t2,cantonales
9023,59,NORD,12019,6910,252,6658,2008,t2,cantonales
9024,59,NORD,11588,5238,204,5034,2008,t2,cantonales
9025,59,NORD,20968,8129,218,7911,2008,t2,cantonales
9026,59,NORD,45282,12955,4151,8804,2008,t2,cantonales
9027,59,NORD,21164,8281,1745,6536,2008,t2,cantonales
9028,59,NORD,11703,7912,228,7684,2008,t2,cantonales
9029,59,NORD,28074,12608,533,12075,2008,t2,cantonales
9030,59,NORD,18524,10454,492,9962,2008,t2,cantonales
9031,59,NORD,8867,5847,497,5350,2008,t2,cantonales
9032,59,NORD,29376,9393,476,8917,2008,t2,cantonales
9033,59,NORD,36346,13844,420,13424,2008,t2,cantonales
9034,59,NORD,14767,6936,271,6665,2008,t2,cantonales
9035,59,NORD,29289,13623,827,12796,2008,t2,cantonales
9036,59,NORD,34004,12076,433,11643,2008,t2,cantonales
9037,59,NORD,32915,15388,765,14623,2008,t2,cantonales
9038,59,NORD,28807,15193,656,14537,2008,t2,cantonales
9039,59,NORD,29206,13572,770,12802,2008,t2,cantonales
9040,59,NORD,24657,13385,645,12740,2008,t2,cantonales
9041,59,NORD,19123,11162,302,10860,2008,t2,cantonales
9042,60,OISE,11178,6217,367,5850,2008,t2,cantonales
9043,60,OISE,11429,6493,246,6247,2008,t2,cantonales
9044,60,OISE,11587,5902,223,5679,2008,t2,cantonales
9045,60,OISE,7184,5119,164,4955,2008,t2,cantonales
9046,60,OISE,25425,13351,596,12755,2008,t2,cantonales
9047,60,OISE,6227,4509,156,4353,2008,t2,cantonales
9048,60,OISE,12065,6663,241,6422,2008,t2,cantonales
9049,60,OISE,20309,10535,389,10146,2008,t2,cantonales
9050,60,OISE,12361,5970,453,5517,2008,t2,cantonales
9051,60,OISE,16748,8843,347,8496,2008,t2,cantonales
9052,60,OISE,12770,8023,389,7634,2008,t2,cantonales
9053,60,OISE,14386,6107,179,5928,2008,t2,cantonales
9054,61,ORNE,7910,3807,80,3727,2008,t2,cantonales
9055,61,ORNE,7940,5370,149,5221,2008,t2,cantonales
9056,61,ORNE,6398,3739,157,3582,2008,t2,cantonales
9057,61,ORNE,6029,3758,163,3595,2008,t2,cantonales
9058,61,ORNE,6782,3831,97,3734,2008,t2,cantonales
9059,61,ORNE,4379,2978,182,2796,2008,t2,cantonales
9060,62,PAS DE CALAIS,18991,12962,533,12429,2008,t2,cantonales
9061,62,PAS DE CALAIS,8750,6442,263,6179,2008,t2,cantonales
9062,62,PAS DE CALAIS,16788,9556,463,9093,2008,t2,cantonales
9063,62,PAS DE CALAIS,8863,6394,224,6170,2008,t2,cantonales
9064,62,PAS DE CALAIS,8332,6150,235,5915,2008,t2,cantonales
9065,62,PAS DE CALAIS,14231,7180,238,6942,2008,t2,cantonales
9066,62,PAS DE CALAIS,15135,6418,1718,4700,2008,t2,cantonales
9067,62,PAS DE CALAIS,14987,4857,690,4167,2008,t2,cantonales
9068,62,PAS DE CALAIS,19651,10609,559,10050,2008,t2,cantonales
9069,62,PAS DE CALAIS,15719,10117,2995,7122,2008,t2,cantonales
9070,62,PAS DE CALAIS,21485,12263,506,11757,2008,t2,cantonales
9071,62,PAS DE CALAIS,15709,10229,325,9904,2008,t2,cantonales
9072,62,PAS DE CALAIS,13129,5905,1340,4565,2008,t2,cantonales
9073,62,PAS DE CALAIS,13026,8321,440,7881,2008,t2,cantonales
9074,62,PAS DE CALAIS,16305,9570,435,9135,2008,t2,cantonales
9075,62,PAS DE CALAIS,18889,9768,367,9401,2008,t2,cantonales
9076,62,PAS DE CALAIS,14505,6324,681,5643,2008,t2,cantonales
9077,62,PAS DE CALAIS,16095,9536,264,9272,2008,t2,cantonales
9078,62,PAS DE CALAIS,14999,7082,1514,5568,2008,t2,cantonales
9079,63,PUY DE DOME,7790,3942,214,3728,2008,t2,cantonales
9080,63,PUY DE DOME,5752,2796,134,2662,2008,t2,cantonales
9081,63,PUY DE DOME,3547,2575,179,2396,2008,t2,cantonales
9082,63,PUY DE DOME,2615,1900,85,1815,2008,t2,cantonales
9083,63,PUY DE DOME,5486,4168,72,4096,2008,t2,cantonales
9084,63,PUY DE DOME,17133,8557,186,8371,2008,t2,cantonales
9085,63,PUY DE DOME,6718,4185,168,4017,2008,t2,cantonales
9086,63,PUY DE DOME,2962,1937,127,1810,2008,t2,cantonales
9087,63,PUY DE DOME,7900,3805,176,3629,2008,t2,cantonales
9088,63,PUY DE DOME,14333,9094,330,8764,2008,t2,cantonales
9089,63,PUY DE DOME,5945,2843,153,2690,2008,t2,cantonales
9090,64,PYRENEES ATLANTIQUES,12651,7130,203,6927,2008,t2,cantonales
9091,64,PYRENEES ATLANTIQUES,16135,9919,376,9543,2008,t2,cantonales
9092,64,PYRENEES ATLANTIQUES,6116,4720,156,4564,2008,t2,cantonales
9093,64,PYRENEES ATLANTIQUES,18211,11460,557,10903,2008,t2,cantonales
9094,64,PYRENEES ATLANTIQUES,7121,5120,190,4930,2008,t2,cantonales
9095,64,PYRENEES ATLANTIQUES,5033,3928,166,3762,2008,t2,cantonales
9096,64,PYRENEES ATLANTIQUES,19551,10187,548,9639,2008,t2,cantonales
9097,64,PYRENEES ATLANTIQUES,6944,5162,91,5071,2008,t2,cantonales
9098,64,PYRENEES ATLANTIQUES,17569,10907,295,10612,2008,t2,cantonales
9099,64,PYRENEES ATLANTIQUES,20864,14366,824,13542,2008,t2,cantonales
9100,64,PYRENEES ATLANTIQUES,12927,8005,331,7674,2008,t2,cantonales
9101,64,PYRENEES ATLANTIQUES,15471,9888,400,9488,2008,t2,cantonales
9102,64,PYRENEES ATLANTIQUES,8415,5539,119,5420,2008,t2,cantonales
9103,65,HAUTES PYRENEES,9058,6096,225,5871,2008,t2,cantonales
9104,65,HAUTES PYRENEES,10736,6976,229,6747,2008,t2,cantonales
9105,65,HAUTES PYRENEES,1831,1298,109,1189,2008,t2,cantonales
9106,65,HAUTES PYRENEES,8044,5402,147,5255,2008,t2,cantonales
9107,65,HAUTES PYRENEES,2973,2393,87,2306,2008,t2,cantonales
9108,65,HAUTES PYRENEES,3965,2306,396,1910,2008,t2,cantonales
9109,65,HAUTES PYRENEES,8857,4752,168,4584,2008,t2,cantonales
9110,65,HAUTES PYRENEES,8943,6135,262,5873,2008,t2,cantonales
9111,65,HAUTES PYRENEES,5518,3869,124,3745,2008,t2,cantonales
9112,65,HAUTES PYRENEES,5351,3326,110,3216,2008,t2,cantonales
9113,65,HAUTES PYRENEES,8477,5298,207,5091,2008,t2,cantonales
9114,66,PYRENEES ORIENTALES,4049,3462,96,3366,2008,t2,cantonales
9115,66,PYRENEES ORIENTALES,1663,1298,33,1265,2008,t2,cantonales
9116,66,PYRENEES ORIENTALES,8190,5055,1027,4028,2008,t2,cantonales
9117,66,PYRENEES ORIENTALES,11566,6973,380,6593,2008,t2,cantonales
9118,66,PYRENEES ORIENTALES,8051,5028,262,4766,2008,t2,cantonales
9119,66,PYRENEES ORIENTALES,5231,2830,402,2428,2008,t2,cantonales
9120,66,PYRENEES ORIENTALES,8032,4722,254,4468,2008,t2,cantonales
9121,66,PYRENEES ORIENTALES,15160,9312,350,8962,2008,t2,cantonales
9122,66,PYRENEES ORIENTALES,16027,9914,484,9430,2008,t2,cantonales
9123,66,PYRENEES ORIENTALES,11582,8562,330,8232,2008,t2,cantonales
9124,66,PYRENEES ORIENTALES,13708,9318,311,9007,2008,t2,cantonales
9125,67,BAS RHIN,14813,7078,319,6759,2008,t2,cantonales
9126,67,BAS RHIN,13427,7196,305,6891,2008,t2,cantonales
9127,67,BAS RHIN,15346,8108,164,7944,2008,t2,cantonales
9128,67,BAS RHIN,12066,6971,242,6729,2008,t2,cantonales
9129,67,BAS RHIN,12572,7323,189,7134,2008,t2,cantonales
9130,67,BAS RHIN,13469,7685,220,7465,2008,t2,cantonales
9131,67,BAS RHIN,14989,7760,299,7461,2008,t2,cantonales
9132,67,BAS RHIN,16572,7044,190,6854,2008,t2,cantonales
9133,68,HAUT RHIN,26604,12355,474,11881,2008,t2,cantonales
9134,68,HAUT RHIN,15207,7552,656,6896,2008,t2,cantonales
9135,68,HAUT RHIN,11546,6794,267,6527,2008,t2,cantonales
9136,68,HAUT RHIN,14983,7213,1229,5984,2008,t2,cantonales
9137,68,HAUT RHIN,25855,12465,1173,11292,2008,t2,cantonales
9138,68,HAUT RHIN,8868,5829,132,5697,2008,t2,cantonales
9139,68,HAUT RHIN,16716,8199,432,7767,2008,t2,cantonales
9140,68,HAUT RHIN,27866,15258,653,14605,2008,t2,cantonales
9141,68,HAUT RHIN,15830,8257,913,7344,2008,t2,cantonales
9142,69,RHONE,11534,6509,125,6384,2008,t2,cantonales
9143,69,RHONE,21124,11056,183,10873,2008,t2,cantonales
9144,69,RHONE,26181,9181,282,8899,2008,t2,cantonales
9145,69,RHONE,21433,8877,174,8703,2008,t2,cantonales
9146,69,RHONE,15446,6640,128,6512,2008,t2,cantonales
9147,69,RHONE,16301,9362,246,9116,2008,t2,cantonales
9148,69,RHONE,28229,13131,386,12745,2008,t2,cantonales
9149,69,RHONE,29533,14349,560,13789,2008,t2,cantonales
9150,69,RHONE,15530,8085,300,7785,2008,t2,cantonales
9151,69,RHONE,17607,9756,360,9396,2008,t2,cantonales
9152,69,RHONE,21174,9134,382,8752,2008,t2,cantonales
9153,69,RHONE,16634,5903,164,5739,2008,t2,cantonales
9154,69,RHONE,15455,5651,193,5458,2008,t2,cantonales
9155,69,RHONE,12219,3640,219,3421,2008,t2,cantonales
9156,69,RHONE,27932,11728,318,11410,2008,t2,cantonales
9157,69,RHONE,31493,17245,912,16333,2008,t2,cantonales
9158,69,RHONE,19025,10446,317,10129,2008,t2,cantonales
9159,69,RHONE,20299,10113,253,9860,2008,t2,cantonales
9160,69,RHONE,21153,11212,648,10564,2008,t2,cantonales
9161,69,RHONE,19314,6829,219,6610,2008,t2,cantonales
9162,70,HAUTE SAONE,9421,5978,196,5782,2008,t2,cantonales
9163,70,HAUTE SAONE,7467,4615,195,4420,2008,t2,cantonales
9164,70,HAUTE SAONE,3500,2641,111,2530,2008,t2,cantonales
9165,70,HAUTE SAONE,10883,7302,441,6861,2008,t2,cantonales
9166,70,HAUTE SAONE,2007,1611,54,1557,2008,t2,cantonales
9167,70,HAUTE SAONE,7648,4943,267,4676,2008,t2,cantonales
9168,71,SAONE ET LOIRE,6894,4384,296,4088,2008,t2,cantonales
9169,71,SAONE ET LOIRE,7086,4397,121,4276,2008,t2,cantonales
9170,71,SAONE ET LOIRE,11808,6464,261,6203,2008,t2,cantonales
9171,71,SAONE ET LOIRE,13221,5937,181,5756,2008,t2,cantonales
9172,71,SAONE ET LOIRE,5128,3268,112,3156,2008,t2,cantonales
9173,71,SAONE ET LOIRE,6449,4096,204,3892,2008,t2,cantonales
9174,71,SAONE ET LOIRE,4741,2937,96,2841,2008,t2,cantonales
9175,71,SAONE ET LOIRE,9125,6777,222,6555,2008,t2,cantonales
9176,71,SAONE ET LOIRE,18591,8952,369,8583,2008,t2,cantonales
9177,71,SAONE ET LOIRE,7091,4594,244,4350,2008,t2,cantonales
9178,71,SAONE ET LOIRE,2312,1485,67,1418,2008,t2,cantonales
9179,71,SAONE ET LOIRE,5081,3749,74,3675,2008,t2,cantonales
9180,71,SAONE ET LOIRE,8881,5491,210,5281,2008,t2,cantonales
9181,71,SAONE ET LOIRE,2987,2003,38,1965,2008,t2,cantonales
9182,71,SAONE ET LOIRE,7929,5236,107,5129,2008,t2,cantonales
9183,71,SAONE ET LOIRE,9218,2841,445,2396,2008,t2,cantonales
9184,71,SAONE ET LOIRE,13692,6222,175,6047,2008,t2,cantonales
9185,72,SARTHE,10328,5881,215,5666,2008,t2,cantonales
9186,72,SARTHE,4915,3409,144,3265,2008,t2,cantonales
9187,72,SARTHE,5354,3533,148,3385,2008,t2,cantonales
9188,72,SARTHE,19864,10120,501,9619,2008,t2,cantonales
9189,72,SARTHE,11894,4055,221,3834,2008,t2,cantonales
9190,72,SARTHE,14474,6829,148,6681,2008,t2,cantonales
9191,72,SARTHE,5749,3743,109,3634,2008,t2,cantonales
9192,72,SARTHE,16271,9299,418,8881,2008,t2,cantonales
9193,72,SARTHE,4565,3153,89,3064,2008,t2,cantonales
9194,72,SARTHE,11657,5029,277,4752,2008,t2,cantonales
9195,72,SARTHE,11843,4821,227,4594,2008,t2,cantonales
9196,73,SAVOIE,4522,2938,115,2823,2008,t2,cantonales
9197,73,SAVOIE,7963,3578,70,3508,2008,t2,cantonales
9198,73,SAVOIE,4065,2747,73,2674,2008,t2,cantonales
9199,73,SAVOIE,11305,7343,203,7140,2008,t2,cantonales
9200,73,SAVOIE,5778,3913,140,3773,2008,t2,cantonales
9201,73,SAVOIE,3675,2301,85,2216,2008,t2,cantonales
9202,73,SAVOIE,7012,2934,117,2817,2008,t2,cantonales
9203,73,SAVOIE,9755,4952,144,4808,2008,t2,cantonales
9204,74,HAUTE SAVOIE,12793,4696,140,4556,2008,t2,cantonales
9205,74,HAUTE SAVOIE,5222,3236,249,2987,2008,t2,cantonales
9206,74,HAUTE SAVOIE,7165,4516,173,4343,2008,t2,cantonales
9207,74,HAUTE SAVOIE,21527,11098,298,10800,2008,t2,cantonales
9208,74,HAUTE SAVOIE,17713,9914,446,9468,2008,t2,cantonales
9209,74,HAUTE SAVOIE,19815,9751,222,9529,2008,t2,cantonales
9210,74,HAUTE SAVOIE,5751,3680,148,3532,2008,t2,cantonales
9211,74,HAUTE SAVOIE,8179,5062,105,4957,2008,t2,cantonales
9212,74,HAUTE SAVOIE,24153,9141,248,8893,2008,t2,cantonales
9213,76,SEINE MARITIME,17250,10005,414,9591,2008,t2,cantonales
9214,76,SEINE MARITIME,28823,14824,486,14338,2008,t2,cantonales
9215,76,SEINE MARITIME,6115,4114,265,3849,2008,t2,cantonales
9216,76,SEINE MARITIME,20497,12264,607,11657,2008,t2,cantonales
9217,76,SEINE MARITIME,11712,5707,444,5263,2008,t2,cantonales
9218,76,SEINE MARITIME,18680,11046,674,10372,2008,t2,cantonales
9219,76,SEINE MARITIME,14328,8903,209,8694,2008,t2,cantonales
9220,76,SEINE MARITIME,11293,4319,83,4236,2008,t2,cantonales
9221,76,SEINE MARITIME,6783,2687,50,2637,2008,t2,cantonales
9222,76,SEINE MARITIME,15510,6147,264,5883,2008,t2,cantonales
9223,76,SEINE MARITIME,15018,10259,415,9844,2008,t2,cantonales
9224,76,SEINE MARITIME,15317,8447,692,7755,2008,t2,cantonales
9225,76,SEINE MARITIME,7088,3637,332,3305,2008,t2,cantonales
9226,76,SEINE MARITIME,18667,11328,899,10429,2008,t2,cantonales
9227,76,SEINE MARITIME,13975,7381,190,7191,2008,t2,cantonales
9228,77,SEINE ET MARNE,9030,4693,108,4585,2008,t2,cantonales
9229,77,SEINE ET MARNE,27125,11561,343,11218,2008,t2,cantonales
9230,77,SEINE ET MARNE,24628,11633,455,11178,2008,t2,cantonales
9231,77,SEINE ET MARNE,22517,11600,258,11342,2008,t2,cantonales
9232,77,SEINE ET MARNE,28703,14962,325,14637,2008,t2,cantonales
9233,77,SEINE ET MARNE,7388,4713,192,4521,2008,t2,cantonales
9234,77,SEINE ET MARNE,30212,15783,638,15145,2008,t2,cantonales
9235,77,SEINE ET MARNE,8110,4176,218,3958,2008,t2,cantonales
9236,77,SEINE ET MARNE,10718,6349,310,6039,2008,t2,cantonales
9237,77,SEINE ET MARNE,20667,8569,192,8377,2008,t2,cantonales
9238,77,SEINE ET MARNE,20359,9195,240,8955,2008,t2,cantonales
9239,77,SEINE ET MARNE,32278,17339,313,17026,2008,t2,cantonales
9240,77,SEINE ET MARNE,19964,9781,398,9383,2008,t2,cantonales
9241,78,YVELINES,17000,8604,243,8361,2008,t2,cantonales
9242,78,YVELINES,28847,13391,421,12970,2008,t2,cantonales
9243,78,YVELINES,21172,10839,164,10675,2008,t2,cantonales
9244,78,YVELINES,28776,10251,405,9846,2008,t2,cantonales
9245,78,YVELINES,27534,14300,542,13758,2008,t2,cantonales
9246,78,YVELINES,38116,18192,890,17302,2008,t2,cantonales
9247,78,YVELINES,25973,11453,394,11059,2008,t2,cantonales
9248,78,YVELINES,26492,12513,288,12225,2008,t2,cantonales
9249,78,YVELINES,12847,4269,306,3963,2008,t2,cantonales
9250,78,YVELINES,24050,13131,307,12824,2008,t2,cantonales
9251,78,YVELINES,21182,11843,532,11311,2008,t2,cantonales
9252,78,YVELINES,20460,9552,455,9097,2008,t2,cantonales
9253,78,YVELINES,35116,16398,468,15930,2008,t2,cantonales
9254,78,YVELINES,14858,8287,197,8090,2008,t2,cantonales
9255,79,DEUX SEVRES,3967,2574,68,2506,2008,t2,cantonales
9256,79,DEUX SEVRES,5262,3437,85,3352,2008,t2,cantonales
9257,79,DEUX SEVRES,22969,13139,381,12758,2008,t2,cantonales
9258,79,DEUX SEVRES,3243,2411,73,2338,2008,t2,cantonales
9259,80,SOMME,10940,7446,336,7110,2008,t2,cantonales
9260,80,SOMME,12173,7068,319,6749,2008,t2,cantonales
9261,80,SOMME,7744,4304,197,4107,2008,t2,cantonales
9262,80,SOMME,11180,6990,286,6704,2008,t2,cantonales
9263,80,SOMME,5141,3865,66,3799,2008,t2,cantonales
9264,80,SOMME,8504,5575,196,5379,2008,t2,cantonales
9265,80,SOMME,6044,4851,215,4636,2008,t2,cantonales
9266,80,SOMME,9543,6501,175,6326,2008,t2,cantonales
9267,80,SOMME,4697,3816,151,3665,2008,t2,cantonales
9268,80,SOMME,6477,5047,282,4765,2008,t2,cantonales
9269,80,SOMME,5650,4382,248,4134,2008,t2,cantonales
9270,80,SOMME,9364,7043,419,6624,2008,t2,cantonales
9271,80,SOMME,9729,5486,594,4892,2008,t2,cantonales
9272,81,TARN,7101,4204,282,3922,2008,t2,cantonales
9273,81,TARN,9243,6140,386,5754,2008,t2,cantonales
9274,81,TARN,7388,4733,159,4574,2008,t2,cantonales
9275,81,TARN,15971,9239,294,8945,2008,t2,cantonales
9276,81,TARN,3105,2418,86,2332,2008,t2,cantonales
9277,81,TARN,18359,12571,648,11923,2008,t2,cantonales
9278,81,TARN,3385,2601,138,2463,2008,t2,cantonales
9279,81,TARN,6681,4239,131,4108,2008,t2,cantonales
9280,81,TARN,2069,1770,66,1704,2008,t2,cantonales
9281,81,TARN,2893,2443,48,2395,2008,t2,cantonales
9282,81,TARN,4590,3324,188,3136,2008,t2,cantonales
9283,81,TARN,10403,6366,294,6072,2008,t2,cantonales
9284,81,TARN,7669,5108,318,4790,2008,t2,cantonales
9285,81,TARN,8320,5589,296,5293,2008,t2,cantonales
9286,81,TARN,7710,5286,211,5075,2008,t2,cantonales
9287,81,TARN,8259,5356,205,5151,2008,t2,cantonales
9288,82,TARN ET GARONNE,1611,1186,82,1104,2008,t2,cantonales
9289,82,TARN ET GARONNE,2394,1789,37,1752,2008,t2,cantonales
9290,82,TARN ET GARONNE,6341,4468,193,4275,2008,t2,cantonales
9291,82,TARN ET GARONNE,9506,6033,493,5540,2008,t2,cantonales
9292,82,TARN ET GARONNE,4801,3580,182,3398,2008,t2,cantonales
9293,82,TARN ET GARONNE,7281,4833,196,4637,2008,t2,cantonales
9294,82,TARN ET GARONNE,7333,5218,242,4976,2008,t2,cantonales
9295,82,TARN ET GARONNE,4487,3151,108,3043,2008,t2,cantonales
9296,82,TARN ET GARONNE,7290,5157,244,4913,2008,t2,cantonales
9297,83,VAR,2563,2062,105,1957,2008,t2,cantonales
9298,83,VAR,8023,4889,268,4621,2008,t2,cantonales
9299,83,VAR,15702,9866,389,9477,2008,t2,cantonales
9300,83,VAR,36145,23049,975,22074,2008,t2,cantonales
9301,83,VAR,23294,13405,364,13041,2008,t2,cantonales
9302,83,VAR,15734,9582,302,9280,2008,t2,cantonales
9303,83,VAR,4528,3308,185,3123,2008,t2,cantonales
9304,83,VAR,7246,3179,127,3052,2008,t2,cantonales
9305,83,VAR,7009,2878,73,2805,2008,t2,cantonales
9306,83,VAR,22573,13360,1002,12358,2008,t2,cantonales
9307,84,VAUCLUSE,22065,13498,1025,12473,2008,t2,cantonales
9308,84,VAUCLUSE,18963,11771,478,11293,2008,t2,cantonales
9309,84,VAUCLUSE,27765,16799,675,16124,2008,t2,cantonales
9310,84,VAUCLUSE,29204,13532,985,12547,2008,t2,cantonales
9311,84,VAUCLUSE,16936,9133,615,8518,2008,t2,cantonales
9312,84,VAUCLUSE,13753,7991,325,7666,2008,t2,cantonales
9313,84,VAUCLUSE,24987,14739,596,14143,2008,t2,cantonales
9314,84,VAUCLUSE,9861,6552,426,6126,2008,t2,cantonales
9315,84,VAUCLUSE,14602,8691,416,8275,2008,t2,cantonales
9316,85,VENDEE,15756,10969,447,10522,2008,t2,cantonales
9317,85,VENDEE,35866,18672,814,17858,2008,t2,cantonales
9318,85,VENDEE,32674,18143,504,17639,2008,t2,cantonales
9319,86,VIENNE,4132,3082,158,2924,2008,t2,cantonales
9320,86,VIENNE,10083,5176,160,5016,2008,t2,cantonales
9321,86,VIENNE,12329,5708,188,5520,2008,t2,cantonales
9322,86,VIENNE,10593,6707,265,6442,2008,t2,cantonales
9323,86,VIENNE,6778,4336,74,4262,2008,t2,cantonales
9324,86,VIENNE,8501,5355,190,5165,2008,t2,cantonales
9325,86,VIENNE,12173,5634,142,5492,2008,t2,cantonales
9326,86,VIENNE,12570,7620,146,7474,2008,t2,cantonales
9327,86,VIENNE,8792,4187,90,4097,2008,t2,cantonales
9328,87,HAUTE VIENNE,4663,2796,467,2329,2008,t2,cantonales
9329,87,HAUTE VIENNE,2951,2021,103,1918,2008,t2,cantonales
9330,87,HAUTE VIENNE,4239,2008,92,1916,2008,t2,cantonales
9331,87,HAUTE VIENNE,7718,4278,333,3945,2008,t2,cantonales
9332,87,HAUTE VIENNE,3293,2105,461,1644,2008,t2,cantonales
9333,87,HAUTE VIENNE,4162,2675,252,2423,2008,t2,cantonales
9334,87,HAUTE VIENNE,2677,2035,155,1880,2008,t2,cantonales
9335,87,HAUTE VIENNE,4126,1878,85,1793,2008,t2,cantonales
9336,87,HAUTE VIENNE,13297,7027,386,6641,2008,t2,cantonales
9337,88,VOSGES,3001,2245,46,2199,2008,t2,cantonales
9338,88,VOSGES,9049,5475,167,5308,2008,t2,cantonales
9339,88,VOSGES,4218,3096,333,2763,2008,t2,cantonales
9340,88,VOSGES,13092,8037,340,7697,2008,t2,cantonales
9341,89,YONNE,7717,4175,209,3966,2008,t2,cantonales
9342,89,YONNE,5953,2546,72,2474,2008,t2,cantonales
9343,89,YONNE,5656,3530,123,3407,2008,t2,cantonales
9344,89,YONNE,2503,1781,48,1733,2008,t2,cantonales
9345,89,YONNE,10247,6045,203,5842,2008,t2,cantonales
9346,89,YONNE,4088,2832,143,2689,2008,t2,cantonales
9347,89,YONNE,15381,7889,361,7528,2008,t2,cantonales
9348,89,YONNE,7647,4718,201,4517,2008,t2,cantonales
9349,89,YONNE,7190,3888,211,3677,2008,t2,cantonales
9350,89,YONNE,9168,5063,116,4947,2008,t2,cantonales
9351,90,TERRITOIRE DE BELFORT,5836,3740,247,3493,2008,t2,cantonales
9352,90,TERRITOIRE DE BELFORT,9776,5836,225,5611,2008,t2,cantonales
9353,90,TERRITOIRE DE BELFORT,4132,2671,125,2546,2008,t2,cantonales
9354,90,TERRITOIRE DE BELFORT,5139,3185,111,3074,2008,t2,cantonales
9355,90,TERRITOIRE DE BELFORT,6883,3974,409,3565,2008,t2,cantonales
9356,90,TERRITOIRE DE BELFORT,4600,2589,158,2431,2008,t2,cantonales
9357,91,ESSONNE,22532,12791,480,12311,2008,t2,cantonales
9358,91,ESSONNE,17088,8666,448,8218,2008,t2,cantonales
9359,91,ESSONNE,19770,9762,352,9410,2008,t2,cantonales
9360,91,ESSONNE,16577,8871,352,8519,2008,t2,cantonales
9361,91,ESSONNE,27499,14862,577,14285,2008,t2,cantonales
9362,91,ESSONNE,26377,14010,482,13528,2008,t2,cantonales
9363,91,ESSONNE,15209,10297,181,10116,2008,t2,cantonales
9364,91,ESSONNE,27214,15771,425,15346,2008,t2,cantonales
9365,91,ESSONNE,15439,6857,238,6619,2008,t2,cantonales
9366,91,ESSONNE,18568,8438,296,8142,2008,t2,cantonales
9367,91,ESSONNE,16859,7459,176,7283,2008,t2,cantonales
9368,91,ESSONNE,18625,8277,204,8073,2008,t2,cantonales
9369,91,ESSONNE,23129,13053,308,12745,2008,t2,cantonales
9370,91,ESSONNE,12534,7618,327,7291,2008,t2,cantonales
9371,91,ESSONNE,10899,6848,230,6618,2008,t2,cantonales
9372,91,ESSONNE,20007,8454,201,8253,2008,t2,cantonales
9373,92,HAUTS DE SEINE,30836,14832,497,14335,2008,t2,cantonales
9374,92,HAUTS DE SEINE,20262,12426,434,11992,2008,t2,cantonales
9375,92,HAUTS DE SEINE,20328,8590,336,8254,2008,t2,cantonales
9376,92,HAUTS DE SEINE,17657,8910,979,7931,2008,t2,cantonales
9377,92,HAUTS DE SEINE,26223,13080,707,12373,2008,t2,cantonales
9378,92,HAUTS DE SEINE,21725,14602,239,14363,2008,t2,cantonales
9379,92,HAUTS DE SEINE,22541,12568,442,12126,2008,t2,cantonales
9380,92,HAUTS DE SEINE,18560,12457,363,12094,2008,t2,cantonales
9381,92,HAUTS DE SEINE,19828,7634,259,7375,2008,t2,cantonales
9382,92,HAUTS DE SEINE,25214,10049,350,9699,2008,t2,cantonales
9383,92,HAUTS DE SEINE,16941,6673,261,6412,2008,t2,cantonales
9384,92,HAUTS DE SEINE,14222,8518,244,8274,2008,t2,cantonales
9385,92,HAUTS DE SEINE,13028,5067,137,4930,2008,t2,cantonales
9386,92,HAUTS DE SEINE,13116,8311,398,7913,2008,t2,cantonales
9387,93,SEINE SAINT-DENIS,10088,4852,308,4544,2008,t2,cantonales
9388,93,SEINE SAINT-DENIS,16254,7999,2585,5414,2008,t2,cantonales
9389,93,SEINE SAINT-DENIS,24098,12589,490,12099,2008,t2,cantonales
9390,93,SEINE SAINT-DENIS,20322,7529,215,7314,2008,t2,cantonales
9391,93,SEINE SAINT-DENIS,17409,8908,519,8389,2008,t2,cantonales
9392,93,SEINE SAINT-DENIS,18326,10912,307,10605,2008,t2,cantonales
9393,93,SEINE SAINT-DENIS,21054,8171,1996,6175,2008,t2,cantonales
9394,93,SEINE SAINT-DENIS,15175,7453,1756,5697,2008,t2,cantonales
9395,93,SEINE SAINT-DENIS,15779,4169,1071,3098,2008,t2,cantonales
9396,93,SEINE SAINT-DENIS,20219,7083,256,6827,2008,t2,cantonales
9397,93,SEINE SAINT-DENIS,15137,6602,237,6365,2008,t2,cantonales
9398,93,SEINE SAINT-DENIS,12365,4510,181,4329,2008,t2,cantonales
9399,93,SEINE SAINT-DENIS,16179,7523,2047,5476,2008,t2,cantonales
9400,94,VAL DE MARNE,13075,5128,306,4822,2008,t2,cantonales
9401,94,VAL DE MARNE,18716,10759,442,10317,2008,t2,cantonales
9402,94,VAL DE MARNE,10337,4839,103,4736,2008,t2,cantonales
9403,94,VAL DE MARNE,13947,5893,141,5752,2008,t2,cantonales
9404,94,VAL DE MARNE,18896,8221,187,8034,2008,t2,cantonales
9405,94,VAL DE MARNE,11978,5927,2511,3416,2008,t2,cantonales
9406,94,VAL DE MARNE,19403,7606,255,7351,2008,t2,cantonales
9407,94,VAL DE MARNE,11026,6078,547,5531,2008,t2,cantonales
9408,94,VAL DE MARNE,14410,5601,193,5408,2008,t2,cantonales
9409,94,VAL DE MARNE,17026,8857,437,8420,2008,t2,cantonales
9410,94,VAL DE MARNE,13487,7912,292,7620,2008,t2,cantonales
9411,94,VAL DE MARNE,16550,7634,131,7503,2008,t2,cantonales
9412,94,VAL DE MARNE,14401,6145,149,5996,2008,t2,cantonales
9413,94,VAL DE MARNE,14258,4604,939,3665,2008,t2,cantonales
9414,94,VAL DE MARNE,15445,4895,774,4121,2008,t2,cantonales
9415,94,VAL DE MARNE,12446,4965,110,4855,2008,t2,cantonales
9416,94,VAL DE MARNE,14713,5692,185,5507,2008,t2,cantonales
9417,94,VAL DE MARNE,26451,13438,304,13134,2008,t2,cantonales
9418,94,VAL DE MARNE,16278,6791,215,6576,2008,t2,cantonales
9419,94,VAL DE MARNE,12161,7422,663,6759,2008,t2,cantonales
9420,94,VAL DE MARNE,16849,9361,166,9195,2008,t2,cantonales
9421,94,VAL DE MARNE,14425,4913,876,4037,2008,t2,cantonales
9422,95,VAL D'OISE,19456,11250,262,10988,2008,t2,cantonales
9423,95,VAL D'OISE,24077,11335,291,11044,2008,t2,cantonales
9424,95,VAL D'OISE,15243,7093,174,6919,2008,t2,cantonales
9425,95,VAL D'OISE,17329,7392,202,7190,2008,t2,cantonales
9426,95,VAL D'OISE,6361,3171,187,2984,2008,t2,cantonales
9427,95,VAL D'OISE,18253,8381,221,8160,2008,t2,cantonales
9428,95,VAL D'OISE,24687,11414,396,11018,2008,t2,cantonales
9429,95,VAL D'OISE,16084,6582,185,6397,2008,t2,cantonales
9430,95,VAL D'OISE,24326,10432,280,10152,2008,t2,cantonales
9431,95,VAL D'OISE,30800,14370,355,14015,2008,t2,cantonales
9432,95,VAL D'OISE,20569,10184,380,9804,2008,t2,cantonales
9433,95,VAL D'OISE,20086,8491,162,8329,2008,t2,cantonales
9434,95,VAL D'OISE,19451,8744,264,8480,2008,t2,cantonales
9435,95,VAL D'OISE,29756,11512,463,11049,2008,t2,cantonales
9436,971,GUADELOUPE,6052,3483,370,3113,2008,t2,cantonales
9437,971,GUADELOUPE,5559,3494,208,3286,2008,t2,cantonales
9438,971,GUADELOUPE,3718,2326,182,2144,2008,t2,cantonales
9439,971,GUADELOUPE,6321,4319,370,3949,2008,t2,cantonales
9440,971,GUADELOUPE,5097,2912,119,2793,2008,t2,cantonales
9441,971,GUADELOUPE,5638,4111,163,3948,2008,t2,cantonales
9442,971,GUADELOUPE,10392,6703,330,6373,2008,t2,cantonales
9443,971,GUADELOUPE,6832,4601,355,4246,2008,t2,cantonales
9444,971,GUADELOUPE,10731,7241,710,6531,2008,t2,cantonales
9445,971,GUADELOUPE,5914,4547,189,4358,2008,t2,cantonales
9446,971,GUADELOUPE,7544,4337,417,3920,2008,t2,cantonales
9447,971,GUADELOUPE,5974,4039,298,3741,2008,t2,cantonales
9448,971,GUADELOUPE,10151,4748,219,4529,2008,t2,cantonales
9449,972,MARTINIQUE,4510,3097,120,2977,2008,t2,cantonales
9450,972,MARTINIQUE,4392,3180,239,2941,2008,t2,cantonales
9451,972,MARTINIQUE,5849,2024,98,1926,2008,t2,cantonales
9452,972,MARTINIQUE,2844,1061,49,1012,2008,t2,cantonales
9453,972,MARTINIQUE,7996,4784,322,4462,2008,t2,cantonales
9454,972,MARTINIQUE,6063,2005,123,1882,2008,t2,cantonales
9455,972,MARTINIQUE,7227,4780,150,4630,2008,t2,cantonales
9456,972,MARTINIQUE,3921,3208,105,3103,2008,t2,cantonales
9457,972,MARTINIQUE,6598,5237,155,5082,2008,t2,cantonales
9458,972,MARTINIQUE,4444,1449,103,1346,2008,t2,cantonales
9459,972,MARTINIQUE,12976,4938,240,4698,2008,t2,cantonales
9460,972,MARTINIQUE,7851,3817,104,3713,2008,t2,cantonales
9461,973,GUYANE,1903,751,24,727,2008,t2,cantonales
9462,973,GUYANE,3340,1149,69,1080,2008,t2,cantonales
9463,973,GUYANE,5729,2599,66,2533,2008,t2,cantonales
9464,973,GUYANE,1785,1265,65,1200,2008,t2,cantonales
9465,973,GUYANE,897,630,54,576,2008,t2,cantonales
9466,973,GUYANE,2898,840,39,801,2008,t2,cantonales
9467,973,GUYANE,3168,934,55,879,2008,t2,cantonales
9468,974,LA REUNION,8046,6133,269,5864,2008,t2,cantonales
9469,974,LA REUNION,4656,3448,911,2537,2008,t2,cantonales
9470,974,LA REUNION,8926,7233,162,7071,2008,t2,cantonales
9471,974,LA REUNION,3455,2888,72,2816,2008,t2,cantonales
9472,974,LA REUNION,12566,6552,398,6154,2008,t2,cantonales
9473,974,LA REUNION,8651,5448,415,5033,2008,t2,cantonales
9474,974,LA REUNION,8517,5271,355,4916,2008,t2,cantonales
9475,974,LA REUNION,10016,7464,295,7169,2008,t2,cantonales
9476,974,LA REUNION,15266,9325,383,8942,2008,t2,cantonales
9477,974,LA REUNION,12404,6872,312,6560,2008,t2,cantonales
9478,974,LA REUNION,5448,4790,103,4687,2008,t2,cantonales
9479,974,LA REUNION,5318,4252,128,4124,2008,t2,cantonales
9480,974,LA REUNION,9060,4583,1537,3046,2008,t2,cantonales
9481,974,LA REUNION,9091,5692,272,5420,2008,t2,cantonales
9482,974,LA REUNION,9048,5775,268,5507,2008,t2,cantonales
9483,974,LA REUNION,12924,7786,522,7264,2008,t2,cantonales
9484,974,LA REUNION,15256,8241,324,7917,2008,t2,cantonales
9485,974,LA REUNION,8910,6914,260,6654,2008,t2,cantonales
9486,985,MAYOTTE,2926,1951,83,1868,2008,t2,cantonales
9487,985,MAYOTTE,3488,2509,72,2437,2008,t2,cantonales
9488,985,MAYOTTE,2292,1731,39,1692,2008,t2,cantonales
9489,985,MAYOTTE,3523,1731,106,1625,2008,t2,cantonales
9490,985,MAYOTTE,4021,2210,73,2137,2008,t2,cantonales
9491,985,MAYOTTE,3471,1864,124,1740,2008,t2,cantonales
9492,985,MAYOTTE,4497,2981,77,2904,2008,t2,cantonales
9493,985,MAYOTTE,4688,2878,46,2832,2008,t2,cantonales
9494,985,MAYOTTE,3544,1990,43,1947,2008,t2,cantonales
9495,1,AIN,14427,8632,263,8369,2008,t1,cantonales
9496,1,AIN,8769,4889,208,4681,2008,t1,cantonales
9497,1,AIN,2778,2235,90,2145,2008,t1,cantonales
9498,1,AIN,6448,4621,132,4489,2008,t1,cantonales
9499,1,AIN,4490,3106,96,3010,2008,t1,cantonales
9500,1,AIN,3863,2853,95,2758,2008,t1,cantonales
9501,1,AIN,5979,3937,227,3710,2008,t1,cantonales
9502,1,AIN,16036,8608,330,8278,2008,t1,cantonales
9503,1,AIN,3873,2756,75,2681,2008,t1,cantonales
9504,1,AIN,13279,8411,246,8165,2008,t1,cantonales
9505,1,AIN,13947,8785,212,8573,2008,t1,cantonales
9506,1,AIN,11038,7577,278,7299,2008,t1,cantonales
9507,1,AIN,10265,5930,167,5763,2008,t1,cantonales
9508,1,AIN,6497,4308,498,3810,2008,t1,cantonales
9509,1,AIN,3753,2657,92,2565,2008,t1,cantonales
9510,1,AIN,9888,6219,249,5970,2008,t1,cantonales
9511,1,AIN,5860,4110,106,4004,2008,t1,cantonales
9512,1,AIN,6727,4000,108,3892,2008,t1,cantonales
9513,1,AIN,7501,4491,158,4333,2008,t1,cantonales
9514,1,AIN,10332,5914,145,5769,2008,t1,cantonales
9515,1,AIN,15016,9791,226,9565,2008,t1,cantonales
9516,2,AISNE,2611,2228,81,2147,2008,t1,cantonales
9517,2,AISNE,6228,4928,206,4722,2008,t1,cantonales
9518,2,AISNE,9863,6547,196,6351,2008,t1,cantonales
9519,2,AISNE,6418,4607,197,4410,2008,t1,cantonales
9520,2,AISNE,8599,6260,254,6006,2008,t1,cantonales
9521,2,AISNE,5625,4498,196,4302,2008,t1,cantonales
9522,2,AISNE,8425,5720,237,5483,2008,t1,cantonales
9523,2,AISNE,7721,5764,268,5496,2008,t1,cantonales
9524,2,AISNE,14219,9573,321,9252,2008,t1,cantonales
9525,2,AISNE,6112,4777,209,4568,2008,t1,cantonales
9526,2,AISNE,7174,5062,231,4831,2008,t1,cantonales
9527,2,AISNE,4146,3136,366,2770,2008,t1,cantonales
9528,2,AISNE,5913,4626,177,4449,2008,t1,cantonales
9529,2,AISNE,8505,6094,272,5822,2008,t1,cantonales
9530,2,AISNE,15156,9298,260,9038,2008,t1,cantonales
9531,2,AISNE,10165,6776,241,6535,2008,t1,cantonales
9532,2,AISNE,4955,3958,271,3687,2008,t1,cantonales
9533,2,AISNE,15691,10107,431,9676,2008,t1,cantonales
9534,2,AISNE,17639,10517,474,10043,2008,t1,cantonales
9535,2,AISNE,16922,9798,335,9463,2008,t1,cantonales
9536,2,AISNE,13089,7537,387,7150,2008,t1,cantonales
9537,3,ALLIER,5658,4313,162,4151,2008,t1,cantonales
9538,3,ALLIER,6244,4493,112,4381,2008,t1,cantonales
9539,3,ALLIER,4157,3336,144,3192,2008,t1,cantonales
9540,3,ALLIER,3665,2858,98,2760,2008,t1,cantonales
9541,3,ALLIER,7399,5204,205,4999,2008,t1,cantonales
9542,3,ALLIER,6078,4637,214,4423,2008,t1,cantonales
9543,3,ALLIER,7256,5468,207,5261,2008,t1,cantonales
9544,3,ALLIER,3832,3020,129,2891,2008,t1,cantonales
9545,3,ALLIER,11152,7638,276,7362,2008,t1,cantonales
9546,3,ALLIER,6064,4647,172,4475,2008,t1,cantonales
9547,3,ALLIER,10205,6057,257,5800,2008,t1,cantonales
9548,3,ALLIER,3911,2917,112,2805,2008,t1,cantonales
9549,3,ALLIER,8309,6102,172,5930,2008,t1,cantonales
9550,3,ALLIER,10901,7974,278,7696,2008,t1,cantonales
9551,3,ALLIER,9367,5706,194,5512,2008,t1,cantonales
9552,3,ALLIER,7463,5046,277,4769,2008,t1,cantonales
9553,3,ALLIER,12388,8731,420,8311,2008,t1,cantonales
9554,4,ALPES DE HAUTE PROVENCE,2037,1674,54,1620,2008,t1,cantonales
9555,4,ALPES DE HAUTE PROVENCE,6803,4632,189,4443,2008,t1,cantonales
9556,4,ALPES DE HAUTE PROVENCE,1260,1118,31,1087,2008,t1,cantonales
9557,4,ALPES DE HAUTE PROVENCE,1213,1022,37,985,2008,t1,cantonales
9558,4,ALPES DE HAUTE PROVENCE,7853,5810,260,5550,2008,t1,cantonales
9559,4,ALPES DE HAUTE PROVENCE,2048,1815,87,1728,2008,t1,cantonales
9560,4,ALPES DE HAUTE PROVENCE,1026,819,44,775,2008,t1,cantonales
9561,4,ALPES DE HAUTE PROVENCE,2878,2229,75,2154,2008,t1,cantonales
9562,4,ALPES DE HAUTE PROVENCE,2474,1984,249,1735,2008,t1,cantonales
9563,4,ALPES DE HAUTE PROVENCE,2502,2130,45,2085,2008,t1,cantonales
9564,4,ALPES DE HAUTE PROVENCE,6609,5084,167,4917,2008,t1,cantonales
9565,4,ALPES DE HAUTE PROVENCE,1034,921,24,897,2008,t1,cantonales
9566,4,ALPES DE HAUTE PROVENCE,9273,6794,311,6483,2008,t1,cantonales
9567,4,ALPES DE HAUTE PROVENCE,8962,5774,199,5575,2008,t1,cantonales
9568,5,HAUTES ALPES,1803,1564,48,1516,2008,t1,cantonales
9569,5,HAUTES ALPES,312,266,8,258,2008,t1,cantonales
9570,5,HAUTES ALPES,8157,6027,179,5848,2008,t1,cantonales
9571,5,HAUTES ALPES,3727,2970,133,2837,2008,t1,cantonales
9572,5,HAUTES ALPES,737,612,17,595,2008,t1,cantonales
9573,5,HAUTES ALPES,4956,3705,493,3212,2008,t1,cantonales
9574,5,HAUTES ALPES,4529,3763,156,3607,2008,t1,cantonales
9575,5,HAUTES ALPES,1590,1353,53,1300,2008,t1,cantonales
9576,5,HAUTES ALPES,1008,860,38,822,2008,t1,cantonales
9577,5,HAUTES ALPES,1367,1105,40,1065,2008,t1,cantonales
9578,5,HAUTES ALPES,902,701,145,556,2008,t1,cantonales
9579,5,HAUTES ALPES,7529,5177,213,4964,2008,t1,cantonales
9580,5,HAUTES ALPES,4530,2839,114,2725,2008,t1,cantonales
9581,5,HAUTES ALPES,2767,1848,66,1782,2008,t1,cantonales
9582,5,HAUTES ALPES,7098,4334,290,4044,2008,t1,cantonales
9583,6,ALPES MARITIMES,25478,14351,598,13753,2008,t1,cantonales
9584,6,ALPES MARITIMES,24690,15702,781,14921,2008,t1,cantonales
9585,6,ALPES MARITIMES,8342,4430,126,4304,2008,t1,cantonales
9586,6,ALPES MARITIMES,2789,2243,96,2147,2008,t1,cantonales
9587,6,ALPES MARITIMES,19373,10959,307,10652,2008,t1,cantonales
9588,6,ALPES MARITIMES,12419,9086,321,8765,2008,t1,cantonales
9589,6,ALPES MARITIMES,18116,11399,477,10922,2008,t1,cantonales
9590,6,ALPES MARITIMES,11853,6992,246,6746,2008,t1,cantonales
9591,6,ALPES MARITIMES,12653,6934,234,6700,2008,t1,cantonales
9592,6,ALPES MARITIMES,11581,6161,150,6011,2008,t1,cantonales
9593,6,ALPES MARITIMES,3811,3014,85,2929,2008,t1,cantonales
9594,6,ALPES MARITIMES,2821,2275,511,1764,2008,t1,cantonales
9595,6,ALPES MARITIMES,2493,2148,126,2022,2008,t1,cantonales
9596,6,ALPES MARITIMES,2917,2424,73,2351,2008,t1,cantonales
9597,6,ALPES MARITIMES,3295,2435,97,2338,2008,t1,cantonales
9598,6,ALPES MARITIMES,20658,12988,546,12442,2008,t1,cantonales
9599,6,ALPES MARITIMES,2350,1935,87,1848,2008,t1,cantonales
9600,6,ALPES MARITIMES,17192,9556,377,9179,2008,t1,cantonales
9601,6,ALPES MARITIMES,20272,11302,207,11095,2008,t1,cantonales
9602,6,ALPES MARITIMES,21212,12497,509,11988,2008,t1,cantonales
9603,6,ALPES MARITIMES,16532,9902,344,9558,2008,t1,cantonales
9604,6,ALPES MARITIMES,27711,15902,448,15454,2008,t1,cantonales
9605,6,ALPES MARITIMES,32466,19441,1006,18435,2008,t1,cantonales
9606,6,ALPES MARITIMES,20385,11891,329,11562,2008,t1,cantonales
9607,6,ALPES MARITIMES,12006,7930,270,7660,2008,t1,cantonales
9608,6,ALPES MARITIMES,14400,8851,442,8409,2008,t1,cantonales
9609,7,ARDECHE,14211,9252,277,8975,2008,t1,cantonales
9610,7,ARDECHE,11745,8614,269,8345,2008,t1,cantonales
9611,7,ARDECHE,1234,1070,22,1048,2008,t1,cantonales
9612,7,ARDECHE,7221,5361,177,5184,2008,t1,cantonales
9613,7,ARDECHE,1989,1791,46,1745,2008,t1,cantonales
9614,7,ARDECHE,5829,4411,140,4271,2008,t1,cantonales
9615,7,ARDECHE,5690,4245,135,4110,2008,t1,cantonales
9616,7,ARDECHE,3434,2684,105,2579,2008,t1,cantonales
9617,7,ARDECHE,20110,13344,232,13112,2008,t1,cantonales
9618,7,ARDECHE,6184,4869,73,4796,2008,t1,cantonales
9619,7,ARDECHE,8556,6349,242,6107,2008,t1,cantonales
9620,7,ARDECHE,6232,4902,197,4705,2008,t1,cantonales
9621,7,ARDECHE,17416,12533,408,12125,2008,t1,cantonales
9622,7,ARDECHE,6657,5134,140,4994,2008,t1,cantonales
9623,7,ARDECHE,3238,2605,97,2508,2008,t1,cantonales
9624,7,ARDECHE,7590,5928,121,5807,2008,t1,cantonales
9625,7,ARDECHE,9085,6541,226,6315,2008,t1,cantonales
9626,8,ARDENNES,4114,3009,186,2823,2008,t1,cantonales
9627,8,ARDENNES,2434,1916,100,1816,2008,t1,cantonales
9628,8,ARDENNES,1703,1451,33,1418,2008,t1,cantonales
9629,8,ARDENNES,7228,5223,207,5016,2008,t1,cantonales
9630,8,ARDENNES,8779,5563,151,5412,2008,t1,cantonales
9631,8,ARDENNES,3044,2338,90,2248,2008,t1,cantonales
9632,8,ARDENNES,2095,1799,90,1709,2008,t1,cantonales
9633,8,ARDENNES,2081,1683,92,1591,2008,t1,cantonales
9634,8,ARDENNES,8117,5935,223,5712,2008,t1,cantonales
9635,8,ARDENNES,10282,7304,144,7160,2008,t1,cantonales
9636,8,ARDENNES,1793,1485,145,1340,2008,t1,cantonales
9637,8,ARDENNES,9266,5530,209,5321,2008,t1,cantonales
9638,8,ARDENNES,4531,3207,153,3054,2008,t1,cantonales
9639,8,ARDENNES,5732,4158,183,3975,2008,t1,cantonales
9640,8,ARDENNES,8814,5119,158,4961,2008,t1,cantonales
9641,8,ARDENNES,9445,4835,183,4652,2008,t1,cantonales
9642,8,ARDENNES,5397,3344,125,3219,2008,t1,cantonales
9643,8,ARDENNES,10665,6862,280,6582,2008,t1,cantonales
9644,8,ARDENNES,9586,6279,268,6011,2008,t1,cantonales
9645,9,ARIEGE,2591,2111,61,2050,2008,t1,cantonales
9646,9,ARIEGE,1842,1452,93,1359,2008,t1,cantonales
9647,9,ARIEGE,2538,2155,220,1935,2008,t1,cantonales
9648,9,ARIEGE,3063,2558,148,2410,2008,t1,cantonales
9649,9,ARIEGE,6384,4294,175,4119,2008,t1,cantonales
9650,9,ARIEGE,2008,1608,44,1564,2008,t1,cantonales
9651,9,ARIEGE,10166,7800,422,7378,2008,t1,cantonales
9652,9,ARIEGE,5910,4637,385,4252,2008,t1,cantonales
9653,9,ARIEGE,7591,6155,254,5901,2008,t1,cantonales
9654,9,ARIEGE,7511,5229,504,4725,2008,t1,cantonales
9655,9,ARIEGE,8683,6811,356,6455,2008,t1,cantonales
9656,10,AUBE,3904,2749,75,2674,2008,t1,cantonales
9657,10,AUBE,8463,5958,230,5728,2008,t1,cantonales
9658,10,AUBE,7282,5162,147,5015,2008,t1,cantonales
9659,10,AUBE,3860,3051,115,2936,2008,t1,cantonales
9660,10,AUBE,1800,1437,58,1379,2008,t1,cantonales
9661,10,AUBE,3507,2696,174,2522,2008,t1,cantonales
9662,10,AUBE,6996,4731,203,4528,2008,t1,cantonales
9663,10,AUBE,7154,5215,217,4998,2008,t1,cantonales
9664,10,AUBE,3652,2771,112,2659,2008,t1,cantonales
9665,10,AUBE,1919,1388,167,1221,2008,t1,cantonales
9666,10,AUBE,6794,4698,340,4358,2008,t1,cantonales
9667,10,AUBE,7903,4472,217,4255,2008,t1,cantonales
9668,10,AUBE,3964,3042,180,2862,2008,t1,cantonales
9669,10,AUBE,11510,6704,200,6504,2008,t1,cantonales
9670,10,AUBE,10625,6347,196,6151,2008,t1,cantonales
9671,10,AUBE,13021,7390,202,7188,2008,t1,cantonales
9672,11,AUDE,1837,1639,59,1580,2008,t1,cantonales
9673,11,AUDE,9876,7841,302,7539,2008,t1,cantonales
9674,11,AUDE,11896,8077,333,7744,2008,t1,cantonales
9675,11,AUDE,10974,8286,274,8012,2008,t1,cantonales
9676,11,AUDE,7711,5762,241,5521,2008,t1,cantonales
9677,11,AUDE,4901,3970,206,3764,2008,t1,cantonales
9678,11,AUDE,11361,9398,305,9093,2008,t1,cantonales
9679,11,AUDE,11805,8469,788,7681,2008,t1,cantonales
9680,11,AUDE,5216,4066,87,3979,2008,t1,cantonales
9681,11,AUDE,1315,1147,80,1067,2008,t1,cantonales
9682,11,AUDE,6689,5317,267,5050,2008,t1,cantonales
9683,11,AUDE,2450,1991,159,1832,2008,t1,cantonales
9684,11,AUDE,2440,2036,99,1937,2008,t1,cantonales
9685,11,AUDE,17403,13023,508,12515,2008,t1,cantonales
9686,11,AUDE,7534,4647,174,4473,2008,t1,cantonales
9687,11,AUDE,12604,9622,478,9144,2008,t1,cantonales
9688,11,AUDE,12227,7577,293,7284,2008,t1,cantonales
9689,12,AVEYRON,7845,5783,459,5324,2008,t1,cantonales
9690,12,AVEYRON,2200,1865,59,1806,2008,t1,cantonales
9691,12,AVEYRON,6746,5294,137,5157,2008,t1,cantonales
9692,12,AVEYRON,4603,4001,94,3907,2008,t1,cantonales
9693,12,AVEYRON,2400,2113,61,2052,2008,t1,cantonales
9694,12,AVEYRON,1739,1521,50,1471,2008,t1,cantonales
9695,12,AVEYRON,7951,6088,170,5918,2008,t1,cantonales
9696,12,AVEYRON,5849,4642,186,4456,2008,t1,cantonales
9697,12,AVEYRON,6812,4613,189,4424,2008,t1,cantonales
9698,12,AVEYRON,2009,1734,51,1683,2008,t1,cantonales
9699,12,AVEYRON,4432,3872,161,3711,2008,t1,cantonales
9700,12,AVEYRON,3716,3103,118,2985,2008,t1,cantonales
9701,12,AVEYRON,4214,3697,129,3568,2008,t1,cantonales
9702,12,AVEYRON,1917,1675,65,1610,2008,t1,cantonales
9703,12,AVEYRON,726,645,24,621,2008,t1,cantonales
9704,12,AVEYRON,1959,1681,92,1589,2008,t1,cantonales
9705,12,AVEYRON,2883,2320,271,2049,2008,t1,cantonales
9706,12,AVEYRON,2665,2358,64,2294,2008,t1,cantonales
9707,12,AVEYRON,2290,2064,58,2006,2008,t1,cantonales
9708,12,AVEYRON,6963,5878,230,5648,2008,t1,cantonales
9709,12,AVEYRON,3363,2801,137,2664,2008,t1,cantonales
9710,12,AVEYRON,3874,3056,97,2959,2008,t1,cantonales
9711,12,AVEYRON,14282,10289,425,9864,2008,t1,cantonales
9712,12,AVEYRON,11411,8165,428,7737,2008,t1,cantonales
9713,13,BOUCHES DU RHONE,39895,23617,585,23032,2008,t1,cantonales
9714,13,BOUCHES DU RHONE,30417,20359,694,19665,2008,t1,cantonales
9715,13,BOUCHES DU RHONE,29245,18319,488,17831,2008,t1,cantonales
9716,13,BOUCHES DU RHONE,25604,17574,573,17001,2008,t1,cantonales
9717,13,BOUCHES DU RHONE,33590,21031,566,20465,2008,t1,cantonales
9718,13,BOUCHES DU RHONE,23063,15344,835,14509,2008,t1,cantonales
9719,13,BOUCHES DU RHONE,14694,8298,233,8065,2008,t1,cantonales
9720,13,BOUCHES DU RHONE,13750,7722,209,7513,2008,t1,cantonales
9721,13,BOUCHES DU RHONE,12950,6698,160,6538,2008,t1,cantonales
9722,13,BOUCHES DU RHONE,22430,12975,300,12675,2008,t1,cantonales
9723,13,BOUCHES DU RHONE,25559,16751,462,16289,2008,t1,cantonales
9724,13,BOUCHES DU RHONE,17592,12191,438,11753,2008,t1,cantonales
9725,13,BOUCHES DU RHONE,33430,22252,732,21520,2008,t1,cantonales
9726,13,BOUCHES DU RHONE,2655,2236,36,2200,2008,t1,cantonales
9727,13,BOUCHES DU RHONE,30311,20800,489,20311,2008,t1,cantonales
9728,13,BOUCHES DU RHONE,18330,11222,213,11009,2008,t1,cantonales
9729,13,BOUCHES DU RHONE,17105,8149,258,7891,2008,t1,cantonales
9730,13,BOUCHES DU RHONE,18612,9880,267,9613,2008,t1,cantonales
9731,13,BOUCHES DU RHONE,18530,9702,265,9437,2008,t1,cantonales
9732,13,BOUCHES DU RHONE,17515,9442,263,9179,2008,t1,cantonales
9733,13,BOUCHES DU RHONE,23284,14243,287,13956,2008,t1,cantonales
9734,13,BOUCHES DU RHONE,24429,13254,543,12711,2008,t1,cantonales
9735,13,BOUCHES DU RHONE,38022,25827,1077,24750,2008,t1,cantonales
9736,13,BOUCHES DU RHONE,18666,11859,460,11399,2008,t1,cantonales
9737,13,BOUCHES DU RHONE,20017,11513,322,11191,2008,t1,cantonales
9738,13,BOUCHES DU RHONE,19930,11917,258,11659,2008,t1,cantonales
9739,13,BOUCHES DU RHONE,17121,8715,291,8424,2008,t1,cantonales
9740,13,BOUCHES DU RHONE,19533,10930,266,10664,2008,t1,cantonales
9741,14,CALVADOS,5683,4082,168,3914,2008,t1,cantonales
9742,14,CALVADOS,15464,9239,364,8875,2008,t1,cantonales
9743,14,CALVADOS,18382,11670,390,11280,2008,t1,cantonales
9744,14,CALVADOS,15443,10855,412,10443,2008,t1,cantonales
9745,14,CALVADOS,12251,7579,399,7180,2008,t1,cantonales
9746,14,CALVADOS,8047,5659,214,5445,2008,t1,cantonales
9747,14,CALVADOS,7644,5489,215,5274,2008,t1,cantonales
9748,14,CALVADOS,3766,2827,141,2686,2008,t1,cantonales
9749,14,CALVADOS,7026,4942,146,4796,2008,t1,cantonales
9750,14,CALVADOS,9302,6595,266,6329,2008,t1,cantonales
9751,14,CALVADOS,5660,3957,152,3805,2008,t1,cantonales
9752,14,CALVADOS,5434,4201,243,3958,2008,t1,cantonales
9753,14,CALVADOS,7148,5300,239,5061,2008,t1,cantonales
9754,14,CALVADOS,11828,8493,340,8153,2008,t1,cantonales
9755,14,CALVADOS,5712,4383,205,4178,2008,t1,cantonales
9756,14,CALVADOS,17029,11119,577,10542,2008,t1,cantonales
9757,14,CALVADOS,17054,10517,416,10101,2008,t1,cantonales
9758,14,CALVADOS,4311,3220,170,3050,2008,t1,cantonales
9759,14,CALVADOS,7633,5714,284,5430,2008,t1,cantonales
9760,14,CALVADOS,13630,9861,350,9511,2008,t1,cantonales
9761,14,CALVADOS,8453,5258,115,5143,2008,t1,cantonales
9762,14,CALVADOS,9825,5599,248,5351,2008,t1,cantonales
9763,14,CALVADOS,11623,6799,262,6537,2008,t1,cantonales
9764,14,CALVADOS,7880,4593,209,4384,2008,t1,cantonales
9765,14,CALVADOS,16208,10911,497,10414,2008,t1,cantonales
9766,14,CALVADOS,18023,11439,325,11114,2008,t1,cantonales
9767,15,CANTAL,2440,2072,427,1645,2008,t1,cantonales
9768,15,CANTAL,8075,5764,402,5362,2008,t1,cantonales
9769,15,CANTAL,3710,3219,106,3113,2008,t1,cantonales
9770,15,CANTAL,3537,2831,681,2150,2008,t1,cantonales
9771,15,CANTAL,2382,1998,512,1486,2008,t1,cantonales
9772,15,CANTAL,3012,2662,89,2573,2008,t1,cantonales
9773,15,CANTAL,4344,3540,125,3415,2008,t1,cantonales
9774,15,CANTAL,2723,2387,174,2213,2008,t1,cantonales
9775,15,CANTAL,5282,4521,114,4407,2008,t1,cantonales
9776,15,CANTAL,4751,3969,147,3822,2008,t1,cantonales
9777,15,CANTAL,6483,4089,249,3840,2008,t1,cantonales
9778,15,CANTAL,7631,5592,279,5313,2008,t1,cantonales
9779,15,CANTAL,4759,3580,176,3404,2008,t1,cantonales
9780,16,CHARENTE,7534,5430,261,5169,2008,t1,cantonales
9781,16,CHARENTE,6440,4591,295,4296,2008,t1,cantonales
9782,16,CHARENTE,1842,1466,62,1404,2008,t1,cantonales
9783,16,CHARENTE,6302,4687,656,4031,2008,t1,cantonales
9784,16,CHARENTE,3634,2716,94,2622,2008,t1,cantonales
9785,16,CHARENTE,2142,1675,156,1519,2008,t1,cantonales
9786,16,CHARENTE,6035,4428,178,4250,2008,t1,cantonales
9787,16,CHARENTE,6814,5259,160,5099,2008,t1,cantonales
9788,16,CHARENTE,3166,2529,95,2434,2008,t1,cantonales
9789,16,CHARENTE,14063,10171,425,9746,2008,t1,cantonales
9790,16,CHARENTE,5742,4449,152,4297,2008,t1,cantonales
9791,16,CHARENTE,4487,3575,203,3372,2008,t1,cantonales
9792,16,CHARENTE,18298,11538,469,11069,2008,t1,cantonales
9793,16,CHARENTE,14509,8805,405,8400,2008,t1,cantonales
9794,16,CHARENTE,10283,6390,286,6104,2008,t1,cantonales
9795,16,CHARENTE,12751,7576,224,7352,2008,t1,cantonales
9796,16,CHARENTE,14609,9143,489,8654,2008,t1,cantonales
9797,17,CHARENTE MARITIME,4588,3408,70,3338,2008,t1,cantonales
9798,17,CHARENTE MARITIME,5279,3946,180,3766,2008,t1,cantonales
9799,17,CHARENTE MARITIME,7805,5568,157,5411,2008,t1,cantonales
9800,17,CHARENTE MARITIME,8492,5892,314,5578,2008,t1,cantonales
9801,17,CHARENTE MARITIME,9524,6742,210,6532,2008,t1,cantonales
9802,17,CHARENTE MARITIME,9464,6699,337,6362,2008,t1,cantonales
9803,17,CHARENTE MARITIME,16097,10243,459,9784,2008,t1,cantonales
9804,17,CHARENTE MARITIME,7927,5631,202,5429,2008,t1,cantonales
9805,17,CHARENTE MARITIME,7332,5638,207,5431,2008,t1,cantonales
9806,17,CHARENTE MARITIME,5966,4583,231,4352,2008,t1,cantonales
9807,17,CHARENTE MARITIME,7676,5705,317,5388,2008,t1,cantonales
9808,17,CHARENTE MARITIME,4952,2522,55,2467,2008,t1,cantonales
9809,17,CHARENTE MARITIME,10003,6760,231,6529,2008,t1,cantonales
9810,17,CHARENTE MARITIME,3551,2653,133,2520,2008,t1,cantonales
9811,17,CHARENTE MARITIME,9772,6856,235,6621,2008,t1,cantonales
9812,17,CHARENTE MARITIME,5393,3826,128,3698,2008,t1,cantonales
9813,17,CHARENTE MARITIME,12045,7879,307,7572,2008,t1,cantonales
9814,17,CHARENTE MARITIME,9879,6168,298,5870,2008,t1,cantonales
9815,17,CHARENTE MARITIME,11640,7453,360,7093,2008,t1,cantonales
9816,17,CHARENTE MARITIME,13909,9147,241,8906,2008,t1,cantonales
9817,17,CHARENTE MARITIME,7931,4605,140,4465,2008,t1,cantonales
9818,17,CHARENTE MARITIME,6950,3632,107,3525,2008,t1,cantonales
9819,17,CHARENTE MARITIME,10773,6597,213,6384,2008,t1,cantonales
9820,17,CHARENTE MARITIME,13445,8261,234,8027,2008,t1,cantonales
9821,17,CHARENTE MARITIME,10599,6962,378,6584,2008,t1,cantonales
9822,18,CHER,9607,6565,242,6323,2008,t1,cantonales
9823,18,CHER,5585,3424,444,2980,2008,t1,cantonales
9824,18,CHER,6252,3154,244,2910,2008,t1,cantonales
9825,18,CHER,4519,3542,106,3436,2008,t1,cantonales
9826,18,CHER,3657,2812,97,2715,2008,t1,cantonales
9827,18,CHER,4886,3502,143,3359,2008,t1,cantonales
9828,18,CHER,2802,2222,102,2120,2008,t1,cantonales
9829,18,CHER,7050,4864,136,4728,2008,t1,cantonales
9830,18,CHER,4916,3548,130,3418,2008,t1,cantonales
9831,18,CHER,4655,3258,122,3136,2008,t1,cantonales
9832,18,CHER,8492,5700,200,5500,2008,t1,cantonales
9833,18,CHER,9758,6607,231,6376,2008,t1,cantonales
9834,18,CHER,6002,4422,228,4194,2008,t1,cantonales
9835,18,CHER,7803,5550,228,5322,2008,t1,cantonales
9836,18,CHER,2734,2194,120,2074,2008,t1,cantonales
9837,18,CHER,7855,4598,415,4183,2008,t1,cantonales
9838,18,CHER,14163,8238,515,7723,2008,t1,cantonales
9839,18,CHER,11315,7521,200,7321,2008,t1,cantonales
9840,19,CORREZE,2975,2656,41,2615,2008,t1,cantonales
9841,19,CORREZE,4030,3256,126,3130,2008,t1,cantonales
9842,19,CORREZE,7557,4920,181,4739,2008,t1,cantonales
9843,19,CORREZE,5012,4195,164,4031,2008,t1,cantonales
9844,19,CORREZE,6020,4903,222,4681,2008,t1,cantonales
9845,19,CORREZE,2323,2021,91,1930,2008,t1,cantonales
9846,19,CORREZE,3913,3177,131,3046,2008,t1,cantonales
9847,19,CORREZE,4448,3808,185,3623,2008,t1,cantonales
9848,19,CORREZE,3194,2878,173,2705,2008,t1,cantonales
9849,19,CORREZE,5821,4856,215,4641,2008,t1,cantonales
9850,19,CORREZE,1968,1709,44,1665,2008,t1,cantonales
9851,19,CORREZE,5680,3999,159,3840,2008,t1,cantonales
9852,19,CORREZE,4380,3140,134,3006,2008,t1,cantonales
9853,19,CORREZE,3097,2753,114,2639,2008,t1,cantonales
9854,19,CORREZE,9505,6279,348,5931,2008,t1,cantonales
9855,19,CORREZE,8108,5584,206,5378,2008,t1,cantonales
9856,19,CORREZE,6513,5332,220,5112,2008,t1,cantonales
9857,19,CORREZE,7341,6241,281,5960,2008,t1,cantonales
9858,2A,CORSE SUD,6803,4653,375,4278,2008,t1,cantonales
9859,2A,CORSE SUD,1906,1752,48,1704,2008,t1,cantonales
9860,2A,CORSE SUD,7595,5895,169,5726,2008,t1,cantonales
9861,2A,CORSE SUD,2511,2025,271,1754,2008,t1,cantonales
9862,2A,CORSE SUD,3066,2758,79,2679,2008,t1,cantonales
9863,2A,CORSE SUD,1789,1543,84,1459,2008,t1,cantonales
9864,2A,CORSE SUD,3229,2874,45,2829,2008,t1,cantonales
9865,2A,CORSE SUD,2284,1781,35,1746,2008,t1,cantonales
9866,2A,CORSE SUD,2947,2558,34,2524,2008,t1,cantonales
9867,2A,CORSE SUD,9851,6800,192,6608,2008,t1,cantonales
9868,2A,CORSE SUD,10290,7750,378,7372,2008,t1,cantonales
9869,2B,HAUTE CORSE,5408,3928,134,3794,2008,t1,cantonales
9870,2B,HAUTE CORSE,10671,7280,247,7033,2008,t1,cantonales
9871,2B,HAUTE CORSE,2929,2568,42,2526,2008,t1,cantonales
9872,2B,HAUTE CORSE,4438,3232,202,3030,2008,t1,cantonales
9873,2B,HAUTE CORSE,3157,2870,55,2815,2008,t1,cantonales
9874,2B,HAUTE CORSE,3470,3022,36,2986,2008,t1,cantonales
9875,2B,HAUTE CORSE,2692,2399,39,2360,2008,t1,cantonales
9876,2B,HAUTE CORSE,1791,1562,42,1520,2008,t1,cantonales
9877,2B,HAUTE CORSE,3390,2791,60,2731,2008,t1,cantonales
9878,2B,HAUTE CORSE,5674,4146,321,3825,2008,t1,cantonales
9879,2B,HAUTE CORSE,2395,2104,18,2086,2008,t1,cantonales
9880,2B,HAUTE CORSE,5728,3650,254,3396,2008,t1,cantonales
9881,2B,HAUTE CORSE,1804,1594,28,1566,2008,t1,cantonales
9882,2B,HAUTE CORSE,1140,889,57,832,2008,t1,cantonales
9883,2B,HAUTE CORSE,4540,3217,109,3108,2008,t1,cantonales
9884,2B,HAUTE CORSE,7637,5178,253,4925,2008,t1,cantonales
9885,21,COTE D'OR,1336,1088,61,1027,2008,t1,cantonales
9886,21,COTE D'OR,15173,9383,399,8984,2008,t1,cantonales
9887,21,COTE D'OR,8001,5899,147,5752,2008,t1,cantonales
9888,21,COTE D'OR,18562,11450,296,11154,2008,t1,cantonales
9889,21,COTE D'OR,24015,14196,469,13727,2008,t1,cantonales
9890,21,COTE D'OR,11158,6685,194,6491,2008,t1,cantonales
9891,21,COTE D'OR,2365,1888,73,1815,2008,t1,cantonales
9892,21,COTE D'OR,15700,10565,378,10187,2008,t1,cantonales
9893,21,COTE D'OR,2724,2309,84,2225,2008,t1,cantonales
9894,21,COTE D'OR,2203,1754,55,1699,2008,t1,cantonales
9895,21,COTE D'OR,4975,3671,186,3485,2008,t1,cantonales
9896,21,COTE D'OR,4280,3528,120,3408,2008,t1,cantonales
9897,21,COTE D'OR,2335,1959,47,1912,2008,t1,cantonales
9898,21,COTE D'OR,1804,1444,75,1369,2008,t1,cantonales
9899,21,COTE D'OR,4731,3574,327,3247,2008,t1,cantonales
9900,21,COTE D'OR,7134,5670,216,5454,2008,t1,cantonales
9901,21,COTE D'OR,6757,4773,196,4577,2008,t1,cantonales
9902,21,COTE D'OR,5249,4051,148,3903,2008,t1,cantonales
9903,21,COTE D'OR,6018,4670,159,4511,2008,t1,cantonales
9904,21,COTE D'OR,17944,10796,308,10488,2008,t1,cantonales
9905,21,COTE D'OR,12689,7606,138,7468,2008,t1,cantonales
9906,21,COTE D'OR,10497,5986,165,5821,2008,t1,cantonales
9907,22,COTES D'ARMOR,6682,5322,133,5189,2008,t1,cantonales
9908,22,COTES D'ARMOR,4638,3950,117,3833,2008,t1,cantonales
9909,22,COTES D'ARMOR,6790,5565,181,5384,2008,t1,cantonales
9910,22,COTES D'ARMOR,4908,4339,87,4252,2008,t1,cantonales
9911,22,COTES D'ARMOR,4728,3862,107,3755,2008,t1,cantonales
9912,22,COTES D'ARMOR,3363,2740,124,2616,2008,t1,cantonales
9913,22,COTES D'ARMOR,11997,8717,373,8344,2008,t1,cantonales
9914,22,COTES D'ARMOR,2696,2288,56,2232,2008,t1,cantonales
9915,22,COTES D'ARMOR,16399,11934,364,11570,2008,t1,cantonales
9916,22,COTES D'ARMOR,15852,11704,540,11164,2008,t1,cantonales
9917,22,COTES D'ARMOR,19256,12686,455,12231,2008,t1,cantonales
9918,22,COTES D'ARMOR,6558,5245,221,5024,2008,t1,cantonales
9919,22,COTES D'ARMOR,7104,5684,131,5553,2008,t1,cantonales
9920,22,COTES D'ARMOR,6027,5111,195,4916,2008,t1,cantonales
9921,22,COTES D'ARMOR,2740,2408,83,2325,2008,t1,cantonales
9922,22,COTES D'ARMOR,9726,7441,392,7049,2008,t1,cantonales
9923,22,COTES D'ARMOR,11209,8450,282,8168,2008,t1,cantonales
9924,22,COTES D'ARMOR,7135,5591,171,5420,2008,t1,cantonales
9925,22,COTES D'ARMOR,7725,6420,380,6040,2008,t1,cantonales
9926,22,COTES D'ARMOR,5160,4184,463,3721,2008,t1,cantonales
9927,22,COTES D'ARMOR,6732,5575,141,5434,2008,t1,cantonales
9928,22,COTES D'ARMOR,9879,5620,177,5443,2008,t1,cantonales
9929,22,COTES D'ARMOR,10777,6068,210,5858,2008,t1,cantonales
9930,22,COTES D'ARMOR,10062,7738,269,7469,2008,t1,cantonales
9931,22,COTES D'ARMOR,2835,2435,71,2364,2008,t1,cantonales
9932,22,COTES D'ARMOR,16180,11291,647,10644,2008,t1,cantonales
9933,23,CREUSE,2996,2359,130,2229,2008,t1,cantonales
9934,23,CREUSE,4482,3514,164,3350,2008,t1,cantonales
9935,23,CREUSE,3462,2663,131,2532,2008,t1,cantonales
9936,23,CREUSE,1596,1316,42,1274,2008,t1,cantonales
9937,23,CREUSE,2913,2296,97,2199,2008,t1,cantonales
9938,23,CREUSE,5743,4377,163,4214,2008,t1,cantonales
9939,23,CREUSE,2599,2170,91,2079,2008,t1,cantonales
9940,23,CREUSE,3283,2648,90,2558,2008,t1,cantonales
9941,23,CREUSE,6333,4296,184,4112,2008,t1,cantonales
9942,23,CREUSE,2821,2276,118,2158,2008,t1,cantonales
9943,23,CREUSE,2429,2010,62,1948,2008,t1,cantonales
9944,23,CREUSE,5625,4181,226,3955,2008,t1,cantonales
9945,23,CREUSE,8570,6301,228,6073,2008,t1,cantonales
9946,23,CREUSE,3639,2352,325,2027,2008,t1,cantonales
9947,24,DORDOGNE,3349,2723,150,2573,2008,t1,cantonales
9948,24,DORDOGNE,4254,3454,142,3312,2008,t1,cantonales
9949,24,DORDOGNE,2611,2233,79,2154,2008,t1,cantonales
9950,24,DORDOGNE,5324,4550,194,4356,2008,t1,cantonales
9951,24,DORDOGNE,4380,3696,219,3477,2008,t1,cantonales
9952,24,DORDOGNE,3291,2662,97,2565,2008,t1,cantonales
9953,24,DORDOGNE,3463,2738,109,2629,2008,t1,cantonales
9954,24,DORDOGNE,2736,2371,130,2241,2008,t1,cantonales
9955,24,DORDOGNE,1750,1527,114,1413,2008,t1,cantonales
9956,24,DORDOGNE,7355,5748,332,5416,2008,t1,cantonales
9957,24,DORDOGNE,5887,4725,183,4542,2008,t1,cantonales
9958,24,DORDOGNE,11056,7426,218,7208,2008,t1,cantonales
9959,24,DORDOGNE,6504,5122,271,4851,2008,t1,cantonales
9960,24,DORDOGNE,2124,1916,36,1880,2008,t1,cantonales
9961,24,DORDOGNE,14343,10511,476,10035,2008,t1,cantonales
9962,24,DORDOGNE,5173,4140,165,3975,2008,t1,cantonales
9963,24,DORDOGNE,5763,4675,257,4418,2008,t1,cantonales
9964,24,DORDOGNE,3816,3127,167,2960,2008,t1,cantonales
9965,24,DORDOGNE,14668,11211,498,10713,2008,t1,cantonales
9966,24,DORDOGNE,10585,8157,242,7915,2008,t1,cantonales
9967,24,DORDOGNE,3605,3046,101,2945,2008,t1,cantonales
9968,24,DORDOGNE,5901,4902,189,4713,2008,t1,cantonales
9969,24,DORDOGNE,7716,5718,280,5438,2008,t1,cantonales
9970,24,DORDOGNE,4346,3472,177,3295,2008,t1,cantonales
9971,25,DOUBS,3107,2677,76,2601,2008,t1,cantonales
9972,25,DOUBS,19883,14210,531,13679,2008,t1,cantonales
9973,25,DOUBS,12283,7259,244,7015,2008,t1,cantonales
9974,25,DOUBS,6756,5446,230,5216,2008,t1,cantonales
9975,25,DOUBS,14725,7752,302,7450,2008,t1,cantonales
9976,25,DOUBS,14490,9235,252,8983,2008,t1,cantonales
9977,25,DOUBS,13011,9170,278,8892,2008,t1,cantonales
9978,25,DOUBS,4543,3810,198,3612,2008,t1,cantonales
9979,25,DOUBS,12307,8123,276,7847,2008,t1,cantonales
9980,25,DOUBS,8778,6861,243,6618,2008,t1,cantonales
9981,25,DOUBS,6276,4834,488,4346,2008,t1,cantonales
9982,25,DOUBS,10537,7617,343,7274,2008,t1,cantonales
9983,25,DOUBS,14728,10798,373,10425,2008,t1,cantonales
9984,25,DOUBS,17449,9998,285,9713,2008,t1,cantonales
9985,25,DOUBS,8672,5801,256,5545,2008,t1,cantonales
9986,25,DOUBS,10083,4721,147,4574,2008,t1,cantonales
9987,25,DOUBS,12953,8194,311,7883,2008,t1,cantonales
9988,26,DROME,1125,910,33,877,2008,t1,cantonales
9989,26,DROME,4650,3617,152,3465,2008,t1,cantonales
9990,26,DROME,1731,1411,27,1384,2008,t1,cantonales
9991,26,DROME,12567,8908,322,8586,2008,t1,cantonales
9992,26,DROME,6480,4740,225,4515,2008,t1,cantonales
9993,26,DROME,7422,5311,210,5101,2008,t1,cantonales
9994,26,DROME,12439,7952,283,7669,2008,t1,cantonales
9995,26,DROME,9271,6812,246,6566,2008,t1,cantonales
9996,26,DROME,20166,12328,287,12041,2008,t1,cantonales
9997,26,DROME,1840,1528,39,1489,2008,t1,cantonales
9998,26,DROME,6056,4110,163,3947,2008,t1,cantonales
9999,26,DROME,14114,10336,336,10000,2008,t1,cantonales
10000,26,DROME,18153,12733,395,12338,2008,t1,cantonales
10001,26,DROME,1996,1716,38,1678,2008,t1,cantonales
10002,26,DROME,10493,5954,185,5769,2008,t1,cantonales
10003,26,DROME,9866,5671,138,5533,2008,t1,cantonales
10004,26,DROME,15598,10605,279,10326,2008,t1,cantonales
10005,26,DROME,12910,8084,223,7861,2008,t1,cantonales
10006,27,EURE,8189,6013,293,5720,2008,t1,cantonales
10007,27,EURE,5031,3764,147,3617,2008,t1,cantonales
10008,27,EURE,10918,6056,315,5741,2008,t1,cantonales
10009,27,EURE,12960,8797,292,8505,2008,t1,cantonales
10010,27,EURE,13351,8819,312,8507,2008,t1,cantonales
10011,27,EURE,3704,2661,108,2553,2008,t1,cantonales
10012,27,EURE,8716,5816,328,5488,2008,t1,cantonales
10013,27,EURE,13380,8612,408,8204,2008,t1,cantonales
10014,27,EURE,4521,3285,102,3183,2008,t1,cantonales
10015,27,EURE,11302,7830,378,7452,2008,t1,cantonales
10016,27,EURE,5832,4143,170,3973,2008,t1,cantonales
10017,27,EURE,18447,11714,335,11379,2008,t1,cantonales
10018,27,EURE,3513,2738,77,2661,2008,t1,cantonales
10019,27,EURE,5273,3890,180,3710,2008,t1,cantonales
10020,27,EURE,8487,5336,260,5076,2008,t1,cantonales
10021,27,EURE,11690,7053,202,6851,2008,t1,cantonales
10022,27,EURE,12885,7692,281,7411,2008,t1,cantonales
10023,27,EURE,12076,7555,349,7206,2008,t1,cantonales
10024,27,EURE,11620,6671,230,6441,2008,t1,cantonales
10025,27,EURE,10685,7292,485,6807,2008,t1,cantonales
10026,27,EURE,12204,6588,293,6295,2008,t1,cantonales
10027,28,EURE ET LOIR,13992,9062,324,8738,2008,t1,cantonales
10028,28,EURE ET LOIR,10664,7207,287,6920,2008,t1,cantonales
10029,28,EURE ET LOIR,4765,3581,125,3456,2008,t1,cantonales
10030,28,EURE ET LOIR,8251,5831,216,5615,2008,t1,cantonales
10031,28,EURE ET LOIR,9664,6231,220,6011,2008,t1,cantonales
10032,28,EURE ET LOIR,7650,5531,169,5362,2008,t1,cantonales
10033,28,EURE ET LOIR,9941,6925,217,6708,2008,t1,cantonales
10034,28,EURE ET LOIR,12443,7146,218,6928,2008,t1,cantonales
10035,28,EURE ET LOIR,7531,5308,202,5106,2008,t1,cantonales
10036,28,EURE ET LOIR,12334,7728,220,7508,2008,t1,cantonales
10037,28,EURE ET LOIR,4409,2904,233,2671,2008,t1,cantonales
10038,28,EURE ET LOIR,6759,5104,272,4832,2008,t1,cantonales
10039,28,EURE ET LOIR,15261,9386,320,9066,2008,t1,cantonales
10040,28,EURE ET LOIR,8660,4699,233,4466,2008,t1,cantonales
10041,28,EURE ET LOIR,12090,6746,243,6503,2008,t1,cantonales
10042,29,FINISTERE,11747,6342,247,6095,2008,t1,cantonales
10043,29,FINISTERE,7691,5852,115,5737,2008,t1,cantonales
10044,29,FINISTERE,14116,10554,284,10270,2008,t1,cantonales
10045,29,FINISTERE,10196,8123,207,7916,2008,t1,cantonales
10046,29,FINISTERE,19278,13274,381,12893,2008,t1,cantonales
10047,29,FINISTERE,5375,4050,148,3902,2008,t1,cantonales
10048,29,FINISTERE,4321,3503,111,3392,2008,t1,cantonales
10049,29,FINISTERE,19634,13479,320,13159,2008,t1,cantonales
10050,29,FINISTERE,12713,9077,196,8881,2008,t1,cantonales
10051,29,FINISTERE,17637,12823,422,12401,2008,t1,cantonales
10052,29,FINISTERE,18901,11991,326,11665,2008,t1,cantonales
10053,29,FINISTERE,971,841,15,826,2008,t1,cantonales
10054,29,FINISTERE,15087,11145,275,10870,2008,t1,cantonales
10055,29,FINISTERE,3488,2565,104,2461,2008,t1,cantonales
10056,29,FINISTERE,8480,6472,133,6339,2008,t1,cantonales
10057,29,FINISTERE,14280,10187,579,9608,2008,t1,cantonales
10058,29,FINISTERE,18033,11721,299,11422,2008,t1,cantonales
10059,29,FINISTERE,16898,10887,555,10332,2008,t1,cantonales
10060,29,FINISTERE,24774,17312,302,17010,2008,t1,cantonales
10061,29,FINISTERE,6394,4980,158,4822,2008,t1,cantonales
10062,29,FINISTERE,3358,2610,104,2506,2008,t1,cantonales
10063,29,FINISTERE,8504,6311,161,6150,2008,t1,cantonales
10064,29,FINISTERE,8521,4124,284,3840,2008,t1,cantonales
10065,29,FINISTERE,19904,13362,367,12995,2008,t1,cantonales
10066,29,FINISTERE,18146,12239,315,11924,2008,t1,cantonales
10067,29,FINISTERE,16177,10627,261,10366,2008,t1,cantonales
10068,30,GARD,9099,6455,292,6163,2008,t1,cantonales
10069,30,GARD,11389,8478,258,8220,2008,t1,cantonales
10070,30,GARD,25186,17033,612,16421,2008,t1,cantonales
10071,30,GARD,18772,13334,523,12811,2008,t1,cantonales
10072,30,GARD,3499,2814,83,2731,2008,t1,cantonales
10073,30,GARD,8193,6166,288,5878,2008,t1,cantonales
10074,30,GARD,2644,2162,90,2072,2008,t1,cantonales
10075,30,GARD,3482,2865,121,2744,2008,t1,cantonales
10076,30,GARD,21516,13696,562,13134,2008,t1,cantonales
10077,30,GARD,21109,11944,270,11674,2008,t1,cantonales
10078,30,GARD,18493,9753,253,9500,2008,t1,cantonales
10079,30,GARD,4629,3724,94,3630,2008,t1,cantonales
10080,30,GARD,6787,5377,132,5245,2008,t1,cantonales
10081,30,GARD,11075,8376,236,8140,2008,t1,cantonales
10082,30,GARD,10996,7030,209,6821,2008,t1,cantonales
10083,30,GARD,3861,2949,232,2717,2008,t1,cantonales
10084,30,GARD,2776,2348,161,2187,2008,t1,cantonales
10085,30,GARD,1847,1439,36,1403,2008,t1,cantonales
10086,30,GARD,25556,16564,366,16198,2008,t1,cantonales
10087,30,GARD,20646,13197,459,12738,2008,t1,cantonales
10088,30,GARD,9834,4670,166,4504,2008,t1,cantonales
10089,30,GARD,17466,11547,355,11192,2008,t1,cantonales
10090,30,GARD,16552,11558,362,11196,2008,t1,cantonales
10091,31,HAUTE GARONNE,4645,3861,431,3430,2008,t1,cantonales
10092,31,HAUTE GARONNE,13649,10138,336,9802,2008,t1,cantonales
10093,31,HAUTE GARONNE,5591,4452,355,4097,2008,t1,cantonales
10094,31,HAUTE GARONNE,5328,4244,167,4077,2008,t1,cantonales
10095,31,HAUTE GARONNE,11553,8438,364,8074,2008,t1,cantonales
10096,31,HAUTE GARONNE,4389,3438,221,3217,2008,t1,cantonales
10097,31,HAUTE GARONNE,20615,14142,765,13377,2008,t1,cantonales
10098,31,HAUTE GARONNE,31362,20217,1094,19123,2008,t1,cantonales
10099,31,HAUTE GARONNE,3362,2564,199,2365,2008,t1,cantonales
10100,31,HAUTE GARONNE,18031,13201,436,12765,2008,t1,cantonales
10101,31,HAUTE GARONNE,6500,5179,191,4988,2008,t1,cantonales
10102,31,HAUTE GARONNE,4738,3741,181,3560,2008,t1,cantonales
10103,31,HAUTE GARONNE,3697,3073,191,2882,2008,t1,cantonales
10104,31,HAUTE GARONNE,18985,13500,438,13062,2008,t1,cantonales
10105,31,HAUTE GARONNE,7175,5425,580,4845,2008,t1,cantonales
10106,31,HAUTE GARONNE,16014,8896,201,8695,2008,t1,cantonales
10107,31,HAUTE GARONNE,5055,4099,96,4003,2008,t1,cantonales
10108,31,HAUTE GARONNE,6924,5120,221,4899,2008,t1,cantonales
10109,31,HAUTE GARONNE,15149,8250,251,7999,2008,t1,cantonales
10110,31,HAUTE GARONNE,12841,6852,190,6662,2008,t1,cantonales
10111,31,HAUTE GARONNE,36209,24392,623,23769,2008,t1,cantonales
10112,31,HAUTE GARONNE,28837,17140,520,16620,2008,t1,cantonales
10113,31,HAUTE GARONNE,17819,9584,260,9324,2008,t1,cantonales
10114,31,HAUTE GARONNE,16253,8475,369,8106,2008,t1,cantonales
10115,31,HAUTE GARONNE,43002,26690,962,25728,2008,t1,cantonales
10116,31,HAUTE GARONNE,27356,18399,672,17727,2008,t1,cantonales
10117,32,GERS,2314,1948,110,1838,2008,t1,cantonales
10118,32,GERS,7201,4928,309,4619,2008,t1,cantonales
10119,32,GERS,7954,6089,201,5888,2008,t1,cantonales
10120,32,GERS,4745,3780,134,3646,2008,t1,cantonales
10121,32,GERS,5457,4280,172,4108,2008,t1,cantonales
10122,32,GERS,9112,6568,322,6246,2008,t1,cantonales
10123,32,GERS,4888,3646,185,3461,2008,t1,cantonales
10124,32,GERS,2689,2166,168,1998,2008,t1,cantonales
10125,32,GERS,3460,2879,113,2766,2008,t1,cantonales
10126,32,GERS,6006,4957,150,4807,2008,t1,cantonales
10127,32,GERS,2394,2048,65,1983,2008,t1,cantonales
10128,32,GERS,6347,5102,512,4590,2008,t1,cantonales
10129,32,GERS,3733,3080,135,2945,2008,t1,cantonales
10130,32,GERS,4824,3901,182,3719,2008,t1,cantonales
10131,32,GERS,6919,4760,240,4520,2008,t1,cantonales
10132,33,GIRONDE,6915,5305,212,5093,2008,t1,cantonales
10133,33,GIRONDE,37253,23101,525,22576,2008,t1,cantonales
10134,33,GIRONDE,10585,7254,296,6958,2008,t1,cantonales
10135,33,GIRONDE,14369,7941,165,7776,2008,t1,cantonales
10136,33,GIRONDE,21298,12450,237,12213,2008,t1,cantonales
10137,33,GIRONDE,18502,10603,224,10379,2008,t1,cantonales
10138,33,GIRONDE,12948,7255,140,7115,2008,t1,cantonales
10139,33,GIRONDE,7975,4815,124,4691,2008,t1,cantonales
10140,33,GIRONDE,7450,5333,162,5171,2008,t1,cantonales
10141,33,GIRONDE,15903,10997,584,10413,2008,t1,cantonales
10142,33,GIRONDE,31069,20737,563,20174,2008,t1,cantonales
10143,33,GIRONDE,11105,7776,347,7429,2008,t1,cantonales
10144,33,GIRONDE,2272,1930,89,1841,2008,t1,cantonales
10145,33,GIRONDE,12558,9273,362,8911,2008,t1,cantonales
10146,33,GIRONDE,12828,9394,364,9030,2008,t1,cantonales
10147,33,GIRONDE,5898,4449,216,4233,2008,t1,cantonales
10148,33,GIRONDE,2050,1635,82,1553,2008,t1,cantonales
10149,33,GIRONDE,13184,9731,341,9390,2008,t1,cantonales
10150,33,GIRONDE,9611,7239,304,6935,2008,t1,cantonales
10151,33,GIRONDE,13941,8967,386,8581,2008,t1,cantonales
10152,33,GIRONDE,8739,6430,261,6169,2008,t1,cantonales
10153,33,GIRONDE,13743,9496,372,9124,2008,t1,cantonales
10154,33,GIRONDE,7900,6135,253,5882,2008,t1,cantonales
10155,33,GIRONDE,4967,3943,115,3828,2008,t1,cantonales
10156,33,GIRONDE,36993,23719,724,22995,2008,t1,cantonales
10157,33,GIRONDE,23347,13421,269,13152,2008,t1,cantonales
10158,33,GIRONDE,25185,14805,348,14457,2008,t1,cantonales
10159,33,GIRONDE,19415,12254,309,11945,2008,t1,cantonales
10160,33,GIRONDE,32443,20835,676,20159,2008,t1,cantonales
10161,33,GIRONDE,18082,10229,319,9910,2008,t1,cantonales
10162,33,GIRONDE,19051,10713,332,10381,2008,t1,cantonales
10163,33,GIRONDE,37089,24741,651,24090,2008,t1,cantonales
10164,34,HERAULT,33116,22105,824,21281,2008,t1,cantonales
10165,34,HERAULT,6813,4910,172,4738,2008,t1,cantonales
10166,34,HERAULT,7711,5585,210,5375,2008,t1,cantonales
10167,34,HERAULT,13143,6670,216,6454,2008,t1,cantonales
10168,34,HERAULT,23881,15712,978,14734,2008,t1,cantonales
10169,34,HERAULT,3155,2461,141,2320,2008,t1,cantonales
10170,34,HERAULT,6768,5170,146,5024,2008,t1,cantonales
10171,34,HERAULT,34072,23191,833,22358,2008,t1,cantonales
10172,34,HERAULT,18059,13239,679,12560,2008,t1,cantonales
10173,34,HERAULT,9243,6955,207,6748,2008,t1,cantonales
10174,34,HERAULT,3424,2785,89,2696,2008,t1,cantonales
10175,34,HERAULT,22630,15526,416,15110,2008,t1,cantonales
10176,34,HERAULT,7903,6222,278,5944,2008,t1,cantonales
10177,34,HERAULT,13729,6325,138,6187,2008,t1,cantonales
10178,34,HERAULT,15783,9199,222,8977,2008,t1,cantonales
10179,34,HERAULT,4266,3475,125,3350,2008,t1,cantonales
10180,34,HERAULT,6310,4850,284,4566,2008,t1,cantonales
10181,34,HERAULT,3944,3083,150,2933,2008,t1,cantonales
10182,34,HERAULT,3182,2443,295,2148,2008,t1,cantonales
10183,34,HERAULT,15424,10594,259,10335,2008,t1,cantonales
10184,34,HERAULT,16979,9048,302,8746,2008,t1,cantonales
10185,34,HERAULT,12551,7090,199,6891,2008,t1,cantonales
10186,34,HERAULT,23261,13632,444,13188,2008,t1,cantonales
10187,35,ILLE ET VILAINE,6805,5310,238,5072,2008,t1,cantonales
10188,35,ILLE ET VILAINE,10047,7180,474,6706,2008,t1,cantonales
10189,35,ILLE ET VILAINE,18347,12347,492,11855,2008,t1,cantonales
10190,35,ILLE ET VILAINE,9519,6932,250,6682,2008,t1,cantonales
10191,35,ILLE ET VILAINE,20205,13438,342,13096,2008,t1,cantonales
10192,35,ILLE ET VILAINE,10033,7248,298,6950,2008,t1,cantonales
10193,35,ILLE ET VILAINE,16945,11359,464,10895,2008,t1,cantonales
10194,35,ILLE ET VILAINE,8598,6103,291,5812,2008,t1,cantonales
10195,35,ILLE ET VILAINE,18317,12276,494,11782,2008,t1,cantonales
10196,35,ILLE ET VILAINE,10935,8065,295,7770,2008,t1,cantonales
10197,35,ILLE ET VILAINE,5799,4535,151,4384,2008,t1,cantonales
10198,35,ILLE ET VILAINE,7567,5765,193,5572,2008,t1,cantonales
10199,35,ILLE ET VILAINE,19527,13539,465,13074,2008,t1,cantonales
10200,35,ILLE ET VILAINE,20121,14000,482,13518,2008,t1,cantonales
10201,35,ILLE ET VILAINE,13353,9044,199,8845,2008,t1,cantonales
10202,35,ILLE ET VILAINE,16826,10292,223,10069,2008,t1,cantonales
10203,35,ILLE ET VILAINE,7437,5717,233,5484,2008,t1,cantonales
10204,35,ILLE ET VILAINE,21861,12546,420,12126,2008,t1,cantonales
10205,35,ILLE ET VILAINE,7401,5813,166,5647,2008,t1,cantonales
10206,35,ILLE ET VILAINE,7771,6175,217,5958,2008,t1,cantonales
10207,35,ILLE ET VILAINE,16540,11062,505,10557,2008,t1,cantonales
10208,35,ILLE ET VILAINE,10576,5695,118,5577,2008,t1,cantonales
10209,35,ILLE ET VILAINE,9883,5678,155,5523,2008,t1,cantonales
10210,35,ILLE ET VILAINE,19431,10815,249,10566,2008,t1,cantonales
10211,35,ILLE ET VILAINE,9021,4521,91,4430,2008,t1,cantonales
10212,35,ILLE ET VILAINE,18803,12578,369,12209,2008,t1,cantonales
10213,36,INDRE,12820,9203,421,8782,2008,t1,cantonales
10214,36,INDRE,2790,2082,453,1629,2008,t1,cantonales
10215,36,INDRE,8830,6488,247,6241,2008,t1,cantonales
10216,36,INDRE,9197,6964,249,6715,2008,t1,cantonales
10217,36,INDRE,12385,7509,232,7277,2008,t1,cantonales
10218,36,INDRE,4978,3900,160,3740,2008,t1,cantonales
10219,36,INDRE,10528,8002,387,7615,2008,t1,cantonales
10220,36,INDRE,8851,5987,271,5716,2008,t1,cantonales
10221,36,INDRE,5947,4471,270,4201,2008,t1,cantonales
10222,36,INDRE,4896,3763,161,3602,2008,t1,cantonales
10223,36,INDRE,4457,3447,135,3312,2008,t1,cantonales
10224,36,INDRE,3615,2849,105,2744,2008,t1,cantonales
10225,36,INDRE,7105,3943,230,3713,2008,t1,cantonales
10226,37,INDRE ET LOIRE,17510,11652,406,11246,2008,t1,cantonales
10227,37,INDRE ET LOIRE,11213,7844,429,7415,2008,t1,cantonales
10228,37,INDRE ET LOIRE,14986,10072,344,9728,2008,t1,cantonales
10229,37,INDRE ET LOIRE,6814,5100,160,4940,2008,t1,cantonales
10230,37,INDRE ET LOIRE,8372,5889,289,5600,2008,t1,cantonales
10231,37,INDRE ET LOIRE,14311,10335,386,9949,2008,t1,cantonales
10232,37,INDRE ET LOIRE,9893,6799,313,6486,2008,t1,cantonales
10233,37,INDRE ET LOIRE,4258,3318,138,3180,2008,t1,cantonales
10234,37,INDRE ET LOIRE,8580,6524,244,6280,2008,t1,cantonales
10235,37,INDRE ET LOIRE,11549,6309,112,6197,2008,t1,cantonales
10236,37,INDRE ET LOIRE,19673,12857,497,12360,2008,t1,cantonales
10237,37,INDRE ET LOIRE,10319,5997,167,5830,2008,t1,cantonales
10238,37,INDRE ET LOIRE,12243,7092,178,6914,2008,t1,cantonales
10239,37,INDRE ET LOIRE,12366,7590,191,7399,2008,t1,cantonales
10240,37,INDRE ET LOIRE,10669,6036,136,5900,2008,t1,cantonales
10241,37,INDRE ET LOIRE,16455,10335,341,9994,2008,t1,cantonales
10242,37,INDRE ET LOIRE,10944,7120,149,6971,2008,t1,cantonales
10243,37,INDRE ET LOIRE,14758,9781,455,9326,2008,t1,cantonales
10244,38,ISERE,5570,3964,110,3854,2008,t1,cantonales
10245,38,ISERE,10413,7263,312,6951,2008,t1,cantonales
10246,38,ISERE,10158,7396,197,7199,2008,t1,cantonales
10247,38,ISERE,20063,13682,306,13376,2008,t1,cantonales
10248,38,ISERE,15552,10213,340,9873,2008,t1,cantonales
10249,38,ISERE,14078,7873,474,7399,2008,t1,cantonales
10250,38,ISERE,15157,9265,311,8954,2008,t1,cantonales
10251,38,ISERE,4829,3321,334,2987,2008,t1,cantonales
10252,38,ISERE,21759,13884,374,13510,2008,t1,cantonales
10253,38,ISERE,4849,3668,207,3461,2008,t1,cantonales
10254,38,ISERE,8678,6257,413,5844,2008,t1,cantonales
10255,38,ISERE,8468,5767,129,5638,2008,t1,cantonales
10256,38,ISERE,17828,10689,237,10452,2008,t1,cantonales
10257,38,ISERE,19493,12557,375,12182,2008,t1,cantonales
10258,38,ISERE,18172,12415,468,11947,2008,t1,cantonales
10259,38,ISERE,24167,14204,421,13783,2008,t1,cantonales
10260,38,ISERE,25271,15470,578,14892,2008,t1,cantonales
10261,38,ISERE,7939,5562,202,5360,2008,t1,cantonales
10262,38,ISERE,21828,13723,454,13269,2008,t1,cantonales
10263,38,ISERE,15368,8427,313,8114,2008,t1,cantonales
10264,38,ISERE,10894,5718,143,5575,2008,t1,cantonales
10265,38,ISERE,16870,8882,223,8659,2008,t1,cantonales
10266,38,ISERE,21342,13458,522,12936,2008,t1,cantonales
10267,38,ISERE,17244,10475,316,10159,2008,t1,cantonales
10268,38,ISERE,12627,6900,136,6764,2008,t1,cantonales
10269,38,ISERE,13196,8314,225,8089,2008,t1,cantonales
10270,38,ISERE,19318,11308,259,11049,2008,t1,cantonales
10271,38,ISERE,19479,9519,279,9240,2008,t1,cantonales
10272,38,ISERE,6639,3754,364,3390,2008,t1,cantonales
10273,38,ISERE,14752,9831,156,9675,2008,t1,cantonales
10274,39,JURA,5203,3982,200,3782,2008,t1,cantonales
10275,39,JURA,12666,9349,494,8855,2008,t1,cantonales
10276,39,JURA,2094,1768,58,1710,2008,t1,cantonales
10277,39,JURA,5101,4064,128,3936,2008,t1,cantonales
10278,39,JURA,4900,3823,227,3596,2008,t1,cantonales
10279,39,JURA,2208,1853,68,1785,2008,t1,cantonales
10280,39,JURA,3457,2696,125,2571,2008,t1,cantonales
10281,39,JURA,6941,5225,203,5022,2008,t1,cantonales
10282,39,JURA,4760,3668,119,3549,2008,t1,cantonales
10283,39,JURA,3535,2905,129,2776,2008,t1,cantonales
10284,39,JURA,14106,9203,271,8932,2008,t1,cantonales
10285,39,JURA,1614,1302,51,1251,2008,t1,cantonales
10286,39,JURA,4170,3105,170,2935,2008,t1,cantonales
10287,39,JURA,4485,3288,91,3197,2008,t1,cantonales
10288,39,JURA,5066,3970,174,3796,2008,t1,cantonales
10289,39,JURA,11490,7198,376,6822,2008,t1,cantonales
10290,39,JURA,10243,6462,301,6161,2008,t1,cantonales
10291,40,LANDES,7557,5786,595,5191,2008,t1,cantonales
10292,40,LANDES,5919,4687,160,4527,2008,t1,cantonales
10293,40,LANDES,8474,6743,295,6448,2008,t1,cantonales
10294,40,LANDES,4464,3735,166,3569,2008,t1,cantonales
10295,40,LANDES,18993,13536,493,13043,2008,t1,cantonales
10296,40,LANDES,8243,6289,237,6052,2008,t1,cantonales
10297,40,LANDES,6123,4796,244,4552,2008,t1,cantonales
10298,40,LANDES,4542,3453,175,3278,2008,t1,cantonales
10299,40,LANDES,18549,12829,433,12396,2008,t1,cantonales
10300,40,LANDES,7754,6237,190,6047,2008,t1,cantonales
10301,40,LANDES,1475,1038,486,552,2008,t1,cantonales
10302,40,LANDES,20792,14500,593,13907,2008,t1,cantonales
10303,40,LANDES,7938,6054,236,5818,2008,t1,cantonales
10304,40,LANDES,4665,3451,497,2954,2008,t1,cantonales
10305,40,LANDES,22375,14656,541,14115,2008,t1,cantonales
10306,41,LOIR ET CHER,11786,7473,268,7205,2008,t1,cantonales
10307,41,LOIR ET CHER,14639,10278,411,9867,2008,t1,cantonales
10308,41,LOIR ET CHER,2666,2101,78,2023,2008,t1,cantonales
10309,41,LOIR ET CHER,11639,8436,304,8132,2008,t1,cantonales
10310,41,LOIR ET CHER,8292,5860,188,5672,2008,t1,cantonales
10311,41,LOIR ET CHER,5437,3861,156,3705,2008,t1,cantonales
10312,41,LOIR ET CHER,8366,5840,255,5585,2008,t1,cantonales
10313,41,LOIR ET CHER,6685,4841,214,4627,2008,t1,cantonales
10314,41,LOIR ET CHER,13650,9964,388,9576,2008,t1,cantonales
10315,41,LOIR ET CHER,3759,2806,139,2667,2008,t1,cantonales
10316,41,LOIR ET CHER,7926,5678,254,5424,2008,t1,cantonales
10317,41,LOIR ET CHER,3040,2340,168,2172,2008,t1,cantonales
10318,41,LOIR ET CHER,9353,6353,255,6098,2008,t1,cantonales
10319,41,LOIR ET CHER,7975,5280,215,5065,2008,t1,cantonales
10320,41,LOIR ET CHER,7567,5055,153,4902,2008,t1,cantonales
10321,42,LOIRE,9630,7260,333,6927,2008,t1,cantonales
10322,42,LOIRE,13459,8243,175,8068,2008,t1,cantonales
10323,42,LOIRE,11469,7574,260,7314,2008,t1,cantonales
10324,42,LOIRE,21498,14555,285,14270,2008,t1,cantonales
10325,42,LOIRE,6518,4550,210,4340,2008,t1,cantonales
10326,42,LOIRE,3562,2941,78,2863,2008,t1,cantonales
10327,42,LOIRE,11334,7692,220,7472,2008,t1,cantonales
10328,42,LOIRE,18898,10683,287,10396,2008,t1,cantonales
10329,42,LOIRE,15569,8618,129,8489,2008,t1,cantonales
10330,42,LOIRE,21679,13279,286,12993,2008,t1,cantonales
10331,42,LOIRE,25826,16098,618,15480,2008,t1,cantonales
10332,42,LOIRE,4619,3542,127,3415,2008,t1,cantonales
10333,42,LOIRE,5303,3985,122,3863,2008,t1,cantonales
10334,42,LOIRE,27009,17040,561,16479,2008,t1,cantonales
10335,42,LOIRE,9493,6973,290,6683,2008,t1,cantonales
10336,42,LOIRE,15783,9563,279,9284,2008,t1,cantonales
10337,42,LOIRE,25284,15800,463,15337,2008,t1,cantonales
10338,42,LOIRE,15900,8675,194,8481,2008,t1,cantonales
10339,42,LOIRE,12619,6395,143,6252,2008,t1,cantonales
10340,43,HAUTE LOIRE,2582,2145,88,2057,2008,t1,cantonales
10341,43,HAUTE LOIRE,5524,4287,204,4083,2008,t1,cantonales
10342,43,HAUTE LOIRE,2089,1861,41,1820,2008,t1,cantonales
10343,43,HAUTE LOIRE,2122,1710,150,1560,2008,t1,cantonales
10344,43,HAUTE LOIRE,3686,2858,218,2640,2008,t1,cantonales
10345,43,HAUTE LOIRE,6261,4957,209,4748,2008,t1,cantonales
10346,43,HAUTE LOIRE,3764,3198,119,3079,2008,t1,cantonales
10347,43,HAUTE LOIRE,3544,2908,120,2788,2008,t1,cantonales
10348,43,HAUTE LOIRE,1024,873,43,830,2008,t1,cantonales
10349,43,HAUTE LOIRE,7994,5500,285,5215,2008,t1,cantonales
10350,43,HAUTE LOIRE,8730,6312,308,6004,2008,t1,cantonales
10351,43,HAUTE LOIRE,2612,1942,40,1902,2008,t1,cantonales
10352,43,HAUTE LOIRE,10888,7827,350,7477,2008,t1,cantonales
10353,43,HAUTE LOIRE,4479,3657,91,3566,2008,t1,cantonales
10354,43,HAUTE LOIRE,9181,6870,338,6532,2008,t1,cantonales
10355,43,HAUTE LOIRE,3958,2936,78,2858,2008,t1,cantonales
10356,43,HAUTE LOIRE,5478,3773,131,3642,2008,t1,cantonales
10357,43,HAUTE LOIRE,5137,3913,183,3730,2008,t1,cantonales
10358,43,HAUTE LOIRE,6391,4541,140,4401,2008,t1,cantonales
10359,44,LOIRE ATLANTIQUE,32291,20124,769,19355,2008,t1,cantonales
10360,44,LOIRE ATLANTIQUE,9137,6482,191,6291,2008,t1,cantonales
10361,44,LOIRE ATLANTIQUE,26693,17718,771,16947,2008,t1,cantonales
10362,44,LOIRE ATLANTIQUE,12022,8430,307,8123,2008,t1,cantonales
10363,44,LOIRE ATLANTIQUE,11098,7758,227,7531,2008,t1,cantonales
10364,44,LOIRE ATLANTIQUE,24842,16490,444,16046,2008,t1,cantonales
10365,44,LOIRE ATLANTIQUE,5606,4135,92,4043,2008,t1,cantonales
10366,44,LOIRE ATLANTIQUE,8325,5729,187,5542,2008,t1,cantonales
10367,44,LOIRE ATLANTIQUE,10266,7223,230,6993,2008,t1,cantonales
10368,44,LOIRE ATLANTIQUE,4966,3912,167,3745,2008,t1,cantonales
10369,44,LOIRE ATLANTIQUE,21571,11748,395,11353,2008,t1,cantonales
10370,44,LOIRE ATLANTIQUE,22209,12172,247,11925,2008,t1,cantonales
10371,44,LOIRE ATLANTIQUE,17415,9763,274,9489,2008,t1,cantonales
10372,44,LOIRE ATLANTIQUE,10612,7663,324,7339,2008,t1,cantonales
10373,44,LOIRE ATLANTIQUE,19572,13129,501,12628,2008,t1,cantonales
10374,44,LOIRE ATLANTIQUE,17468,11744,344,11400,2008,t1,cantonales
10375,44,LOIRE ATLANTIQUE,10202,7149,192,6957,2008,t1,cantonales
10376,44,LOIRE ATLANTIQUE,3932,2929,177,2752,2008,t1,cantonales
10377,44,LOIRE ATLANTIQUE,4424,3363,104,3259,2008,t1,cantonales
10378,44,LOIRE ATLANTIQUE,8706,6409,476,5933,2008,t1,cantonales
10379,44,LOIRE ATLANTIQUE,8209,5280,205,5075,2008,t1,cantonales
10380,44,LOIRE ATLANTIQUE,12568,8761,321,8440,2008,t1,cantonales
10381,44,LOIRE ATLANTIQUE,16947,10704,449,10255,2008,t1,cantonales
10382,44,LOIRE ATLANTIQUE,17569,9718,185,9533,2008,t1,cantonales
10383,44,LOIRE ATLANTIQUE,26042,16330,319,16011,2008,t1,cantonales
10384,44,LOIRE ATLANTIQUE,21747,12165,303,11862,2008,t1,cantonales
10385,44,LOIRE ATLANTIQUE,14701,7690,247,7443,2008,t1,cantonales
10386,44,LOIRE ATLANTIQUE,17101,9521,374,9147,2008,t1,cantonales
10387,44,LOIRE ATLANTIQUE,16896,8827,316,8511,2008,t1,cantonales
10388,44,LOIRE ATLANTIQUE,16053,10654,357,10297,2008,t1,cantonales
10389,45,LOIRET,11904,7483,279,7204,2008,t1,cantonales
10390,45,LOIRET,7418,5179,318,4861,2008,t1,cantonales
10391,45,LOIRET,5050,3500,159,3341,2008,t1,cantonales
10392,45,LOIRET,7808,5475,169,5306,2008,t1,cantonales
10393,45,LOIRET,5672,3912,162,3750,2008,t1,cantonales
10394,45,LOIRET,7288,4903,160,4743,2008,t1,cantonales
10395,45,LOIRET,11349,7488,395,7093,2008,t1,cantonales
10396,45,LOIRET,10440,7633,237,7396,2008,t1,cantonales
10397,45,LOIRET,17135,11224,360,10864,2008,t1,cantonales
10398,45,LOIRET,10657,6941,273,6668,2008,t1,cantonales
10399,45,LOIRET,10870,6097,158,5939,2008,t1,cantonales
10400,45,LOIRET,9464,4722,172,4550,2008,t1,cantonales
10401,45,LOIRET,12730,6877,155,6722,2008,t1,cantonales
10402,45,LOIRET,6332,4562,190,4372,2008,t1,cantonales
10403,45,LOIRET,7084,4857,213,4644,2008,t1,cantonales
10404,45,LOIRET,16666,10340,431,9909,2008,t1,cantonales
10405,45,LOIRET,19401,11929,251,11678,2008,t1,cantonales
10406,45,LOIRET,9481,5647,158,5489,2008,t1,cantonales
10407,45,LOIRET,12972,8753,306,8447,2008,t1,cantonales
10408,45,LOIRET,25089,15650,377,15273,2008,t1,cantonales
10409,45,LOIRET,8974,4581,94,4487,2008,t1,cantonales
10410,46,LOT,6816,5487,221,5266,2008,t1,cantonales
10411,46,LOT,3236,2528,279,2249,2008,t1,cantonales
10412,46,LOT,4157,3588,177,3411,2008,t1,cantonales
10413,46,LOT,6331,5046,217,4829,2008,t1,cantonales
10414,46,LOT,1832,1560,63,1497,2008,t1,cantonales
10415,46,LOT,4443,3690,112,3578,2008,t1,cantonales
10416,46,LOT,2332,2008,59,1949,2008,t1,cantonales
10417,46,LOT,2815,2402,111,2291,2008,t1,cantonales
10418,46,LOT,3227,2717,429,2288,2008,t1,cantonales
10419,46,LOT,3089,2503,86,2417,2008,t1,cantonales
10420,46,LOT,7240,5588,300,5288,2008,t1,cantonales
10421,46,LOT,6127,4889,164,4725,2008,t1,cantonales
10422,46,LOT,2082,1759,207,1552,2008,t1,cantonales
10423,46,LOT,2114,1707,168,1539,2008,t1,cantonales
10424,46,LOT,3617,3031,105,2926,2008,t1,cantonales
10425,47,LOT ET GARONNE,8859,5524,199,5325,2008,t1,cantonales
10426,47,LOT ET GARONNE,6412,4905,248,4657,2008,t1,cantonales
10427,47,LOT ET GARONNE,5118,3920,161,3759,2008,t1,cantonales
10428,47,LOT ET GARONNE,2770,2180,70,2110,2008,t1,cantonales
10429,47,LOT ET GARONNE,2602,2196,71,2125,2008,t1,cantonales
10430,47,LOT ET GARONNE,2322,1885,76,1809,2008,t1,cantonales
10431,47,LOT ET GARONNE,8751,6235,360,5875,2008,t1,cantonales
10432,47,LOT ET GARONNE,7069,5479,151,5328,2008,t1,cantonales
10433,47,LOT ET GARONNE,6698,5107,158,4949,2008,t1,cantonales
10434,47,LOT ET GARONNE,4693,3917,129,3788,2008,t1,cantonales
10435,47,LOT ET GARONNE,3151,2506,91,2415,2008,t1,cantonales
10436,47,LOT ET GARONNE,7402,5427,208,5219,2008,t1,cantonales
10437,47,LOT ET GARONNE,5957,4405,158,4247,2008,t1,cantonales
10438,47,LOT ET GARONNE,6466,4806,169,4637,2008,t1,cantonales
10439,47,LOT ET GARONNE,5711,4408,122,4286,2008,t1,cantonales
10440,47,LOT ET GARONNE,4647,3835,137,3698,2008,t1,cantonales
10441,47,LOT ET GARONNE,5096,3907,135,3772,2008,t1,cantonales
10442,47,LOT ET GARONNE,2948,2356,92,2264,2008,t1,cantonales
10443,47,LOT ET GARONNE,10704,7054,283,6771,2008,t1,cantonales
10444,47,LOT ET GARONNE,10408,6994,252,6742,2008,t1,cantonales
10445,48,LOZERE,1207,1020,52,968,2008,t1,cantonales
10446,48,LOZERE,1727,1493,60,1433,2008,t1,cantonales
10447,48,LOZERE,2556,2164,169,1995,2008,t1,cantonales
10448,48,LOZERE,3134,2515,97,2418,2008,t1,cantonales
10449,48,LOZERE,1557,1381,45,1336,2008,t1,cantonales
10450,48,LOZERE,5646,4571,140,4431,2008,t1,cantonales
10451,48,LOZERE,807,712,66,646,2008,t1,cantonales
10452,48,LOZERE,6562,5165,210,4955,2008,t1,cantonales
10453,48,LOZERE,1235,1054,26,1028,2008,t1,cantonales
10454,48,LOZERE,1906,1613,49,1564,2008,t1,cantonales
10455,48,LOZERE,5134,4357,89,4268,2008,t1,cantonales
10456,48,LOZERE,2380,2104,133,1971,2008,t1,cantonales
10457,48,LOZERE,4441,3350,131,3219,2008,t1,cantonales
10458,49,MAINE ET LOIRE,20540,11960,500,11460,2008,t1,cantonales
10459,49,MAINE ET LOIRE,19494,11248,496,10752,2008,t1,cantonales
10460,49,MAINE ET LOIRE,20562,11465,409,11056,2008,t1,cantonales
10461,49,MAINE ET LOIRE,13307,8846,566,8280,2008,t1,cantonales
10462,49,MAINE ET LOIRE,20600,13997,796,13201,2008,t1,cantonales
10463,49,MAINE ET LOIRE,11061,7779,437,7342,2008,t1,cantonales
10464,49,MAINE ET LOIRE,8439,5930,379,5551,2008,t1,cantonales
10465,49,MAINE ET LOIRE,11444,7755,478,7277,2008,t1,cantonales
10466,49,MAINE ET LOIRE,8675,6119,321,5798,2008,t1,cantonales
10467,49,MAINE ET LOIRE,9639,6705,279,6426,2008,t1,cantonales
10468,49,MAINE ET LOIRE,7053,5161,195,4966,2008,t1,cantonales
10469,49,MAINE ET LOIRE,18081,11855,536,11319,2008,t1,cantonales
10470,49,MAINE ET LOIRE,9303,6357,299,6058,2008,t1,cantonales
10471,49,MAINE ET LOIRE,4436,3381,136,3245,2008,t1,cantonales
10472,49,MAINE ET LOIRE,8401,5951,291,5660,2008,t1,cantonales
10473,49,MAINE ET LOIRE,14378,10280,487,9793,2008,t1,cantonales
10474,49,MAINE ET LOIRE,10780,7456,305,7151,2008,t1,cantonales
10475,49,MAINE ET LOIRE,11218,7975,310,7665,2008,t1,cantonales
10476,49,MAINE ET LOIRE,17255,11084,535,10549,2008,t1,cantonales
10477,49,MAINE ET LOIRE,19508,12221,553,11668,2008,t1,cantonales
10478,49,MAINE ET LOIRE,14852,9224,227,8997,2008,t1,cantonales
10479,50,MANCHE,14618,9952,477,9475,2008,t1,cantonales
10480,50,MANCHE,2467,1911,173,1738,2008,t1,cantonales
10481,50,MANCHE,5255,3780,189,3591,2008,t1,cantonales
10482,50,MANCHE,4132,3054,128,2926,2008,t1,cantonales
10483,50,MANCHE,7383,3899,117,3782,2008,t1,cantonales
10484,50,MANCHE,5528,4076,632,3444,2008,t1,cantonales
10485,50,MANCHE,4088,3259,152,3107,2008,t1,cantonales
10486,50,MANCHE,19165,12527,431,12096,2008,t1,cantonales
10487,50,MANCHE,5329,3954,185,3769,2008,t1,cantonales
10488,50,MANCHE,7663,5724,251,5473,2008,t1,cantonales
10489,50,MANCHE,5468,3799,220,3579,2008,t1,cantonales
10490,50,MANCHE,5154,3986,195,3791,2008,t1,cantonales
10491,50,MANCHE,6941,5183,216,4967,2008,t1,cantonales
10492,50,MANCHE,4813,3806,171,3635,2008,t1,cantonales
10493,50,MANCHE,12553,7159,301,6858,2008,t1,cantonales
10494,50,MANCHE,9679,6615,469,6146,2008,t1,cantonales
10495,50,MANCHE,7497,5357,223,5134,2008,t1,cantonales
10496,50,MANCHE,5727,4038,174,3864,2008,t1,cantonales
10497,50,MANCHE,9021,6962,201,6761,2008,t1,cantonales
10498,50,MANCHE,10044,6453,158,6295,2008,t1,cantonales
10499,50,MANCHE,2292,1799,131,1668,2008,t1,cantonales
10500,50,MANCHE,4366,3402,197,3205,2008,t1,cantonales
10501,50,MANCHE,5099,3727,173,3554,2008,t1,cantonales
10502,50,MANCHE,6115,4560,323,4237,2008,t1,cantonales
10503,50,MANCHE,4417,3433,257,3176,2008,t1,cantonales
10504,50,MANCHE,19009,11239,483,10756,2008,t1,cantonales
10505,51,MARNE,5127,3838,194,3644,2008,t1,cantonales
10506,51,MARNE,13560,8706,445,8261,2008,t1,cantonales
10507,51,MARNE,16790,11080,346,10734,2008,t1,cantonales
10508,51,MARNE,8439,4266,122,4144,2008,t1,cantonales
10509,51,MARNE,2591,2025,140,1885,2008,t1,cantonales
10510,51,MARNE,7232,4745,207,4538,2008,t1,cantonales
10511,51,MARNE,4125,3139,141,2998,2008,t1,cantonales
10512,51,MARNE,10804,7171,244,6927,2008,t1,cantonales
10513,51,MARNE,3076,2487,266,2221,2008,t1,cantonales
10514,51,MARNE,7207,5109,183,4926,2008,t1,cantonales
10515,51,MARNE,5456,3662,174,3488,2008,t1,cantonales
10516,51,MARNE,13696,7115,120,6995,2008,t1,cantonales
10517,51,MARNE,10527,5769,154,5615,2008,t1,cantonales
10518,51,MARNE,1817,1448,84,1364,2008,t1,cantonales
10519,51,MARNE,5249,3799,264,3535,2008,t1,cantonales
10520,51,MARNE,10956,7631,317,7314,2008,t1,cantonales
10521,51,MARNE,1958,1435,176,1259,2008,t1,cantonales
10522,51,MARNE,9044,6187,264,5923,2008,t1,cantonales
10523,51,MARNE,11614,6086,175,5911,2008,t1,cantonales
10524,51,MARNE,10858,5308,142,5166,2008,t1,cantonales
10525,51,MARNE,12674,7182,152,7030,2008,t1,cantonales
10526,51,MARNE,13335,6846,193,6653,2008,t1,cantonales
10527,52,HAUTE MARNE,2771,2360,137,2223,2008,t1,cantonales
10528,52,HAUTE MARNE,3481,2612,305,2307,2008,t1,cantonales
10529,52,HAUTE MARNE,2994,2526,135,2391,2008,t1,cantonales
10530,52,HAUTE MARNE,5027,3903,141,3762,2008,t1,cantonales
10531,52,HAUTE MARNE,1698,1446,86,1360,2008,t1,cantonales
10532,52,HAUTE MARNE,3282,2462,306,2156,2008,t1,cantonales
10533,52,HAUTE MARNE,5626,3888,170,3718,2008,t1,cantonales
10534,52,HAUTE MARNE,1269,1010,86,924,2008,t1,cantonales
10535,52,HAUTE MARNE,2380,1853,75,1778,2008,t1,cantonales
10536,52,HAUTE MARNE,3713,2891,123,2768,2008,t1,cantonales
10537,52,HAUTE MARNE,7163,5085,474,4611,2008,t1,cantonales
10538,52,HAUTE MARNE,1650,1370,61,1309,2008,t1,cantonales
10539,52,HAUTE MARNE,2137,1729,194,1535,2008,t1,cantonales
10540,52,HAUTE MARNE,2315,1871,197,1674,2008,t1,cantonales
10541,52,HAUTE MARNE,12496,7422,447,6975,2008,t1,cantonales
10542,52,HAUTE MARNE,4896,2781,129,2652,2008,t1,cantonales
10543,53,MAYENNE,12580,8930,429,8501,2008,t1,cantonales
10544,53,MAYENNE,3979,2984,222,2762,2008,t1,cantonales
10545,53,MAYENNE,4263,3061,96,2965,2008,t1,cantonales
10546,53,MAYENNE,8932,6118,254,5864,2008,t1,cantonales
10547,53,MAYENNE,3307,2461,137,2324,2008,t1,cantonales
10548,53,MAYENNE,9916,6994,227,6767,2008,t1,cantonales
10549,53,MAYENNE,4891,3471,240,3231,2008,t1,cantonales
10550,53,MAYENNE,2882,2202,324,1878,2008,t1,cantonales
10551,53,MAYENNE,2663,2170,119,2051,2008,t1,cantonales
10552,53,MAYENNE,5857,4131,215,3916,2008,t1,cantonales
10553,53,MAYENNE,4033,3012,190,2822,2008,t1,cantonales
10554,53,MAYENNE,4338,3223,209,3014,2008,t1,cantonales
10555,53,MAYENNE,3294,2420,169,2251,2008,t1,cantonales
10556,53,MAYENNE,5178,3896,368,3528,2008,t1,cantonales
10557,53,MAYENNE,7962,5434,221,5213,2008,t1,cantonales
10558,54,MEURTHE ET MOSELLE,8081,5992,240,5752,2008,t1,cantonales
10559,54,MEURTHE ET MOSELLE,10037,7250,291,6959,2008,t1,cantonales
10560,54,MEURTHE ET MOSELLE,11749,7471,333,7138,2008,t1,cantonales
10561,54,MEURTHE ET MOSELLE,2702,2037,133,1904,2008,t1,cantonales
10562,54,MEURTHE ET MOSELLE,2714,1893,106,1787,2008,t1,cantonales
10563,54,MEURTHE ET MOSELLE,10218,7094,282,6812,2008,t1,cantonales
10564,54,MEURTHE ET MOSELLE,4855,3965,240,3725,2008,t1,cantonales
10565,54,MEURTHE ET MOSELLE,10515,7360,465,6895,2008,t1,cantonales
10566,54,MEURTHE ET MOSELLE,8434,4164,107,4057,2008,t1,cantonales
10567,54,MEURTHE ET MOSELLE,15790,9986,541,9445,2008,t1,cantonales
10568,54,MEURTHE ET MOSELLE,17814,8983,292,8691,2008,t1,cantonales
10569,54,MEURTHE ET MOSELLE,18853,12590,453,12137,2008,t1,cantonales
10570,54,MEURTHE ET MOSELLE,7307,5690,261,5429,2008,t1,cantonales
10571,54,MEURTHE ET MOSELLE,13720,7839,594,7245,2008,t1,cantonales
10572,54,MEURTHE ET MOSELLE,14240,8962,380,8582,2008,t1,cantonales
10573,54,MEURTHE ET MOSELLE,19880,12272,378,11894,2008,t1,cantonales
10574,54,MEURTHE ET MOSELLE,13147,7893,323,7570,2008,t1,cantonales
10575,54,MEURTHE ET MOSELLE,7408,4304,92,4212,2008,t1,cantonales
10576,54,MEURTHE ET MOSELLE,20129,11931,358,11573,2008,t1,cantonales
10577,54,MEURTHE ET MOSELLE,14824,9536,346,9190,2008,t1,cantonales
10578,54,MEURTHE ET MOSELLE,16246,10481,459,10022,2008,t1,cantonales
10579,54,MEURTHE ET MOSELLE,8144,4880,106,4774,2008,t1,cantonales
10580,55,MEUSE,3387,2688,113,2575,2008,t1,cantonales
10581,55,MEUSE,9460,6431,299,6132,2008,t1,cantonales
10582,55,MEUSE,1985,1670,49,1621,2008,t1,cantonales
10583,55,MEUSE,5298,3937,202,3735,2008,t1,cantonales
10584,55,MEUSE,3905,3265,148,3117,2008,t1,cantonales
10585,55,MEUSE,8518,6060,330,5730,2008,t1,cantonales
10586,55,MEUSE,2180,1750,106,1644,2008,t1,cantonales
10587,55,MEUSE,4449,3485,154,3331,2008,t1,cantonales
10588,55,MEUSE,5955,4315,188,4127,2008,t1,cantonales
10589,55,MEUSE,2859,2365,134,2231,2008,t1,cantonales
10590,55,MEUSE,4412,3160,153,3007,2008,t1,cantonales
10591,55,MEUSE,5787,3637,162,3475,2008,t1,cantonales
10592,55,MEUSE,2967,2466,134,2332,2008,t1,cantonales
10593,55,MEUSE,4354,3320,122,3198,2008,t1,cantonales
10594,55,MEUSE,7330,6334,287,6047,2008,t1,cantonales
10595,55,MEUSE,4570,2905,133,2772,2008,t1,cantonales
10596,56,MORBIHAN,11983,8923,222,8701,2008,t1,cantonales
10597,56,MORBIHAN,25512,17439,370,17069,2008,t1,cantonales
10598,56,MORBIHAN,10529,8285,237,8048,2008,t1,cantonales
10599,56,MORBIHAN,11901,8314,323,7991,2008,t1,cantonales
10600,56,MORBIHAN,7026,5788,213,5575,2008,t1,cantonales
10601,56,MORBIHAN,13753,9820,323,9497,2008,t1,cantonales
10602,56,MORBIHAN,8304,6670,214,6456,2008,t1,cantonales
10603,56,MORBIHAN,8030,5953,288,5665,2008,t1,cantonales
10604,56,MORBIHAN,14000,10214,300,9914,2008,t1,cantonales
10605,56,MORBIHAN,2294,1884,35,1849,2008,t1,cantonales
10606,56,MORBIHAN,7673,5706,168,5538,2008,t1,cantonales
10607,56,MORBIHAN,22285,14908,520,14388,2008,t1,cantonales
10608,56,MORBIHAN,8825,6628,326,6302,2008,t1,cantonales
10609,56,MORBIHAN,10214,5496,234,5262,2008,t1,cantonales
10610,56,MORBIHAN,12276,9358,303,9055,2008,t1,cantonales
10611,56,MORBIHAN,4631,3682,113,3569,2008,t1,cantonales
10612,56,MORBIHAN,4317,3129,129,3000,2008,t1,cantonales
10613,56,MORBIHAN,9957,7525,277,7248,2008,t1,cantonales
10614,56,MORBIHAN,27262,18135,632,17503,2008,t1,cantonales
10615,56,MORBIHAN,31345,20193,860,19333,2008,t1,cantonales
10616,56,MORBIHAN,14346,7651,597,7054,2008,t1,cantonales
10617,57,MOSELLE,5133,4132,263,3869,2008,t1,cantonales
10618,57,MOSELLE,23070,15599,490,15109,2008,t1,cantonales
10619,57,MOSELLE,5115,3783,146,3637,2008,t1,cantonales
10620,57,MOSELLE,17631,12135,479,11656,2008,t1,cantonales
10621,57,MOSELLE,6050,4855,227,4628,2008,t1,cantonales
10622,57,MOSELLE,10852,8505,378,8127,2008,t1,cantonales
10623,57,MOSELLE,14863,7557,370,7187,2008,t1,cantonales
10624,57,MOSELLE,26368,13313,420,12893,2008,t1,cantonales
10625,57,MOSELLE,25777,16591,964,15627,2008,t1,cantonales
10626,57,MOSELLE,14734,8966,348,8618,2008,t1,cantonales
10627,57,MOSELLE,14390,10112,408,9704,2008,t1,cantonales
10628,57,MOSELLE,13138,10035,388,9647,2008,t1,cantonales
10629,57,MOSELLE,3181,2474,127,2347,2008,t1,cantonales
10630,57,MOSELLE,12969,10014,543,9471,2008,t1,cantonales
10631,57,MOSELLE,19947,11765,526,11239,2008,t1,cantonales
10632,57,MOSELLE,11477,8468,427,8041,2008,t1,cantonales
10633,57,MOSELLE,8598,6367,256,6111,2008,t1,cantonales
10634,57,MOSELLE,14562,7705,242,7463,2008,t1,cantonales
10635,57,MOSELLE,23544,16071,656,15415,2008,t1,cantonales
10636,57,MOSELLE,11715,8558,404,8154,2008,t1,cantonales
10637,57,MOSELLE,4653,3893,182,3711,2008,t1,cantonales
10638,57,MOSELLE,12197,6122,216,5906,2008,t1,cantonales
10639,57,MOSELLE,17646,8004,341,7663,2008,t1,cantonales
10640,57,MOSELLE,20221,12531,777,11754,2008,t1,cantonales
10641,57,MOSELLE,12506,6226,200,6026,2008,t1,cantonales
10642,58,NIEVRE,2268,1132,37,1095,2008,t1,cantonales
10643,58,NIEVRE,4838,3745,235,3510,2008,t1,cantonales
10644,58,NIEVRE,3224,2571,146,2425,2008,t1,cantonales
10645,58,NIEVRE,6221,1973,116,1857,2008,t1,cantonales
10646,58,NIEVRE,6852,4301,178,4123,2008,t1,cantonales
10647,58,NIEVRE,3430,2637,104,2533,2008,t1,cantonales
10648,58,NIEVRE,3341,2501,228,2273,2008,t1,cantonales
10649,58,NIEVRE,3604,2824,120,2704,2008,t1,cantonales
10650,58,NIEVRE,6603,3719,217,3502,2008,t1,cantonales
10651,58,NIEVRE,8983,5688,258,5430,2008,t1,cantonales
10652,58,NIEVRE,4770,3421,157,3264,2008,t1,cantonales
10653,58,NIEVRE,3038,2117,82,2035,2008,t1,cantonales
10654,58,NIEVRE,4203,3241,132,3109,2008,t1,cantonales
10655,58,NIEVRE,4944,3704,178,3526,2008,t1,cantonales
10656,58,NIEVRE,12282,8281,449,7832,2008,t1,cantonales
10657,58,NIEVRE,6220,3908,148,3760,2008,t1,cantonales
10658,59,NORD,10425,7419,370,7049,2008,t1,cantonales
10659,59,NORD,12004,7940,249,7691,2008,t1,cantonales
10660,59,NORD,19303,12405,362,12043,2008,t1,cantonales
10661,59,NORD,14242,9326,345,8981,2008,t1,cantonales
10662,59,NORD,16819,10501,535,9966,2008,t1,cantonales
10663,59,NORD,14034,10163,369,9794,2008,t1,cantonales
10664,59,NORD,28741,17483,994,16489,2008,t1,cantonales
10665,59,NORD,22246,15349,589,14760,2008,t1,cantonales
10666,59,NORD,31981,18723,919,17804,2008,t1,cantonales
10667,59,NORD,30546,17962,695,17267,2008,t1,cantonales
10668,59,NORD,23884,13984,565,13419,2008,t1,cantonales
10669,59,NORD,34578,19551,1437,18114,2008,t1,cantonales
10670,59,NORD,34200,19503,582,18921,2008,t1,cantonales
10671,59,NORD,12019,8243,347,7896,2008,t1,cantonales
10672,59,NORD,10859,7699,771,6928,2008,t1,cantonales
10673,59,NORD,11588,5571,148,5423,2008,t1,cantonales
10674,59,NORD,20968,9928,225,9703,2008,t1,cantonales
10675,59,NORD,45282,24959,605,24354,2008,t1,cantonales
10676,59,NORD,21164,9176,322,8854,2008,t1,cantonales
10677,59,NORD,30392,19692,1057,18635,2008,t1,cantonales
10678,59,NORD,11704,9001,410,8591,2008,t1,cantonales
10679,59,NORD,28076,17185,594,16591,2008,t1,cantonales
10680,59,NORD,18524,12427,542,11885,2008,t1,cantonales
10681,59,NORD,18486,12637,533,12104,2008,t1,cantonales
10682,59,NORD,8867,6735,346,6389,2008,t1,cantonales
10683,59,NORD,9723,7208,336,6872,2008,t1,cantonales
10684,59,NORD,27910,16024,597,15427,2008,t1,cantonales
10685,59,NORD,29376,12394,509,11885,2008,t1,cantonales
10686,59,NORD,36346,17120,519,16601,2008,t1,cantonales
10687,59,NORD,14764,9610,511,9099,2008,t1,cantonales
10688,59,NORD,29289,18919,922,17997,2008,t1,cantonales
10689,59,NORD,10696,8181,286,7895,2008,t1,cantonales
10690,59,NORD,34004,16112,413,15699,2008,t1,cantonales
10691,59,NORD,19507,12539,520,12019,2008,t1,cantonales
10692,59,NORD,32917,20332,937,19395,2008,t1,cantonales
10693,59,NORD,13351,8264,224,8040,2008,t1,cantonales
10694,59,NORD,36069,18597,336,18261,2008,t1,cantonales
10695,59,NORD,28807,16649,608,16041,2008,t1,cantonales
10696,59,NORD,29208,16407,558,15849,2008,t1,cantonales
10697,59,NORD,24657,15359,573,14786,2008,t1,cantonales
10698,59,NORD,19123,10970,173,10797,2008,t1,cantonales
10699,60,OISE,11764,8220,214,8006,2008,t1,cantonales
10700,60,OISE,11178,7857,379,7478,2008,t1,cantonales
10701,60,OISE,7675,5088,200,4888,2008,t1,cantonales
10702,60,OISE,8325,6088,267,5821,2008,t1,cantonales
10703,60,OISE,20811,13646,552,13094,2008,t1,cantonales
10704,60,OISE,20016,11785,356,11429,2008,t1,cantonales
10705,60,OISE,11429,7984,309,7675,2008,t1,cantonales
10706,60,OISE,11601,7623,394,7229,2008,t1,cantonales
10707,60,OISE,7184,5461,235,5226,2008,t1,cantonales
10708,60,OISE,25436,16442,585,15857,2008,t1,cantonales
10709,60,OISE,6226,4838,188,4650,2008,t1,cantonales
10710,60,OISE,20257,12660,457,12203,2008,t1,cantonales
10711,60,OISE,12070,7895,313,7582,2008,t1,cantonales
10712,60,OISE,20319,12605,515,12090,2008,t1,cantonales
10713,60,OISE,12029,8769,410,8359,2008,t1,cantonales
10714,60,OISE,8402,6224,276,5948,2008,t1,cantonales
10715,60,OISE,10956,6710,198,6512,2008,t1,cantonales
10716,60,OISE,12361,5895,190,5705,2008,t1,cantonales
10717,60,OISE,16770,10136,290,9846,2008,t1,cantonales
10718,60,OISE,12770,8161,290,7871,2008,t1,cantonales
10719,60,OISE,14346,8119,321,7798,2008,t1,cantonales
10720,61,ORNE,7910,4514,252,4262,2008,t1,cantonales
10721,61,ORNE,14748,9991,342,9649,2008,t1,cantonales
10722,61,ORNE,5735,4797,259,4538,2008,t1,cantonales
10723,61,ORNE,6194,4475,239,4236,2008,t1,cantonales
10724,61,ORNE,2798,2096,141,1955,2008,t1,cantonales
10725,61,ORNE,2279,1756,225,1531,2008,t1,cantonales
10726,61,ORNE,4699,3730,140,3590,2008,t1,cantonales
10727,61,ORNE,3306,2446,119,2327,2008,t1,cantonales
10728,61,ORNE,7940,5818,292,5526,2008,t1,cantonales
10729,61,ORNE,3220,2359,296,2063,2008,t1,cantonales
10730,61,ORNE,6398,4363,142,4221,2008,t1,cantonales
10731,61,ORNE,3739,2723,338,2385,2008,t1,cantonales
10732,61,ORNE,6029,4484,230,4254,2008,t1,cantonales
10733,61,ORNE,6782,4662,193,4469,2008,t1,cantonales
10734,61,ORNE,3615,2535,155,2380,2008,t1,cantonales
10735,61,ORNE,3846,3005,134,2871,2008,t1,cantonales
10736,61,ORNE,5444,4037,147,3890,2008,t1,cantonales
10737,61,ORNE,5384,3888,175,3713,2008,t1,cantonales
10738,61,ORNE,3539,2578,414,2164,2008,t1,cantonales
10739,61,ORNE,4379,3424,163,3261,2008,t1,cantonales
10740,62,PAS DE CALAIS,18991,14286,800,13486,2008,t1,cantonales
10741,62,PAS DE CALAIS,9689,7910,358,7552,2008,t1,cantonales
10742,62,PAS DE CALAIS,8758,6996,358,6638,2008,t1,cantonales
10743,62,PAS DE CALAIS,6403,4921,157,4764,2008,t1,cantonales
10744,62,PAS DE CALAIS,5036,3855,955,2900,2008,t1,cantonales
10745,62,PAS DE CALAIS,16758,10582,371,10211,2008,t1,cantonales
10746,62,PAS DE CALAIS,12617,7298,335,6963,2008,t1,cantonales
10747,62,PAS DE CALAIS,8833,7184,346,6838,2008,t1,cantonales
10748,62,PAS DE CALAIS,5398,4838,163,4675,2008,t1,cantonales
10749,62,PAS DE CALAIS,11310,8668,488,8180,2008,t1,cantonales
10750,62,PAS DE CALAIS,8628,6696,317,6379,2008,t1,cantonales
10751,62,PAS DE CALAIS,8321,6997,332,6665,2008,t1,cantonales
10752,62,PAS DE CALAIS,5768,5071,298,4773,2008,t1,cantonales
10753,62,PAS DE CALAIS,14231,9787,418,9369,2008,t1,cantonales
10754,62,PAS DE CALAIS,15135,7900,378,7522,2008,t1,cantonales
10755,62,PAS DE CALAIS,14987,8514,311,8203,2008,t1,cantonales
10756,62,PAS DE CALAIS,17841,14770,526,14244,2008,t1,cantonales
10757,62,PAS DE CALAIS,8837,6686,266,6420,2008,t1,cantonales
10758,62,PAS DE CALAIS,16375,12699,1486,11213,2008,t1,cantonales
10759,62,PAS DE CALAIS,19653,13861,858,13003,2008,t1,cantonales
10760,62,PAS DE CALAIS,15719,11724,1102,10622,2008,t1,cantonales
10761,62,PAS DE CALAIS,5744,4974,253,4721,2008,t1,cantonales
10762,62,PAS DE CALAIS,12198,8520,224,8296,2008,t1,cantonales
10763,62,PAS DE CALAIS,15654,9756,326,9430,2008,t1,cantonales
10764,62,PAS DE CALAIS,21487,15272,496,14776,2008,t1,cantonales
10765,62,PAS DE CALAIS,12392,6812,423,6389,2008,t1,cantonales
10766,62,PAS DE CALAIS,15709,10170,351,9819,2008,t1,cantonales
10767,62,PAS DE CALAIS,13129,7416,353,7063,2008,t1,cantonales
10768,62,PAS DE CALAIS,14574,8103,367,7736,2008,t1,cantonales
10769,62,PAS DE CALAIS,13025,8241,284,7957,2008,t1,cantonales
10770,62,PAS DE CALAIS,16302,10907,284,10623,2008,t1,cantonales
10771,62,PAS DE CALAIS,18710,11817,392,11425,2008,t1,cantonales
10772,62,PAS DE CALAIS,14505,9271,283,8988,2008,t1,cantonales
10773,62,PAS DE CALAIS,12916,8485,671,7814,2008,t1,cantonales
10774,62,PAS DE CALAIS,16094,11280,375,10905,2008,t1,cantonales
10775,62,PAS DE CALAIS,16373,10383,552,9831,2008,t1,cantonales
10776,62,PAS DE CALAIS,14403,8201,549,7652,2008,t1,cantonales
10777,62,PAS DE CALAIS,15008,9999,344,9655,2008,t1,cantonales
10778,62,PAS DE CALAIS,15346,10147,732,9415,2008,t1,cantonales
10779,63,PUY DE DOME,6282,4881,152,4729,2008,t1,cantonales
10780,63,PUY DE DOME,2089,1827,52,1775,2008,t1,cantonales
10781,63,PUY DE DOME,3344,2662,81,2581,2008,t1,cantonales
10782,63,PUY DE DOME,4230,3559,131,3428,2008,t1,cantonales
10783,63,PUY DE DOME,4851,3639,145,3494,2008,t1,cantonales
10784,63,PUY DE DOME,7790,4158,168,3990,2008,t1,cantonales
10785,63,PUY DE DOME,9531,4909,197,4712,2008,t1,cantonales
10786,63,PUY DE DOME,5752,2977,75,2902,2008,t1,cantonales
10787,63,PUY DE DOME,6541,5176,189,4987,2008,t1,cantonales
10788,63,PUY DE DOME,7396,5870,285,5585,2008,t1,cantonales
10789,63,PUY DE DOME,1109,1019,62,957,2008,t1,cantonales
10790,63,PUY DE DOME,5912,4064,94,3970,2008,t1,cantonales
10791,63,PUY DE DOME,3871,2825,103,2722,2008,t1,cantonales
10792,63,PUY DE DOME,3547,2942,101,2841,2008,t1,cantonales
10793,63,PUY DE DOME,2610,2134,57,2077,2008,t1,cantonales
10794,63,PUY DE DOME,4332,3585,144,3441,2008,t1,cantonales
10795,63,PUY DE DOME,5471,4451,111,4340,2008,t1,cantonales
10796,63,PUY DE DOME,17133,11560,516,11044,2008,t1,cantonales
10797,63,PUY DE DOME,9043,7361,213,7148,2008,t1,cantonales
10798,63,PUY DE DOME,6748,5157,298,4859,2008,t1,cantonales
10799,63,PUY DE DOME,1713,1435,52,1383,2008,t1,cantonales
10800,63,PUY DE DOME,2957,2419,238,2181,2008,t1,cantonales
10801,63,PUY DE DOME,5403,3904,799,3105,2008,t1,cantonales
10802,63,PUY DE DOME,2547,2290,79,2211,2008,t1,cantonales
10803,63,PUY DE DOME,8348,6268,708,5560,2008,t1,cantonales
10804,63,PUY DE DOME,1922,1658,95,1563,2008,t1,cantonales
10805,63,PUY DE DOME,7900,4170,142,4028,2008,t1,cantonales
10806,63,PUY DE DOME,14634,9495,376,9119,2008,t1,cantonales
10807,63,PUY DE DOME,20404,12846,430,12416,2008,t1,cantonales
10808,63,PUY DE DOME,5945,2997,108,2889,2008,t1,cantonales
10809,63,PUY DE DOME,9675,6652,193,6459,2008,t1,cantonales
10810,64,PYRENEES ATLANTIQUES,2635,2349,156,2193,2008,t1,cantonales
10811,64,PYRENEES ATLANTIQUES,5913,4659,194,4465,2008,t1,cantonales
10812,64,PYRENEES ATLANTIQUES,12651,6772,156,6616,2008,t1,cantonales
10813,64,PYRENEES ATLANTIQUES,3980,3354,137,3217,2008,t1,cantonales
10814,64,PYRENEES ATLANTIQUES,11005,8102,329,7773,2008,t1,cantonales
10815,64,PYRENEES ATLANTIQUES,2959,2585,84,2501,2008,t1,cantonales
10816,64,PYRENEES ATLANTIQUES,8331,6912,251,6661,2008,t1,cantonales
10817,64,PYRENEES ATLANTIQUES,2094,1674,341,1333,2008,t1,cantonales
10818,64,PYRENEES ATLANTIQUES,16131,11796,399,11397,2008,t1,cantonales
10819,64,PYRENEES ATLANTIQUES,6117,4877,162,4715,2008,t1,cantonales
10820,64,PYRENEES ATLANTIQUES,9088,7386,205,7181,2008,t1,cantonales
10821,64,PYRENEES ATLANTIQUES,13147,9959,414,9545,2008,t1,cantonales
10822,64,PYRENEES ATLANTIQUES,18220,11292,353,10939,2008,t1,cantonales
10823,64,PYRENEES ATLANTIQUES,7122,5812,190,5622,2008,t1,cantonales
10824,64,PYRENEES ATLANTIQUES,5033,4209,121,4088,2008,t1,cantonales
10825,64,PYRENEES ATLANTIQUES,19551,12731,519,12212,2008,t1,cantonales
10826,64,PYRENEES ATLANTIQUES,7316,6207,215,5992,2008,t1,cantonales
10827,64,PYRENEES ATLANTIQUES,6944,5559,149,5410,2008,t1,cantonales
10828,64,PYRENEES ATLANTIQUES,3244,2714,132,2582,2008,t1,cantonales
10829,64,PYRENEES ATLANTIQUES,4772,3932,165,3767,2008,t1,cantonales
10830,64,PYRENEES ATLANTIQUES,17571,12573,543,12030,2008,t1,cantonales
10831,64,PYRENEES ATLANTIQUES,20864,14404,493,13911,2008,t1,cantonales
10832,64,PYRENEES ATLANTIQUES,12935,8453,245,8208,2008,t1,cantonales
10833,64,PYRENEES ATLANTIQUES,15471,9308,339,8969,2008,t1,cantonales
10834,64,PYRENEES ATLANTIQUES,8415,5381,150,5231,2008,t1,cantonales
10835,64,PYRENEES ATLANTIQUES,12146,8422,390,8032,2008,t1,cantonales
10836,65,HAUTES PYRENEES,9061,7131,280,6851,2008,t1,cantonales
10837,65,HAUTES PYRENEES,10736,7791,352,7439,2008,t1,cantonales
10838,65,HAUTES PYRENEES,3774,3087,161,2926,2008,t1,cantonales
10839,65,HAUTES PYRENEES,3244,2536,129,2407,2008,t1,cantonales
10840,65,HAUTES PYRENEES,2948,2481,168,2313,2008,t1,cantonales
10841,65,HAUTES PYRENEES,1541,1323,32,1291,2008,t1,cantonales
10842,65,HAUTES PYRENEES,1831,1556,47,1509,2008,t1,cantonales
10843,65,HAUTES PYRENEES,8047,6255,196,6059,2008,t1,cantonales
10844,65,HAUTES PYRENEES,7860,5731,276,5455,2008,t1,cantonales
10845,65,HAUTES PYRENEES,2969,2514,66,2448,2008,t1,cantonales
10846,65,HAUTES PYRENEES,3968,3293,138,3155,2008,t1,cantonales
10847,65,HAUTES PYRENEES,8857,6389,286,6103,2008,t1,cantonales
10848,65,HAUTES PYRENEES,4890,3992,329,3663,2008,t1,cantonales
10849,65,HAUTES PYRENEES,8945,6155,277,5878,2008,t1,cantonales
10850,65,HAUTES PYRENEES,5518,3598,128,3470,2008,t1,cantonales
10851,65,HAUTES PYRENEES,5351,3232,96,3136,2008,t1,cantonales
10852,65,HAUTES PYRENEES,8477,6312,308,6004,2008,t1,cantonales
10853,66,PYRENEES ORIENTALES,6042,4748,137,4611,2008,t1,cantonales
10854,66,PYRENEES ORIENTALES,16850,12250,427,11823,2008,t1,cantonales
10855,66,PYRENEES ORIENTALES,4049,3425,99,3326,2008,t1,cantonales
10856,66,PYRENEES ORIENTALES,15365,11846,425,11421,2008,t1,cantonales
10857,66,PYRENEES ORIENTALES,1661,1417,33,1384,2008,t1,cantonales
10858,66,PYRENEES ORIENTALES,7919,6288,162,6126,2008,t1,cantonales
10859,66,PYRENEES ORIENTALES,8190,6641,240,6401,2008,t1,cantonales
10860,66,PYRENEES ORIENTALES,11566,6210,237,5973,2008,t1,cantonales
10861,66,PYRENEES ORIENTALES,8051,4319,159,4160,2008,t1,cantonales
10862,66,PYRENEES ORIENTALES,5231,2623,107,2516,2008,t1,cantonales
10863,66,PYRENEES ORIENTALES,8032,4258,118,4140,2008,t1,cantonales
10864,66,PYRENEES ORIENTALES,15160,11034,354,10680,2008,t1,cantonales
10865,66,PYRENEES ORIENTALES,16027,11882,470,11412,2008,t1,cantonales
10866,66,PYRENEES ORIENTALES,11581,8684,252,8432,2008,t1,cantonales
10867,66,PYRENEES ORIENTALES,13712,9948,367,9581,2008,t1,cantonales
10868,67,BAS RHIN,13832,9067,449,8618,2008,t1,cantonales
10869,67,BAS RHIN,14997,10364,415,9949,2008,t1,cantonales
10870,67,BAS RHIN,32732,21010,983,20027,2008,t1,cantonales
10871,67,BAS RHIN,14813,10057,479,9578,2008,t1,cantonales
10872,67,BAS RHIN,36715,23085,874,22211,2008,t1,cantonales
10873,67,BAS RHIN,8949,6711,318,6393,2008,t1,cantonales
10874,67,BAS RHIN,28453,19233,845,18388,2008,t1,cantonales
10875,67,BAS RHIN,49755,33319,1435,31884,2008,t1,cantonales
10876,67,BAS RHIN,12614,9801,379,9422,2008,t1,cantonales
10877,67,BAS RHIN,3390,2626,113,2513,2008,t1,cantonales
10878,67,BAS RHIN,16728,11914,671,11243,2008,t1,cantonales
10879,67,BAS RHIN,29124,19207,767,18440,2008,t1,cantonales
10880,67,BAS RHIN,8485,6411,538,5873,2008,t1,cantonales
10881,67,BAS RHIN,13436,8995,456,8539,2008,t1,cantonales
10882,67,BAS RHIN,8445,6582,206,6376,2008,t1,cantonales
10883,67,BAS RHIN,14565,9969,610,9359,2008,t1,cantonales
10884,67,BAS RHIN,15346,7842,131,7711,2008,t1,cantonales
10885,67,BAS RHIN,12066,6758,127,6631,2008,t1,cantonales
10886,67,BAS RHIN,12572,7087,116,6971,2008,t1,cantonales
10887,67,BAS RHIN,13469,7398,142,7256,2008,t1,cantonales
10888,67,BAS RHIN,14989,7415,198,7217,2008,t1,cantonales
10889,67,BAS RHIN,16572,8217,203,8014,2008,t1,cantonales
10890,68,HAUT RHIN,26604,17115,724,16391,2008,t1,cantonales
10891,68,HAUT RHIN,15206,7904,463,7441,2008,t1,cantonales
10892,68,HAUT RHIN,10215,7810,381,7429,2008,t1,cantonales
10893,68,HAUT RHIN,11546,8741,456,8285,2008,t1,cantonales
10894,68,HAUT RHIN,7657,5472,273,5199,2008,t1,cantonales
10895,68,HAUT RHIN,14983,6896,603,6293,2008,t1,cantonales
10896,68,HAUT RHIN,25855,14967,1229,13738,2008,t1,cantonales
10897,68,HAUT RHIN,10877,8116,327,7789,2008,t1,cantonales
10898,68,HAUT RHIN,10060,6932,449,6483,2008,t1,cantonales
10899,68,HAUT RHIN,8869,6568,234,6334,2008,t1,cantonales
10900,68,HAUT RHIN,16717,10817,596,10221,2008,t1,cantonales
10901,68,HAUT RHIN,14783,9876,454,9422,2008,t1,cantonales
10902,68,HAUT RHIN,35784,19447,831,18616,2008,t1,cantonales
10903,68,HAUT RHIN,27865,16144,682,15462,2008,t1,cantonales
10904,68,HAUT RHIN,15830,7971,881,7090,2008,t1,cantonales
10905,68,HAUT RHIN,12363,6212,393,5819,2008,t1,cantonales
10906,68,HAUT RHIN,23892,14526,514,14012,2008,t1,cantonales
10907,69,RHONE,6199,4394,175,4219,2008,t1,cantonales
10908,69,RHONE,15608,9438,342,9096,2008,t1,cantonales
10909,69,RHONE,11566,7991,200,7791,2008,t1,cantonales
10910,69,RHONE,21139,12578,345,12233,2008,t1,cantonales
10911,69,RHONE,17728,10039,226,9813,2008,t1,cantonales
10912,69,RHONE,18020,9751,168,9583,2008,t1,cantonales
10913,69,RHONE,26181,12625,392,12233,2008,t1,cantonales
10914,69,RHONE,21432,11520,266,11254,2008,t1,cantonales
10915,69,RHONE,15445,8540,116,8424,2008,t1,cantonales
10916,69,RHONE,3446,2476,234,2242,2008,t1,cantonales
10917,69,RHONE,16305,10974,221,10753,2008,t1,cantonales
10918,69,RHONE,28228,16946,462,16484,2008,t1,cantonales
10919,69,RHONE,29531,17139,347,16792,2008,t1,cantonales
10920,69,RHONE,10807,7099,374,6725,2008,t1,cantonales
10921,69,RHONE,15530,9968,337,9631,2008,t1,cantonales
10922,69,RHONE,17606,9443,167,9276,2008,t1,cantonales
10923,69,RHONE,21183,11772,230,11542,2008,t1,cantonales
10924,69,RHONE,16634,8025,196,7829,2008,t1,cantonales
10925,69,RHONE,28771,18489,669,17820,2008,t1,cantonales
10926,69,RHONE,15455,7792,180,7612,2008,t1,cantonales
10927,69,RHONE,12219,5247,199,5048,2008,t1,cantonales
10928,69,RHONE,27932,15480,251,15229,2008,t1,cantonales
10929,69,RHONE,31491,17362,436,16926,2008,t1,cantonales
10930,69,RHONE,18537,11045,211,10834,2008,t1,cantonales
10931,69,RHONE,20313,11572,256,11316,2008,t1,cantonales
10932,69,RHONE,21151,12221,327,11894,2008,t1,cantonales
10933,69,RHONE,17510,10551,345,10206,2008,t1,cantonales
10934,69,RHONE,19314,9249,303,8946,2008,t1,cantonales
10935,70,HAUTE SAONE,9417,6608,261,6347,2008,t1,cantonales
10936,70,HAUTE SAONE,3762,3144,135,3009,2008,t1,cantonales
10937,70,HAUTE SAONE,7467,5428,232,5196,2008,t1,cantonales
10938,70,HAUTE SAONE,4642,3616,170,3446,2008,t1,cantonales
10939,70,HAUTE SAONE,5489,4352,287,4065,2008,t1,cantonales
10940,70,HAUTE SAONE,3501,2826,89,2737,2008,t1,cantonales
10941,70,HAUTE SAONE,5627,4379,296,4083,2008,t1,cantonales
10942,70,HAUTE SAONE,6399,5244,254,4990,2008,t1,cantonales
10943,70,HAUTE SAONE,10888,7824,387,7437,2008,t1,cantonales
10944,70,HAUTE SAONE,2902,2406,173,2233,2008,t1,cantonales
10945,70,HAUTE SAONE,5383,4361,210,4151,2008,t1,cantonales
10946,70,HAUTE SAONE,3340,2754,165,2589,2008,t1,cantonales
10947,70,HAUTE SAONE,10264,7200,293,6907,2008,t1,cantonales
10948,70,HAUTE SAONE,5720,4837,235,4602,2008,t1,cantonales
10949,70,HAUTE SAONE,2015,1722,94,1628,2008,t1,cantonales
10950,70,HAUTE SAONE,7649,5912,386,5526,2008,t1,cantonales
10951,71,SAONE ET LOIRE,6904,5039,285,4754,2008,t1,cantonales
10952,71,SAONE ET LOIRE,7092,5388,168,5220,2008,t1,cantonales
10953,71,SAONE ET LOIRE,11808,8045,341,7704,2008,t1,cantonales
10954,71,SAONE ET LOIRE,13225,7652,230,7422,2008,t1,cantonales
10955,71,SAONE ET LOIRE,8730,5545,225,5320,2008,t1,cantonales
10956,71,SAONE ET LOIRE,5129,3643,205,3438,2008,t1,cantonales
10957,71,SAONE ET LOIRE,6453,4724,197,4527,2008,t1,cantonales
10958,71,SAONE ET LOIRE,4741,3577,137,3440,2008,t1,cantonales
10959,71,SAONE ET LOIRE,12260,7990,345,7645,2008,t1,cantonales
10960,71,SAONE ET LOIRE,9126,6986,224,6762,2008,t1,cantonales
10961,71,SAONE ET LOIRE,11021,8012,278,7734,2008,t1,cantonales
10962,71,SAONE ET LOIRE,18594,11850,501,11349,2008,t1,cantonales
10963,71,SAONE ET LOIRE,12191,7886,422,7464,2008,t1,cantonales
10964,71,SAONE ET LOIRE,7091,4806,155,4651,2008,t1,cantonales
10965,71,SAONE ET LOIRE,2313,1674,51,1623,2008,t1,cantonales
10966,71,SAONE ET LOIRE,3003,2436,62,2374,2008,t1,cantonales
10967,71,SAONE ET LOIRE,3093,2404,62,2342,2008,t1,cantonales
10968,71,SAONE ET LOIRE,5081,4131,133,3998,2008,t1,cantonales
10969,71,SAONE ET LOIRE,2198,1709,78,1631,2008,t1,cantonales
10970,71,SAONE ET LOIRE,3405,2622,137,2485,2008,t1,cantonales
10971,71,SAONE ET LOIRE,3976,3068,127,2941,2008,t1,cantonales
10972,71,SAONE ET LOIRE,9599,6430,265,6165,2008,t1,cantonales
10973,71,SAONE ET LOIRE,8881,5931,228,5703,2008,t1,cantonales
10974,71,SAONE ET LOIRE,2989,2260,80,2180,2008,t1,cantonales
10975,71,SAONE ET LOIRE,7930,5932,259,5673,2008,t1,cantonales
10976,71,SAONE ET LOIRE,6560,4836,206,4630,2008,t1,cantonales
10977,71,SAONE ET LOIRE,8342,4939,205,4734,2008,t1,cantonales
10978,71,SAONE ET LOIRE,9218,5436,264,5172,2008,t1,cantonales
10979,71,SAONE ET LOIRE,13694,8177,331,7846,2008,t1,cantonales
10980,72,SARTHE,10329,7328,360,6968,2008,t1,cantonales
10981,72,SARTHE,4916,3525,136,3389,2008,t1,cantonales
10982,72,SARTHE,5354,3871,200,3671,2008,t1,cantonales
10983,72,SARTHE,4676,3436,185,3251,2008,t1,cantonales
10984,72,SARTHE,8747,6138,212,5926,2008,t1,cantonales
10985,72,SARTHE,19859,13054,611,12443,2008,t1,cantonales
10986,72,SARTHE,12303,8313,393,7920,2008,t1,cantonales
10987,72,SARTHE,3002,2285,115,2170,2008,t1,cantonales
10988,72,SARTHE,6271,4472,206,4266,2008,t1,cantonales
10989,72,SARTHE,15324,10110,369,9741,2008,t1,cantonales
10990,72,SARTHE,6293,4626,225,4401,2008,t1,cantonales
10991,72,SARTHE,11894,5814,630,5184,2008,t1,cantonales
10992,72,SARTHE,14474,8418,431,7987,2008,t1,cantonales
10993,72,SARTHE,7026,4954,164,4790,2008,t1,cantonales
10994,72,SARTHE,3252,2330,116,2214,2008,t1,cantonales
10995,72,SARTHE,8832,5898,246,5652,2008,t1,cantonales
10996,72,SARTHE,5752,4114,135,3979,2008,t1,cantonales
10997,72,SARTHE,16272,11011,579,10432,2008,t1,cantonales
10998,72,SARTHE,4567,3483,111,3372,2008,t1,cantonales
10999,72,SARTHE,11659,6799,483,6316,2008,t1,cantonales
11000,72,SARTHE,11843,6749,596,6153,2008,t1,cantonales
11001,73,SAVOIE,4522,3429,127,3302,2008,t1,cantonales
11002,73,SAVOIE,8043,5602,622,4980,2008,t1,cantonales
11003,73,SAVOIE,5829,3865,174,3691,2008,t1,cantonales
11004,73,SAVOIE,3798,3086,162,2924,2008,t1,cantonales
11005,73,SAVOIE,7963,4774,158,4616,2008,t1,cantonales
11006,73,SAVOIE,4065,3149,46,3103,2008,t1,cantonales
11007,73,SAVOIE,4528,3402,159,3243,2008,t1,cantonales
11008,73,SAVOIE,11306,7247,263,6984,2008,t1,cantonales
11009,73,SAVOIE,12234,8480,349,8131,2008,t1,cantonales
11010,73,SAVOIE,5778,4223,132,4091,2008,t1,cantonales
11011,73,SAVOIE,3675,2605,125,2480,2008,t1,cantonales
11012,73,SAVOIE,4657,3338,143,3195,2008,t1,cantonales
11013,73,SAVOIE,11802,8700,270,8430,2008,t1,cantonales
11014,73,SAVOIE,4565,3342,112,3230,2008,t1,cantonales
11015,73,SAVOIE,8369,5923,319,5604,2008,t1,cantonales
11016,73,SAVOIE,12127,7937,290,7647,2008,t1,cantonales
11017,73,SAVOIE,7012,3962,122,3840,2008,t1,cantonales
11018,73,SAVOIE,9762,6262,249,6013,2008,t1,cantonales
11019,74,HAUTE SAVOIE,12800,6563,141,6422,2008,t1,cantonales
11020,74,HAUTE SAVOIE,5239,3654,148,3506,2008,t1,cantonales
11021,74,HAUTE SAVOIE,5222,3689,74,3615,2008,t1,cantonales
11022,74,HAUTE SAVOIE,22263,13193,508,12685,2008,t1,cantonales
11023,74,HAUTE SAVOIE,10496,6430,233,6197,2008,t1,cantonales
11024,74,HAUTE SAVOIE,7194,5159,276,4883,2008,t1,cantonales
11025,74,HAUTE SAVOIE,21530,13594,1091,12503,2008,t1,cantonales
11026,74,HAUTE SAVOIE,17828,11521,380,11141,2008,t1,cantonales
11027,74,HAUTE SAVOIE,19814,12537,268,12269,2008,t1,cantonales
11028,74,HAUTE SAVOIE,4480,3258,362,2896,2008,t1,cantonales
11029,74,HAUTE SAVOIE,5751,3975,77,3898,2008,t1,cantonales
11030,74,HAUTE SAVOIE,11165,7953,448,7505,2008,t1,cantonales
11031,74,HAUTE SAVOIE,14516,8589,225,8364,2008,t1,cantonales
11032,74,HAUTE SAVOIE,8179,5951,174,5777,2008,t1,cantonales
11033,74,HAUTE SAVOIE,24153,11843,298,11545,2008,t1,cantonales
11034,74,HAUTE SAVOIE,7192,4254,145,4109,2008,t1,cantonales
11035,74,HAUTE SAVOIE,33199,19628,590,19038,2008,t1,cantonales
11036,76,SEINE MARITIME,4081,2968,129,2839,2008,t1,cantonales
11037,76,SEINE MARITIME,17260,11155,427,10728,2008,t1,cantonales
11038,76,SEINE MARITIME,28823,18366,662,17704,2008,t1,cantonales
11039,76,SEINE MARITIME,7735,5439,122,5317,2008,t1,cantonales
11040,76,SEINE MARITIME,10525,7649,259,7390,2008,t1,cantonales
11041,76,SEINE MARITIME,16788,11710,308,11402,2008,t1,cantonales
11042,76,SEINE MARITIME,6114,4543,290,4253,2008,t1,cantonales
11043,76,SEINE MARITIME,17564,9493,445,9048,2008,t1,cantonales
11044,76,SEINE MARITIME,12926,9683,382,9301,2008,t1,cantonales
11045,76,SEINE MARITIME,20562,13869,587,13282,2008,t1,cantonales
11046,76,SEINE MARITIME,8449,6131,214,5917,2008,t1,cantonales
11047,76,SEINE MARITIME,10409,7701,248,7453,2008,t1,cantonales
11048,76,SEINE MARITIME,9365,6625,231,6394,2008,t1,cantonales
11049,76,SEINE MARITIME,10817,6484,625,5859,2008,t1,cantonales
11050,76,SEINE MARITIME,11712,5537,479,5058,2008,t1,cantonales
11051,76,SEINE MARITIME,18680,10815,955,9860,2008,t1,cantonales
11052,76,SEINE MARITIME,26819,17067,487,16580,2008,t1,cantonales
11053,76,SEINE MARITIME,14348,10475,363,10112,2008,t1,cantonales
11054,76,SEINE MARITIME,11293,5886,171,5715,2008,t1,cantonales
11055,76,SEINE MARITIME,7369,3979,86,3893,2008,t1,cantonales
11056,76,SEINE MARITIME,6783,3681,99,3582,2008,t1,cantonales
11057,76,SEINE MARITIME,14719,10343,238,10105,2008,t1,cantonales
11058,76,SEINE MARITIME,6049,4668,339,4329,2008,t1,cantonales
11059,76,SEINE MARITIME,15500,8728,515,8213,2008,t1,cantonales
11060,76,SEINE MARITIME,7477,5795,276,5519,2008,t1,cantonales
11061,76,SEINE MARITIME,14983,10739,373,10366,2008,t1,cantonales
11062,76,SEINE MARITIME,17911,10711,699,10012,2008,t1,cantonales
11063,76,SEINE MARITIME,15317,8107,852,7255,2008,t1,cantonales
11064,76,SEINE MARITIME,7088,3463,375,3088,2008,t1,cantonales
11065,76,SEINE MARITIME,18127,11171,300,10871,2008,t1,cantonales
11066,76,SEINE MARITIME,19215,10930,628,10302,2008,t1,cantonales
11067,76,SEINE MARITIME,13983,9382,240,9142,2008,t1,cantonales
11068,76,SEINE MARITIME,15382,9928,588,9340,2008,t1,cantonales
11069,76,SEINE MARITIME,19768,12491,804,11687,2008,t1,cantonales
11070,76,SEINE MARITIME,12363,6615,151,6464,2008,t1,cantonales
11071,77,SEINE ET MARNE,9030,6036,256,5780,2008,t1,cantonales
11072,77,SEINE ET MARNE,27025,15010,373,14637,2008,t1,cantonales
11073,77,SEINE ET MARNE,9509,6494,334,6160,2008,t1,cantonales
11074,77,SEINE ET MARNE,9544,5777,298,5479,2008,t1,cantonales
11075,77,SEINE ET MARNE,28944,15717,356,15361,2008,t1,cantonales
11076,77,SEINE ET MARNE,24627,14613,558,14055,2008,t1,cantonales
11077,77,SEINE ET MARNE,22517,13974,379,13595,2008,t1,cantonales
11078,77,SEINE ET MARNE,28702,17834,528,17306,2008,t1,cantonales
11079,77,SEINE ET MARNE,7388,5386,160,5226,2008,t1,cantonales
11080,77,SEINE ET MARNE,10293,6822,265,6557,2008,t1,cantonales
11081,77,SEINE ET MARNE,30212,17001,439,16562,2008,t1,cantonales
11082,77,SEINE ET MARNE,8104,5548,211,5337,2008,t1,cantonales
11083,77,SEINE ET MARNE,21278,11167,381,10786,2008,t1,cantonales
11084,77,SEINE ET MARNE,10718,7187,277,6910,2008,t1,cantonales
11085,77,SEINE ET MARNE,20667,11177,239,10938,2008,t1,cantonales
11086,77,SEINE ET MARNE,20373,12326,508,11818,2008,t1,cantonales
11087,77,SEINE ET MARNE,32281,19371,409,18962,2008,t1,cantonales
11088,77,SEINE ET MARNE,19964,9757,443,9314,2008,t1,cantonales
11089,77,SEINE ET MARNE,15963,9486,242,9244,2008,t1,cantonales
11090,77,SEINE ET MARNE,16656,7417,198,7219,2008,t1,cantonales
11091,78,YVELINES,17001,11082,366,10716,2008,t1,cantonales
11092,78,YVELINES,26123,13760,225,13535,2008,t1,cantonales
11093,78,YVELINES,35173,21507,581,20926,2008,t1,cantonales
11094,78,YVELINES,29557,21027,422,20605,2008,t1,cantonales
11095,78,YVELINES,21172,11592,188,11404,2008,t1,cantonales
11096,78,YVELINES,19530,10186,333,9853,2008,t1,cantonales
11097,78,YVELINES,28783,14710,511,14199,2008,t1,cantonales
11098,78,YVELINES,27535,15796,415,15381,2008,t1,cantonales
11099,78,YVELINES,38116,23194,792,22402,2008,t1,cantonales
11100,78,YVELINES,25972,13992,340,13652,2008,t1,cantonales
11101,78,YVELINES,26527,14472,344,14128,2008,t1,cantonales
11102,78,YVELINES,12848,5882,233,5649,2008,t1,cantonales
11103,78,YVELINES,24052,13378,277,13101,2008,t1,cantonales
11104,78,YVELINES,21182,12309,308,12001,2008,t1,cantonales
11105,78,YVELINES,40224,21545,447,21098,2008,t1,cantonales
11106,78,YVELINES,10715,6527,100,6427,2008,t1,cantonales
11107,78,YVELINES,20460,11395,467,10928,2008,t1,cantonales
11108,78,YVELINES,35117,19628,526,19102,2008,t1,cantonales
11109,78,YVELINES,14858,8490,120,8370,2008,t1,cantonales
11110,79,DEUX SEVRES,4111,3180,155,3025,2008,t1,cantonales
11111,79,DEUX SEVRES,7645,5648,296,5352,2008,t1,cantonales
11112,79,DEUX SEVRES,3976,2902,133,2769,2008,t1,cantonales
11113,79,DEUX SEVRES,16420,11116,548,10568,2008,t1,cantonales
11114,79,DEUX SEVRES,5178,4052,187,3865,2008,t1,cantonales
11115,79,DEUX SEVRES,12153,8363,515,7848,2008,t1,cantonales
11116,79,DEUX SEVRES,4664,3694,113,3581,2008,t1,cantonales
11117,79,DEUX SEVRES,7901,5579,284,5295,2008,t1,cantonales
11118,79,DEUX SEVRES,5268,3865,144,3721,2008,t1,cantonales
11119,79,DEUX SEVRES,5113,3932,148,3784,2008,t1,cantonales
11120,79,DEUX SEVRES,6984,5034,197,4837,2008,t1,cantonales
11121,79,DEUX SEVRES,22977,14192,440,13752,2008,t1,cantonales
11122,79,DEUX SEVRES,15793,10817,452,10365,2008,t1,cantonales
11123,79,DEUX SEVRES,3243,2680,141,2539,2008,t1,cantonales
11124,79,DEUX SEVRES,11519,7878,315,7563,2008,t1,cantonales
11125,79,DEUX SEVRES,5442,4148,214,3934,2008,t1,cantonales
11126,79,DEUX SEVRES,10489,7260,333,6927,2008,t1,cantonales
11127,80,SOMME,10942,7429,423,7006,2008,t1,cantonales
11128,80,SOMME,5887,4851,214,4637,2008,t1,cantonales
11129,80,SOMME,12074,6560,266,6294,2008,t1,cantonales
11130,80,SOMME,7740,4143,207,3936,2008,t1,cantonales
11131,80,SOMME,11181,6383,235,6148,2008,t1,cantonales
11132,80,SOMME,4077,3433,162,3271,2008,t1,cantonales
11133,80,SOMME,14996,11072,350,10722,2008,t1,cantonales
11134,80,SOMME,5142,4326,163,4163,2008,t1,cantonales
11135,80,SOMME,5291,4010,133,3877,2008,t1,cantonales
11136,80,SOMME,4907,4211,233,3978,2008,t1,cantonales
11137,80,SOMME,8504,6565,322,6243,2008,t1,cantonales
11138,80,SOMME,6045,5011,235,4776,2008,t1,cantonales
11139,80,SOMME,9643,6999,245,6754,2008,t1,cantonales
11140,80,SOMME,4698,3898,122,3776,2008,t1,cantonales
11141,80,SOMME,9081,6778,341,6437,2008,t1,cantonales
11142,80,SOMME,6477,5355,238,5117,2008,t1,cantonales
11143,80,SOMME,5047,4259,232,4027,2008,t1,cantonales
11144,80,SOMME,12507,9030,387,8643,2008,t1,cantonales
11145,80,SOMME,14026,10707,598,10109,2008,t1,cantonales
11146,80,SOMME,5650,4632,178,4454,2008,t1,cantonales
11147,80,SOMME,6566,5094,215,4879,2008,t1,cantonales
11148,80,SOMME,9365,7556,253,7303,2008,t1,cantonales
11149,80,SOMME,9729,4945,316,4629,2008,t1,cantonales
11150,81,TARN,2923,2468,181,2287,2008,t1,cantonales
11151,81,TARN,3424,2753,404,2349,2008,t1,cantonales
11152,81,TARN,7101,5057,283,4774,2008,t1,cantonales
11153,81,TARN,9249,6109,235,5874,2008,t1,cantonales
11154,81,TARN,7390,5760,241,5519,2008,t1,cantonales
11155,81,TARN,15984,10955,424,10531,2008,t1,cantonales
11156,81,TARN,3105,2535,97,2438,2008,t1,cantonales
11157,81,TARN,18359,13428,672,12756,2008,t1,cantonales
11158,81,TARN,2415,2059,100,1959,2008,t1,cantonales
11159,81,TARN,3385,2859,80,2779,2008,t1,cantonales
11160,81,TARN,5603,4258,278,3980,2008,t1,cantonales
11161,81,TARN,6681,4847,170,4677,2008,t1,cantonales
11162,81,TARN,5324,4101,183,3918,2008,t1,cantonales
11163,81,TARN,2069,1805,59,1746,2008,t1,cantonales
11164,81,TARN,2894,2504,80,2424,2008,t1,cantonales
11165,81,TARN,1393,1163,69,1094,2008,t1,cantonales
11166,81,TARN,4593,3602,140,3462,2008,t1,cantonales
11167,81,TARN,10315,7517,418,7099,2008,t1,cantonales
11168,81,TARN,5995,4205,357,3848,2008,t1,cantonales
11169,81,TARN,7682,5196,221,4975,2008,t1,cantonales
11170,81,TARN,8306,5632,219,5413,2008,t1,cantonales
11171,81,TARN,7710,5172,255,4917,2008,t1,cantonales
11172,81,TARN,8264,5782,244,5538,2008,t1,cantonales
11173,82,TARN ET GARONNE,3626,2839,253,2586,2008,t1,cantonales
11174,82,TARN ET GARONNE,1611,1318,50,1268,2008,t1,cantonales
11175,82,TARN ET GARONNE,2197,1853,118,1735,2008,t1,cantonales
11176,82,TARN ET GARONNE,2053,1703,249,1454,2008,t1,cantonales
11177,82,TARN ET GARONNE,6032,3923,200,3723,2008,t1,cantonales
11178,82,TARN ET GARONNE,2395,1968,57,1911,2008,t1,cantonales
11179,82,TARN ET GARONNE,6341,4233,140,4093,2008,t1,cantonales
11180,82,TARN ET GARONNE,13892,10162,429,9733,2008,t1,cantonales
11181,82,TARN ET GARONNE,9506,7088,360,6728,2008,t1,cantonales
11182,82,TARN ET GARONNE,4802,3874,183,3691,2008,t1,cantonales
11183,82,TARN ET GARONNE,6564,4871,270,4601,2008,t1,cantonales
11184,82,TARN ET GARONNE,4588,3583,209,3374,2008,t1,cantonales
11185,82,TARN ET GARONNE,7281,5355,185,5170,2008,t1,cantonales
11186,82,TARN ET GARONNE,7333,4941,257,4684,2008,t1,cantonales
11187,82,TARN ET GARONNE,4487,2927,94,2833,2008,t1,cantonales
11188,82,TARN ET GARONNE,7290,4906,171,4735,2008,t1,cantonales
11189,83,VAR,2563,2139,52,2087,2008,t1,cantonales
11190,83,VAR,8053,5969,315,5654,2008,t1,cantonales
11191,83,VAR,26248,15603,1716,13887,2008,t1,cantonales
11192,83,VAR,12451,8186,265,7921,2008,t1,cantonales
11193,83,VAR,1277,1117,79,1038,2008,t1,cantonales
11194,83,VAR,6870,5125,98,5027,2008,t1,cantonales
11195,83,VAR,15701,10863,356,10507,2008,t1,cantonales
11196,83,VAR,36155,22748,636,22112,2008,t1,cantonales
11197,83,VAR,15647,10288,391,9897,2008,t1,cantonales
11198,83,VAR,23294,15695,481,15214,2008,t1,cantonales
11199,83,VAR,15733,10681,383,10298,2008,t1,cantonales
11200,83,VAR,4527,3348,109,3239,2008,t1,cantonales
11201,83,VAR,21343,13203,424,12779,2008,t1,cantonales
11202,83,VAR,7121,3782,158,3624,2008,t1,cantonales
11203,83,VAR,17518,9565,297,9268,2008,t1,cantonales
11204,83,VAR,7246,4269,126,4143,2008,t1,cantonales
11205,83,VAR,19722,10516,423,10093,2008,t1,cantonales
11206,83,VAR,7009,4018,111,3907,2008,t1,cantonales
11207,83,VAR,17440,9242,249,8993,2008,t1,cantonales
11208,83,VAR,29496,19426,651,18775,2008,t1,cantonales
11209,83,VAR,22571,13331,307,13024,2008,t1,cantonales
11210,84,VAUCLUSE,22065,12829,452,12377,2008,t1,cantonales
11211,84,VAUCLUSE,18759,12778,412,12366,2008,t1,cantonales
11212,84,VAUCLUSE,27768,18325,587,17738,2008,t1,cantonales
11213,84,VAUCLUSE,29133,18640,830,17810,2008,t1,cantonales
11214,84,VAUCLUSE,5070,3942,206,3736,2008,t1,cantonales
11215,84,VAUCLUSE,16939,11489,581,10908,2008,t1,cantonales
11216,84,VAUCLUSE,13751,9465,251,9214,2008,t1,cantonales
11217,84,VAUCLUSE,24986,16040,473,15567,2008,t1,cantonales
11218,84,VAUCLUSE,2082,1676,53,1623,2008,t1,cantonales
11219,84,VAUCLUSE,9837,7734,374,7360,2008,t1,cantonales
11220,84,VAUCLUSE,9861,6347,410,5937,2008,t1,cantonales
11221,84,VAUCLUSE,14602,8187,311,7876,2008,t1,cantonales
11222,85,VENDEE,12796,9154,572,8582,2008,t1,cantonales
11223,85,VENDEE,15760,11524,415,11109,2008,t1,cantonales
11224,85,VENDEE,16516,11540,501,11039,2008,t1,cantonales
11225,85,VENDEE,6357,4921,244,4677,2008,t1,cantonales
11226,85,VENDEE,22516,15962,1335,14627,2008,t1,cantonales
11227,85,VENDEE,20218,14034,447,13587,2008,t1,cantonales
11228,85,VENDEE,14042,9852,468,9384,2008,t1,cantonales
11229,85,VENDEE,12154,8894,442,8452,2008,t1,cantonales
11230,85,VENDEE,8808,6242,156,6086,2008,t1,cantonales
11231,85,VENDEE,7883,5781,227,5554,2008,t1,cantonales
11232,85,VENDEE,16851,12895,640,12255,2008,t1,cantonales
11233,85,VENDEE,35867,24909,828,24081,2008,t1,cantonales
11234,85,VENDEE,7181,5498,239,5259,2008,t1,cantonales
11235,85,VENDEE,14634,9689,401,9288,2008,t1,cantonales
11236,85,VENDEE,32675,21586,673,20913,2008,t1,cantonales
11237,86,VIENNE,2398,1987,80,1907,2008,t1,cantonales
11238,86,VIENNE,11423,6724,260,6464,2008,t1,cantonales
11239,86,VIENNE,7515,5470,201,5269,2008,t1,cantonales
11240,86,VIENNE,6428,4777,253,4524,2008,t1,cantonales
11241,86,VIENNE,4132,3291,145,3146,2008,t1,cantonales
11242,86,VIENNE,6975,4916,188,4728,2008,t1,cantonales
11243,86,VIENNE,8078,6266,277,5989,2008,t1,cantonales
11244,86,VIENNE,3006,2482,132,2350,2008,t1,cantonales
11245,86,VIENNE,10183,6572,235,6337,2008,t1,cantonales
11246,86,VIENNE,12329,7231,311,6920,2008,t1,cantonales
11247,86,VIENNE,9780,6634,230,6404,2008,t1,cantonales
11248,86,VIENNE,4176,3345,177,3168,2008,t1,cantonales
11249,86,VIENNE,10594,7818,288,7530,2008,t1,cantonales
11250,86,VIENNE,6778,4834,150,4684,2008,t1,cantonales
11251,86,VIENNE,8501,6094,245,5849,2008,t1,cantonales
11252,86,VIENNE,12176,7158,256,6902,2008,t1,cantonales
11253,86,VIENNE,12570,8342,252,8090,2008,t1,cantonales
11254,86,VIENNE,8792,5101,148,4953,2008,t1,cantonales
11255,86,VIENNE,15198,8696,468,8228,2008,t1,cantonales
11256,87,HAUTE VIENNE,4473,3397,235,3162,2008,t1,cantonales
11257,87,HAUTE VIENNE,4504,3546,553,2993,2008,t1,cantonales
11258,87,HAUTE VIENNE,4664,3723,214,3509,2008,t1,cantonales
11259,87,HAUTE VIENNE,3683,2828,65,2763,2008,t1,cantonales
11260,87,HAUTE VIENNE,2951,2314,124,2190,2008,t1,cantonales
11261,87,HAUTE VIENNE,4536,2780,116,2664,2008,t1,cantonales
11262,87,HAUTE VIENNE,4239,2364,77,2287,2008,t1,cantonales
11263,87,HAUTE VIENNE,2976,2386,100,2286,2008,t1,cantonales
11264,87,HAUTE VIENNE,5849,4401,403,3998,2008,t1,cantonales
11265,87,HAUTE VIENNE,7718,5613,271,5342,2008,t1,cantonales
11266,87,HAUTE VIENNE,3293,2566,119,2447,2008,t1,cantonales
11267,87,HAUTE VIENNE,6535,5105,205,4900,2008,t1,cantonales
11268,87,HAUTE VIENNE,4162,3143,222,2921,2008,t1,cantonales
11269,87,HAUTE VIENNE,2677,2181,90,2091,2008,t1,cantonales
11270,87,HAUTE VIENNE,8646,6337,728,5609,2008,t1,cantonales
11271,87,HAUTE VIENNE,8117,5024,230,4794,2008,t1,cantonales
11272,87,HAUTE VIENNE,4126,2424,101,2323,2008,t1,cantonales
11273,87,HAUTE VIENNE,13297,8804,437,8367,2008,t1,cantonales
11274,87,HAUTE VIENNE,6389,4470,313,4157,2008,t1,cantonales
11275,87,HAUTE VIENNE,5407,3235,141,3094,2008,t1,cantonales
11276,87,HAUTE VIENNE,4606,3029,238,2791,2008,t1,cantonales
11277,88,VOSGES,2999,2437,63,2374,2008,t1,cantonales
11278,88,VOSGES,4548,3829,167,3662,2008,t1,cantonales
11279,88,VOSGES,9049,6344,257,6087,2008,t1,cantonales
11280,88,VOSGES,5870,4368,209,4159,2008,t1,cantonales
11281,88,VOSGES,3436,2648,578,2070,2008,t1,cantonales
11282,88,VOSGES,3911,3058,235,2823,2008,t1,cantonales
11283,88,VOSGES,4218,3445,272,3173,2008,t1,cantonales
11284,88,VOSGES,5911,4427,362,4065,2008,t1,cantonales
11285,88,VOSGES,1967,1556,100,1456,2008,t1,cantonales
11286,88,VOSGES,9764,7304,301,7003,2008,t1,cantonales
11287,88,VOSGES,9058,6143,234,5909,2008,t1,cantonales
11288,88,VOSGES,25240,17220,1015,16205,2008,t1,cantonales
11289,88,VOSGES,7929,5479,209,5270,2008,t1,cantonales
11290,88,VOSGES,10209,7245,360,6885,2008,t1,cantonales
11291,88,VOSGES,24955,16010,1028,14982,2008,t1,cantonales
11292,88,VOSGES,13091,8420,387,8033,2008,t1,cantonales
11293,89,YONNE,7717,5381,223,5158,2008,t1,cantonales
11294,89,YONNE,4353,3304,141,3163,2008,t1,cantonales
11295,89,YONNE,5953,2877,97,2780,2008,t1,cantonales
11296,89,YONNE,5661,4002,370,3632,2008,t1,cantonales
11297,89,YONNE,4673,3310,155,3155,2008,t1,cantonales
11298,89,YONNE,6664,4721,273,4448,2008,t1,cantonales
11299,89,YONNE,2671,2004,67,1937,2008,t1,cantonales
11300,89,YONNE,2490,1969,71,1898,2008,t1,cantonales
11301,89,YONNE,2371,1913,89,1824,2008,t1,cantonales
11302,89,YONNE,10249,6393,216,6177,2008,t1,cantonales
11303,89,YONNE,2469,2055,89,1966,2008,t1,cantonales
11304,89,YONNE,2419,1805,88,1717,2008,t1,cantonales
11305,89,YONNE,4191,2801,113,2688,2008,t1,cantonales
11306,89,YONNE,4089,3023,146,2877,2008,t1,cantonales
11307,89,YONNE,15384,8916,446,8470,2008,t1,cantonales
11308,89,YONNE,5555,3831,158,3673,2008,t1,cantonales
11309,89,YONNE,7648,5467,338,5129,2008,t1,cantonales
11310,89,YONNE,4709,3387,128,3259,2008,t1,cantonales
11311,89,YONNE,7190,4507,218,4289,2008,t1,cantonales
11312,89,YONNE,9168,5846,181,5665,2008,t1,cantonales
11313,90,TERRITOIRE DE BELFORT,7562,5056,235,4821,2008,t1,cantonales
11314,90,TERRITOIRE DE BELFORT,5836,4642,330,4312,2008,t1,cantonales
11315,90,TERRITOIRE DE BELFORT,9776,6922,319,6603,2008,t1,cantonales
11316,90,TERRITOIRE DE BELFORT,4132,3139,155,2984,2008,t1,cantonales
11317,90,TERRITOIRE DE BELFORT,5139,3728,113,3615,2008,t1,cantonales
11318,90,TERRITOIRE DE BELFORT,6883,4973,336,4637,2008,t1,cantonales
11319,90,TERRITOIRE DE BELFORT,4602,2553,125,2428,2008,t1,cantonales
11320,91,ESSONNE,19951,12334,279,12055,2008,t1,cantonales
11321,91,ESSONNE,22538,12994,405,12589,2008,t1,cantonales
11322,91,ESSONNE,17092,8928,188,8740,2008,t1,cantonales
11323,91,ESSONNE,19770,12379,370,12009,2008,t1,cantonales
11324,91,ESSONNE,16579,10133,382,9751,2008,t1,cantonales
11325,91,ESSONNE,16974,11494,425,11069,2008,t1,cantonales
11326,91,ESSONNE,27499,15404,570,14834,2008,t1,cantonales
11327,91,ESSONNE,26377,16034,608,15426,2008,t1,cantonales
11328,91,ESSONNE,15209,9591,170,9421,2008,t1,cantonales
11329,91,ESSONNE,27213,15734,331,15403,2008,t1,cantonales
11330,91,ESSONNE,15443,8364,147,8217,2008,t1,cantonales
11331,91,ESSONNE,18570,11372,465,10907,2008,t1,cantonales
11332,91,ESSONNE,16859,9249,280,8969,2008,t1,cantonales
11333,91,ESSONNE,18625,9973,217,9756,2008,t1,cantonales
11334,91,ESSONNE,23129,14309,336,13973,2008,t1,cantonales
11335,91,ESSONNE,12534,7290,141,7149,2008,t1,cantonales
11336,91,ESSONNE,15180,9914,248,9666,2008,t1,cantonales
11337,91,ESSONNE,25796,15844,410,15434,2008,t1,cantonales
11338,91,ESSONNE,10897,6289,145,6144,2008,t1,cantonales
11339,91,ESSONNE,20007,10469,239,10230,2008,t1,cantonales
11340,91,ESSONNE,12471,6960,157,6803,2008,t1,cantonales
11341,92,HAUTS DE SEINE,30836,17438,696,16742,2008,t1,cantonales
11342,92,HAUTS DE SEINE,20262,11114,360,10754,2008,t1,cantonales
11343,92,HAUTS DE SEINE,20328,10915,369,10546,2008,t1,cantonales
11344,92,HAUTS DE SEINE,16400,8785,248,8537,2008,t1,cantonales
11345,92,HAUTS DE SEINE,17656,9234,267,8967,2008,t1,cantonales
11346,92,HAUTS DE SEINE,26223,13353,583,12770,2008,t1,cantonales
11347,92,HAUTS DE SEINE,21725,13781,241,13540,2008,t1,cantonales
11348,92,HAUTS DE SEINE,22541,12161,312,11849,2008,t1,cantonales
11349,92,HAUTS DE SEINE,18560,11325,276,11049,2008,t1,cantonales
11350,92,HAUTS DE SEINE,19827,10415,566,9849,2008,t1,cantonales
11351,92,HAUTS DE SEINE,28819,14915,442,14473,2008,t1,cantonales
11352,92,HAUTS DE SEINE,25214,13590,861,12729,2008,t1,cantonales
11353,92,HAUTS DE SEINE,19451,10832,308,10524,2008,t1,cantonales
11354,92,HAUTS DE SEINE,18559,10864,159,10705,2008,t1,cantonales
11355,92,HAUTS DE SEINE,16941,8919,173,8746,2008,t1,cantonales
11356,92,HAUTS DE SEINE,17127,9093,609,8484,2008,t1,cantonales
11357,92,HAUTS DE SEINE,28914,17993,404,17589,2008,t1,cantonales
11358,92,HAUTS DE SEINE,14222,8114,242,7872,2008,t1,cantonales
11359,92,HAUTS DE SEINE,24216,13783,581,13202,2008,t1,cantonales
11360,92,HAUTS DE SEINE,13028,5951,159,5792,2008,t1,cantonales
11361,92,HAUTS DE SEINE,13116,7452,433,7019,2008,t1,cantonales
11362,92,HAUTS DE SEINE,15558,9333,158,9175,2008,t1,cantonales
11363,92,HAUTS DE SEINE,9391,4818,165,4653,2008,t1,cantonales
11364,93,SEINE SAINT-DENIS,10088,4649,133,4516,2008,t1,cantonales
11365,93,SEINE SAINT-DENIS,16081,8945,331,8614,2008,t1,cantonales
11366,93,SEINE SAINT-DENIS,16248,8348,321,8027,2008,t1,cantonales
11367,93,SEINE SAINT-DENIS,24098,12046,367,11679,2008,t1,cantonales
11368,93,SEINE SAINT-DENIS,20326,9248,319,8929,2008,t1,cantonales
11369,93,SEINE SAINT-DENIS,12027,6358,261,6097,2008,t1,cantonales
11370,93,SEINE SAINT-DENIS,26170,13704,382,13322,2008,t1,cantonales
11371,93,SEINE SAINT-DENIS,23432,12422,422,12000,2008,t1,cantonales
11372,93,SEINE SAINT-DENIS,17409,8790,416,8374,2008,t1,cantonales
11373,93,SEINE SAINT-DENIS,12641,6945,168,6777,2008,t1,cantonales
11374,93,SEINE SAINT-DENIS,18325,10032,278,9754,2008,t1,cantonales
11375,93,SEINE SAINT-DENIS,12120,6217,178,6039,2008,t1,cantonales
11376,93,SEINE SAINT-DENIS,21051,8780,319,8461,2008,t1,cantonales
11377,93,SEINE SAINT-DENIS,15175,7799,302,7497,2008,t1,cantonales
11378,93,SEINE SAINT-DENIS,15779,6906,597,6309,2008,t1,cantonales
11379,93,SEINE SAINT-DENIS,20221,9915,270,9645,2008,t1,cantonales
11380,93,SEINE SAINT-DENIS,15141,8451,457,7994,2008,t1,cantonales
11381,93,SEINE SAINT-DENIS,12365,6027,300,5727,2008,t1,cantonales
11382,93,SEINE SAINT-DENIS,16179,8250,415,7835,2008,t1,cantonales
11383,93,SEINE SAINT-DENIS,18420,9479,352,9127,2008,t1,cantonales
11384,94,VAL DE MARNE,13075,7183,253,6930,2008,t1,cantonales
11385,94,VAL DE MARNE,18714,10306,303,10003,2008,t1,cantonales
11386,94,VAL DE MARNE,15208,7909,357,7552,2008,t1,cantonales
11387,94,VAL DE MARNE,10337,5958,87,5871,2008,t1,cantonales
11388,94,VAL DE MARNE,13947,7284,177,7107,2008,t1,cantonales
11389,94,VAL DE MARNE,18896,10569,231,10338,2008,t1,cantonales
11390,94,VAL DE MARNE,11978,6428,112,6316,2008,t1,cantonales
11391,94,VAL DE MARNE,19404,10305,232,10073,2008,t1,cantonales
11392,94,VAL DE MARNE,11026,6387,168,6219,2008,t1,cantonales
11393,94,VAL DE MARNE,14410,7340,225,7115,2008,t1,cantonales
11394,94,VAL DE MARNE,16533,8999,156,8843,2008,t1,cantonales
11395,94,VAL DE MARNE,17026,9785,293,9492,2008,t1,cantonales
11396,94,VAL DE MARNE,13487,7710,280,7430,2008,t1,cantonales
11397,94,VAL DE MARNE,16550,8887,111,8776,2008,t1,cantonales
11398,94,VAL DE MARNE,14400,7692,180,7512,2008,t1,cantonales
11399,94,VAL DE MARNE,14258,6651,287,6364,2008,t1,cantonales
11400,94,VAL DE MARNE,15445,6954,182,6772,2008,t1,cantonales
11401,94,VAL DE MARNE,12446,6228,164,6064,2008,t1,cantonales
11402,94,VAL DE MARNE,14713,7450,151,7299,2008,t1,cantonales
11403,94,VAL DE MARNE,26451,14763,308,14455,2008,t1,cantonales
11404,94,VAL DE MARNE,16278,9060,216,8844,2008,t1,cantonales
11405,94,VAL DE MARNE,12161,7140,131,7009,2008,t1,cantonales
11406,94,VAL DE MARNE,16849,9365,205,9160,2008,t1,cantonales
11407,94,VAL DE MARNE,14425,6904,186,6718,2008,t1,cantonales
11408,95,VAL D'OISE,19455,10432,233,10199,2008,t1,cantonales
11409,95,VAL D'OISE,13690,7119,180,6939,2008,t1,cantonales
11410,95,VAL D'OISE,24076,12887,339,12548,2008,t1,cantonales
11411,95,VAL D'OISE,15244,8919,229,8690,2008,t1,cantonales
11412,95,VAL D'OISE,28321,14629,260,14369,2008,t1,cantonales
11413,95,VAL D'OISE,17329,9141,217,8924,2008,t1,cantonales
11414,95,VAL D'OISE,6361,3038,111,2927,2008,t1,cantonales
11415,95,VAL D'OISE,18250,11305,311,10994,2008,t1,cantonales
11416,95,VAL D'OISE,24686,14839,613,14226,2008,t1,cantonales
11417,95,VAL D'OISE,16084,8312,205,8107,2008,t1,cantonales
11418,95,VAL D'OISE,17072,10358,179,10179,2008,t1,cantonales
11419,95,VAL D'OISE,14913,7988,135,7853,2008,t1,cantonales
11420,95,VAL D'OISE,24328,13249,332,12917,2008,t1,cantonales
11421,95,VAL D'OISE,8054,5708,155,5553,2008,t1,cantonales
11422,95,VAL D'OISE,41627,21203,509,20694,2008,t1,cantonales
11423,95,VAL D'OISE,20568,10449,287,10162,2008,t1,cantonales
11424,95,VAL D'OISE,20086,9861,183,9678,2008,t1,cantonales
11425,95,VAL D'OISE,29921,16703,412,16291,2008,t1,cantonales
11426,95,VAL D'OISE,29756,16820,1000,15820,2008,t1,cantonales
11427,95,VAL D'OISE,13326,6570,121,6449,2008,t1,cantonales
11428,971,GUADELOUPE,6052,2922,290,2632,2008,t1,cantonales
11429,971,GUADELOUPE,5359,3359,301,3058,2008,t1,cantonales
11430,971,GUADELOUPE,3718,2207,157,2050,2008,t1,cantonales
11431,971,GUADELOUPE,6321,4019,234,3785,2008,t1,cantonales
11432,971,GUADELOUPE,1744,1274,75,1199,2008,t1,cantonales
11433,971,GUADELOUPE,8131,4123,301,3822,2008,t1,cantonales
11434,971,GUADELOUPE,5108,2889,208,2681,2008,t1,cantonales
11435,971,GUADELOUPE,5639,3782,224,3558,2008,t1,cantonales
11436,971,GUADELOUPE,9547,6714,281,6433,2008,t1,cantonales
11437,971,GUADELOUPE,3107,1691,189,1502,2008,t1,cantonales
11438,971,GUADELOUPE,10519,5981,380,5601,2008,t1,cantonales
11439,971,GUADELOUPE,6876,4045,315,3730,2008,t1,cantonales
11440,971,GUADELOUPE,10731,6716,372,6344,2008,t1,cantonales
11441,971,GUADELOUPE,5912,4132,217,3915,2008,t1,cantonales
11442,971,GUADELOUPE,3113,2676,52,2624,2008,t1,cantonales
11443,971,GUADELOUPE,11265,7571,849,6722,2008,t1,cantonales
11444,971,GUADELOUPE,8100,5152,468,4684,2008,t1,cantonales
11445,971,GUADELOUPE,7540,3973,484,3489,2008,t1,cantonales
11446,971,GUADELOUPE,5971,3679,321,3358,2008,t1,cantonales
11447,971,GUADELOUPE,10152,6067,498,5569,2008,t1,cantonales
11448,971,GUADELOUPE,5337,3231,295,2936,2008,t1,cantonales
11449,972,MARTINIQUE,1447,1092,59,1033,2008,t1,cantonales
11450,972,MARTINIQUE,3349,2429,80,2349,2008,t1,cantonales
11451,972,MARTINIQUE,3569,2409,206,2203,2008,t1,cantonales
11452,972,MARTINIQUE,4510,3290,114,3176,2008,t1,cantonales
11453,972,MARTINIQUE,3957,2818,172,2646,2008,t1,cantonales
11454,972,MARTINIQUE,4269,3025,105,2920,2008,t1,cantonales
11455,972,MARTINIQUE,5849,2439,201,2238,2008,t1,cantonales
11456,972,MARTINIQUE,2784,1199,111,1088,2008,t1,cantonales
11457,972,MARTINIQUE,8326,4642,264,4378,2008,t1,cantonales
11458,972,MARTINIQUE,7996,5095,375,4720,2008,t1,cantonales
11459,972,MARTINIQUE,6063,3005,314,2691,2008,t1,cantonales
11460,972,MARTINIQUE,6414,4128,169,3959,2008,t1,cantonales
11461,972,MARTINIQUE,4492,3092,227,2865,2008,t1,cantonales
11462,972,MARTINIQUE,6807,4374,172,4202,2008,t1,cantonales
11463,972,MARTINIQUE,11398,6921,245,6676,2008,t1,cantonales
11464,972,MARTINIQUE,5036,3180,115,3065,2008,t1,cantonales
11465,972,MARTINIQUE,3923,3026,137,2889,2008,t1,cantonales
11466,972,MARTINIQUE,6597,4694,183,4511,2008,t1,cantonales
11467,972,MARTINIQUE,4444,1892,182,1710,2008,t1,cantonales
11468,972,MARTINIQUE,13038,5622,538,5084,2008,t1,cantonales
11469,972,MARTINIQUE,7896,3615,139,3476,2008,t1,cantonales
11470,972,MARTINIQUE,7424,3850,435,3415,2008,t1,cantonales
11471,973,GUYANE,1903,894,52,842,2008,t1,cantonales
11472,973,GUYANE,3340,1596,131,1465,2008,t1,cantonales
11473,973,GUYANE,5749,2615,419,2196,2008,t1,cantonales
11474,973,GUYANE,3661,2385,107,2278,2008,t1,cantonales
11475,973,GUYANE,5726,3448,123,3325,2008,t1,cantonales
11476,973,GUYANE,1785,1139,59,1080,2008,t1,cantonales
11477,973,GUYANE,895,586,20,566,2008,t1,cantonales
11478,973,GUYANE,2898,1345,123,1222,2008,t1,cantonales
11479,973,GUYANE,3169,1597,190,1407,2008,t1,cantonales
11480,973,GUYANE,7889,4394,262,4132,2008,t1,cantonales
11481,974,LA REUNION,8045,5794,151,5643,2008,t1,cantonales
11482,974,LA REUNION,4656,3709,167,3542,2008,t1,cantonales
11483,974,LA REUNION,8926,6818,330,6488,2008,t1,cantonales
11484,974,LA REUNION,3455,2780,71,2709,2008,t1,cantonales
11485,974,LA REUNION,12458,8094,492,7602,2008,t1,cantonales
11486,974,LA REUNION,7330,4219,181,4038,2008,t1,cantonales
11487,974,LA REUNION,8648,5075,235,4840,2008,t1,cantonales
11488,974,LA REUNION,8517,4778,352,4426,2008,t1,cantonales
11489,974,LA REUNION,9914,7265,288,6977,2008,t1,cantonales
11490,974,LA REUNION,10069,6892,377,6515,2008,t1,cantonales
11491,974,LA REUNION,12842,8103,495,7608,2008,t1,cantonales
11492,974,LA REUNION,15239,10582,660,9922,2008,t1,cantonales
11493,974,LA REUNION,10481,6594,413,6181,2008,t1,cantonales
11494,974,LA REUNION,12406,8497,721,7776,2008,t1,cantonales
11495,974,LA REUNION,5448,4488,123,4365,2008,t1,cantonales
11496,974,LA REUNION,14527,9951,859,9092,2008,t1,cantonales
11497,974,LA REUNION,5329,3926,110,3816,2008,t1,cantonales
11498,974,LA REUNION,9060,4703,308,4395,2008,t1,cantonales
11499,974,LA REUNION,9091,5069,325,4744,2008,t1,cantonales
11500,974,LA REUNION,9049,5151,308,4843,2008,t1,cantonales
11501,974,LA REUNION,12924,6904,562,6342,2008,t1,cantonales
11502,974,LA REUNION,15195,10120,674,9446,2008,t1,cantonales
11503,974,LA REUNION,11986,8337,727,7610,2008,t1,cantonales
11504,974,LA REUNION,8949,6065,367,5698,2008,t1,cantonales
11505,985,MAYOTTE,2926,1887,70,1817,2008,t1,cantonales
11506,985,MAYOTTE,3488,2431,47,2384,2008,t1,cantonales
11507,985,MAYOTTE,2289,1672,61,1611,2008,t1,cantonales
11508,985,MAYOTTE,5129,2478,59,2419,2008,t1,cantonales
11509,985,MAYOTTE,3522,1623,56,1567,2008,t1,cantonales
11510,985,MAYOTTE,4023,2099,66,2033,2008,t1,cantonales
11511,985,MAYOTTE,3470,1757,38,1719,2008,t1,cantonales
11512,985,MAYOTTE,4498,2800,88,2712,2008,t1,cantonales
11513,985,MAYOTTE,4684,2745,76,2669,2008,t1,cantonales
11514,985,MAYOTTE,3540,1926,63,1863,2008,t1,cantonales
11515,1,AIN,9788,6386,237,6149,2004,t1,cantonales
11516,1,AIN,9983,5825,136,5689,2004,t1,cantonales
11517,1,AIN,10953,7081,321,6760,2004,t1,cantonales
11518,1,AIN,11337,6972,302,6670,2004,t1,cantonales
11519,1,AIN,4739,2991,185,2806,2004,t1,cantonales
11520,1,AIN,14488,7634,231,7403,2004,t1,cantonales
11521,1,AIN,3410,2300,86,2214,2004,t1,cantonales
11522,1,AIN,3798,2529,72,2457,2004,t1,cantonales
11523,1,AIN,12506,7892,201,7691,2004,t1,cantonales
11524,1,AIN,7282,4384,178,4206,2004,t1,cantonales
11525,1,AIN,4558,2899,127,2772,2004,t1,cantonales
11526,1,AIN,8370,5344,203,5141,2004,t1,cantonales
11527,1,AIN,8054,4901,210,4691,2004,t1,cantonales
11528,1,AIN,4094,2622,88,2534,2004,t1,cantonales
11529,1,AIN,3714,2300,71,2229,2004,t1,cantonales
11530,1,AIN,8937,5295,217,5078,2004,t1,cantonales
11531,1,AIN,10996,6702,222,6480,2004,t1,cantonales
11532,1,AIN,6107,3869,103,3766,2004,t1,cantonales
11533,1,AIN,3065,2076,82,1994,2004,t1,cantonales
11534,1,AIN,9122,5758,146,5612,2004,t1,cantonales
11535,1,AIN,12804,7765,172,7593,2004,t1,cantonales
11536,1,AIN,11054,7351,201,7150,2004,t1,cantonales
11537,2,AISNE,7165,4650,185,4465,2004,t1,cantonales
11538,2,AISNE,10119,6679,282,6397,2004,t1,cantonales
11539,2,AISNE,7755,5111,161,4950,2004,t1,cantonales
11540,2,AISNE,6292,4273,214,4059,2004,t1,cantonales
11541,2,AISNE,18854,11506,387,11119,2004,t1,cantonales
11542,2,AISNE,16801,10291,305,9986,2004,t1,cantonales
11543,2,AISNE,4062,2960,82,2878,2004,t1,cantonales
11544,2,AISNE,6301,4257,150,4107,2004,t1,cantonales
11545,2,AISNE,9753,5944,210,5734,2004,t1,cantonales
11546,2,AISNE,5265,4019,140,3879,2004,t1,cantonales
11547,2,AISNE,6803,4409,178,4231,2004,t1,cantonales
11548,2,AISNE,4922,3314,183,3131,2004,t1,cantonales
11549,2,AISNE,6345,4285,186,4099,2004,t1,cantonales
11550,2,AISNE,3374,2491,120,2371,2004,t1,cantonales
11551,2,AISNE,12293,7469,336,7133,2004,t1,cantonales
11552,2,AISNE,7328,5008,183,4825,2004,t1,cantonales
11553,2,AISNE,7150,4804,161,4643,2004,t1,cantonales
11554,2,AISNE,7129,4972,239,4733,2004,t1,cantonales
11555,2,AISNE,6194,4353,172,4181,2004,t1,cantonales
11556,2,AISNE,7671,5112,223,4889,2004,t1,cantonales
11557,2,AISNE,15952,9875,355,9520,2004,t1,cantonales
11558,3,ALLIER,4954,3529,136,3393,2004,t1,cantonales
11559,3,ALLIER,5061,3440,172,3268,2004,t1,cantonales
11560,3,ALLIER,4249,2983,101,2882,2004,t1,cantonales
11561,3,ALLIER,8984,5944,355,5589,2004,t1,cantonales
11562,3,ALLIER,6947,4354,254,4100,2004,t1,cantonales
11563,3,ALLIER,14661,9548,480,9068,2004,t1,cantonales
11564,3,ALLIER,7051,4901,274,4627,2004,t1,cantonales
11565,3,ALLIER,3647,2405,116,2289,2004,t1,cantonales
11566,3,ALLIER,4634,3186,123,3063,2004,t1,cantonales
11567,3,ALLIER,3971,2768,134,2634,2004,t1,cantonales
11568,3,ALLIER,3918,2864,112,2752,2004,t1,cantonales
11569,3,ALLIER,9021,5497,253,5244,2004,t1,cantonales
11570,3,ALLIER,11128,6592,264,6328,2004,t1,cantonales
11571,3,ALLIER,5080,3583,141,3442,2004,t1,cantonales
11572,3,ALLIER,8263,4728,187,4541,2004,t1,cantonales
11573,3,ALLIER,12105,7884,397,7487,2004,t1,cantonales
11574,3,ALLIER,8915,5633,256,5377,2004,t1,cantonales
11575,3,ALLIER,10241,6799,362,6437,2004,t1,cantonales
11576,4,ALPES DE HAUTE PROVENCE,1901,1460,55,1405,2004,t1,cantonales
11577,4,ALPES DE HAUTE PROVENCE,2261,1764,29,1735,2004,t1,cantonales
11578,4,ALPES DE HAUTE PROVENCE,5194,3507,152,3355,2004,t1,cantonales
11579,4,ALPES DE HAUTE PROVENCE,1207,954,27,927,2004,t1,cantonales
11580,4,ALPES DE HAUTE PROVENCE,1948,1521,33,1488,2004,t1,cantonales
11581,4,ALPES DE HAUTE PROVENCE,9416,6557,262,6295,2004,t1,cantonales
11582,4,ALPES DE HAUTE PROVENCE,1539,1198,47,1151,2004,t1,cantonales
11583,4,ALPES DE HAUTE PROVENCE,7960,5290,202,5088,2004,t1,cantonales
11584,4,ALPES DE HAUTE PROVENCE,1568,1294,22,1272,2004,t1,cantonales
11585,4,ALPES DE HAUTE PROVENCE,983,830,14,816,2004,t1,cantonales
11586,4,ALPES DE HAUTE PROVENCE,2805,2184,79,2105,2004,t1,cantonales
11587,4,ALPES DE HAUTE PROVENCE,3853,2913,83,2830,2004,t1,cantonales
11588,4,ALPES DE HAUTE PROVENCE,1310,961,72,889,2004,t1,cantonales
11589,4,ALPES DE HAUTE PROVENCE,4323,3125,76,3049,2004,t1,cantonales
11590,4,ALPES DE HAUTE PROVENCE,8000,5834,242,5592,2004,t1,cantonales
11591,4,ALPES DE HAUTE PROVENCE,5362,3827,176,3651,2004,t1,cantonales
11592,5,HAUTES ALPES,1903,1443,36,1407,2004,t1,cantonales
11593,5,HAUTES ALPES,4719,3389,141,3248,2004,t1,cantonales
11594,5,HAUTES ALPES,3103,2457,108,2349,2004,t1,cantonales
11595,5,HAUTES ALPES,3517,2371,96,2275,2004,t1,cantonales
11596,5,HAUTES ALPES,3165,2449,98,2351,2004,t1,cantonales
11597,5,HAUTES ALPES,3184,2093,125,1968,2004,t1,cantonales
11598,5,HAUTES ALPES,975,826,14,812,2004,t1,cantonales
11599,5,HAUTES ALPES,5517,4208,165,4043,2004,t1,cantonales
11600,5,HAUTES ALPES,1637,1185,145,1040,2004,t1,cantonales
11601,5,HAUTES ALPES,1413,1092,26,1066,2004,t1,cantonales
11602,5,HAUTES ALPES,2020,1593,39,1554,2004,t1,cantonales
11603,5,HAUTES ALPES,4161,3395,75,3320,2004,t1,cantonales
11604,5,HAUTES ALPES,3269,2412,134,2278,2004,t1,cantonales
11605,5,HAUTES ALPES,5170,3331,135,3196,2004,t1,cantonales
11606,5,HAUTES ALPES,5986,3701,186,3515,2004,t1,cantonales
11607,6,ALPES MARITIMES,23700,14317,508,13809,2004,t1,cantonales
11608,6,ALPES MARITIMES,1988,1456,32,1424,2004,t1,cantonales
11609,6,ALPES MARITIMES,6818,4656,170,4486,2004,t1,cantonales
11610,6,ALPES MARITIMES,18668,10983,421,10562,2004,t1,cantonales
11611,6,ALPES MARITIMES,3075,2249,78,2171,2004,t1,cantonales
11612,6,ALPES MARITIMES,14204,9687,300,9387,2004,t1,cantonales
11613,6,ALPES MARITIMES,19350,11789,429,11360,2004,t1,cantonales
11614,6,ALPES MARITIMES,2444,1866,94,1772,2004,t1,cantonales
11615,6,ALPES MARITIMES,2709,2112,55,2057,2004,t1,cantonales
11616,6,ALPES MARITIMES,1618,1215,37,1178,2004,t1,cantonales
11617,6,ALPES MARITIMES,13873,9112,301,8811,2004,t1,cantonales
11618,6,ALPES MARITIMES,2248,1876,35,1841,2004,t1,cantonales
11619,6,ALPES MARITIMES,2598,1951,67,1884,2004,t1,cantonales
11620,6,ALPES MARITIMES,16183,9521,438,9083,2004,t1,cantonales
11621,6,ALPES MARITIMES,17240,10052,332,9720,2004,t1,cantonales
11622,6,ALPES MARITIMES,26516,15261,558,14703,2004,t1,cantonales
11623,6,ALPES MARITIMES,25236,14851,380,14471,2004,t1,cantonales
11624,6,ALPES MARITIMES,13703,7864,251,7613,2004,t1,cantonales
11625,6,ALPES MARITIMES,12842,7194,162,7032,2004,t1,cantonales
11626,6,ALPES MARITIMES,18258,10165,393,9772,2004,t1,cantonales
11627,6,ALPES MARITIMES,17956,10642,395,10247,2004,t1,cantonales
11628,6,ALPES MARITIMES,11227,6194,189,6005,2004,t1,cantonales
11629,6,ALPES MARITIMES,12880,7182,286,6896,2004,t1,cantonales
11630,6,ALPES MARITIMES,19006,10562,307,10255,2004,t1,cantonales
11631,6,ALPES MARITIMES,16652,9897,189,9708,2004,t1,cantonales
11632,6,ALPES MARITIMES,13508,7717,222,7495,2004,t1,cantonales
11633,7,ARDECHE,13072,7754,468,7286,2004,t1,cantonales
11634,7,ARDECHE,2415,1768,48,1720,2004,t1,cantonales
11635,7,ARDECHE,5355,3627,221,3406,2004,t1,cantonales
11636,7,ARDECHE,7168,5029,205,4824,2004,t1,cantonales
11637,7,ARDECHE,5106,3648,187,3461,2004,t1,cantonales
11638,7,ARDECHE,1824,1491,28,1463,2004,t1,cantonales
11639,7,ARDECHE,13429,8944,328,8616,2004,t1,cantonales
11640,7,ARDECHE,945,751,8,743,2004,t1,cantonales
11641,7,ARDECHE,3050,2300,63,2237,2004,t1,cantonales
11642,7,ARDECHE,2949,2245,81,2164,2004,t1,cantonales
11643,7,ARDECHE,2750,2092,86,2006,2004,t1,cantonales
11644,7,ARDECHE,933,680,13,667,2004,t1,cantonales
11645,7,ARDECHE,6584,4776,144,4632,2004,t1,cantonales
11646,7,ARDECHE,9697,6575,228,6347,2004,t1,cantonales
11647,7,ARDECHE,10470,7025,224,6801,2004,t1,cantonales
11648,7,ARDECHE,10668,6723,394,6329,2004,t1,cantonales
11649,8,ARDENNES,4841,2957,99,2858,2004,t1,cantonales
11650,8,ARDENNES,3321,2220,97,2123,2004,t1,cantonales
11651,8,ARDENNES,1700,1262,99,1163,2004,t1,cantonales
11652,8,ARDENNES,9032,5528,194,5334,2004,t1,cantonales
11653,8,ARDENNES,2157,1458,78,1380,2004,t1,cantonales
11654,8,ARDENNES,3386,2169,101,2068,2004,t1,cantonales
11655,8,ARDENNES,1888,1328,53,1275,2004,t1,cantonales
11656,8,ARDENNES,2900,2041,67,1974,2004,t1,cantonales
11657,8,ARDENNES,5572,3796,104,3692,2004,t1,cantonales
11658,8,ARDENNES,9373,5791,149,5642,2004,t1,cantonales
11659,8,ARDENNES,3168,2376,96,2280,2004,t1,cantonales
11660,8,ARDENNES,7250,4304,107,4197,2004,t1,cantonales
11661,8,ARDENNES,9031,5289,207,5082,2004,t1,cantonales
11662,8,ARDENNES,3074,2126,64,2062,2004,t1,cantonales
11663,8,ARDENNES,2879,1862,75,1787,2004,t1,cantonales
11664,8,ARDENNES,1097,796,47,749,2004,t1,cantonales
11665,8,ARDENNES,4602,3074,180,2894,2004,t1,cantonales
11666,8,ARDENNES,6482,4273,74,4199,2004,t1,cantonales
11667,9,ARIEGE,4246,3060,173,2887,2004,t1,cantonales
11668,9,ARIEGE,10324,6686,363,6323,2004,t1,cantonales
11669,9,ARIEGE,3408,2487,113,2374,2004,t1,cantonales
11670,9,ARIEGE,2725,1849,63,1786,2004,t1,cantonales
11671,9,ARIEGE,7173,4674,269,4405,2004,t1,cantonales
11672,9,ARIEGE,491,414,13,401,2004,t1,cantonales
11673,9,ARIEGE,1716,1399,52,1347,2004,t1,cantonales
11674,9,ARIEGE,7993,5312,257,5055,2004,t1,cantonales
11675,9,ARIEGE,6419,4489,281,4208,2004,t1,cantonales
11676,9,ARIEGE,1397,1089,26,1063,2004,t1,cantonales
11677,9,ARIEGE,8699,5975,311,5664,2004,t1,cantonales
11678,10,AUBE,6570,4220,156,4064,2004,t1,cantonales
11679,10,AUBE,7301,4800,188,4612,2004,t1,cantonales
11680,10,AUBE,5728,3926,141,3785,2004,t1,cantonales
11681,10,AUBE,4118,2850,77,2773,2004,t1,cantonales
11682,10,AUBE,4156,2809,69,2740,2004,t1,cantonales
11683,10,AUBE,4880,3249,145,3104,2004,t1,cantonales
11684,10,AUBE,2572,1753,100,1653,2004,t1,cantonales
11685,10,AUBE,7101,4371,185,4186,2004,t1,cantonales
11686,10,AUBE,2792,2108,80,2028,2004,t1,cantonales
11687,10,AUBE,2165,1416,117,1299,2004,t1,cantonales
11688,10,AUBE,9836,5815,144,5671,2004,t1,cantonales
11689,10,AUBE,8388,4345,119,4226,2004,t1,cantonales
11690,10,AUBE,2757,1809,66,1743,2004,t1,cantonales
11691,10,AUBE,6896,3937,112,3825,2004,t1,cantonales
11692,10,AUBE,5516,2789,58,2731,2004,t1,cantonales
11693,10,AUBE,10210,5990,188,5802,2004,t1,cantonales
11694,10,AUBE,5880,3481,123,3358,2004,t1,cantonales
11695,11,AUDE,3797,2979,128,2851,2004,t1,cantonales
11696,11,AUDE,5880,4495,193,4302,2004,t1,cantonales
11697,11,AUDE,1673,1271,51,1220,2004,t1,cantonales
11698,11,AUDE,1643,1227,50,1177,2004,t1,cantonales
11699,11,AUDE,12186,8280,409,7871,2004,t1,cantonales
11700,11,AUDE,6848,5111,178,4933,2004,t1,cantonales
11701,11,AUDE,2648,1922,119,1803,2004,t1,cantonales
11702,11,AUDE,3046,2304,114,2190,2004,t1,cantonales
11703,11,AUDE,17693,11918,948,10970,2004,t1,cantonales
11704,11,AUDE,3013,2327,98,2229,2004,t1,cantonales
11705,11,AUDE,2544,1988,117,1871,2004,t1,cantonales
11706,11,AUDE,13966,10121,458,9663,2004,t1,cantonales
11707,11,AUDE,1887,1494,67,1427,2004,t1,cantonales
11708,11,AUDE,13238,8807,444,8363,2004,t1,cantonales
11709,11,AUDE,9467,6818,373,6445,2004,t1,cantonales
11710,11,AUDE,1600,1262,120,1142,2004,t1,cantonales
11711,11,AUDE,1648,1304,77,1227,2004,t1,cantonales
11712,11,AUDE,5880,3952,190,3762,2004,t1,cantonales
11713,12,AVEYRON,2202,1756,72,1684,2004,t1,cantonales
11714,12,AVEYRON,5295,3768,382,3386,2004,t1,cantonales
11715,12,AVEYRON,1525,1172,111,1061,2004,t1,cantonales
11716,12,AVEYRON,2229,1666,56,1610,2004,t1,cantonales
11717,12,AVEYRON,2670,2137,59,2078,2004,t1,cantonales
11718,12,AVEYRON,2066,1678,48,1630,2004,t1,cantonales
11719,12,AVEYRON,3517,2592,299,2293,2004,t1,cantonales
11720,12,AVEYRON,7318,5627,165,5462,2004,t1,cantonales
11721,12,AVEYRON,5496,4251,232,4019,2004,t1,cantonales
11722,12,AVEYRON,2837,1959,74,1885,2004,t1,cantonales
11723,12,AVEYRON,3455,2730,81,2649,2004,t1,cantonales
11724,12,AVEYRON,2679,2084,132,1952,2004,t1,cantonales
11725,12,AVEYRON,4271,3548,116,3432,2004,t1,cantonales
11726,12,AVEYRON,5346,4056,232,3824,2004,t1,cantonales
11727,12,AVEYRON,8948,6177,276,5901,2004,t1,cantonales
11728,12,AVEYRON,9285,6976,544,6432,2004,t1,cantonales
11729,12,AVEYRON,2069,1655,29,1626,2004,t1,cantonales
11730,12,AVEYRON,3090,2499,87,2412,2004,t1,cantonales
11731,12,AVEYRON,1823,1517,38,1479,2004,t1,cantonales
11732,12,AVEYRON,3343,2617,129,2488,2004,t1,cantonales
11733,12,AVEYRON,1486,1230,37,1193,2004,t1,cantonales
11734,12,AVEYRON,12442,8188,448,7740,2004,t1,cantonales
11735,12,AVEYRON,13182,9162,548,8614,2004,t1,cantonales
11736,13,BOUCHES DU RHONE,40649,25562,725,24837,2004,t1,cantonales
11737,13,BOUCHES DU RHONE,16564,10658,366,10292,2004,t1,cantonales
11738,13,BOUCHES DU RHONE,21134,13087,539,12548,2004,t1,cantonales
11739,13,BOUCHES DU RHONE,28629,18062,517,17545,2004,t1,cantonales
11740,13,BOUCHES DU RHONE,15542,10183,347,9836,2004,t1,cantonales
11741,13,BOUCHES DU RHONE,17755,11890,378,11512,2004,t1,cantonales
11742,13,BOUCHES DU RHONE,16436,9991,325,9666,2004,t1,cantonales
11743,13,BOUCHES DU RHONE,17419,10414,259,10155,2004,t1,cantonales
11744,13,BOUCHES DU RHONE,15892,9708,265,9443,2004,t1,cantonales
11745,13,BOUCHES DU RHONE,16439,9298,277,9021,2004,t1,cantonales
11746,13,BOUCHES DU RHONE,20694,12415,332,12083,2004,t1,cantonales
11747,13,BOUCHES DU RHONE,17441,9987,313,9674,2004,t1,cantonales
11748,13,BOUCHES DU RHONE,12668,8425,323,8102,2004,t1,cantonales
11749,13,BOUCHES DU RHONE,5842,4187,114,4073,2004,t1,cantonales
11750,13,BOUCHES DU RHONE,11843,8028,348,7680,2004,t1,cantonales
11751,13,BOUCHES DU RHONE,12102,7821,333,7488,2004,t1,cantonales
11752,13,BOUCHES DU RHONE,20840,14092,548,13544,2004,t1,cantonales
11753,13,BOUCHES DU RHONE,24170,15898,521,15377,2004,t1,cantonales
11754,13,BOUCHES DU RHONE,25536,14842,532,14310,2004,t1,cantonales
11755,13,BOUCHES DU RHONE,16990,10439,347,10092,2004,t1,cantonales
11756,13,BOUCHES DU RHONE,22644,13316,436,12880,2004,t1,cantonales
11757,13,BOUCHES DU RHONE,16012,9476,331,9145,2004,t1,cantonales
11758,13,BOUCHES DU RHONE,21311,12970,386,12584,2004,t1,cantonales
11759,13,BOUCHES DU RHONE,33475,21446,649,20797,2004,t1,cantonales
11760,13,BOUCHES DU RHONE,30984,20179,637,19542,2004,t1,cantonales
11761,13,BOUCHES DU RHONE,30255,18582,607,17975,2004,t1,cantonales
11762,13,BOUCHES DU RHONE,21228,12669,416,12253,2004,t1,cantonales
11763,13,BOUCHES DU RHONE,28845,18124,692,17432,2004,t1,cantonales
11764,13,BOUCHES DU RHONE,17483,10690,342,10348,2004,t1,cantonales
11765,13,BOUCHES DU RHONE,21142,12696,315,12381,2004,t1,cantonales
11766,13,BOUCHES DU RHONE,18006,10811,350,10461,2004,t1,cantonales
11767,14,CALVADOS,5661,3741,200,3541,2004,t1,cantonales
11768,14,CALVADOS,7301,4439,201,4238,2004,t1,cantonales
11769,14,CALVADOS,14280,8690,335,8355,2004,t1,cantonales
11770,14,CALVADOS,6029,3915,170,3745,2004,t1,cantonales
11771,14,CALVADOS,15145,10054,499,9555,2004,t1,cantonales
11772,14,CALVADOS,9745,6600,370,6230,2004,t1,cantonales
11773,14,CALVADOS,10869,6934,220,6714,2004,t1,cantonales
11774,14,CALVADOS,3655,2360,87,2273,2004,t1,cantonales
11775,14,CALVADOS,4335,2762,136,2626,2004,t1,cantonales
11776,14,CALVADOS,6059,4132,161,3971,2004,t1,cantonales
11777,14,CALVADOS,14655,9759,373,9386,2004,t1,cantonales
11778,14,CALVADOS,10953,7057,303,6754,2004,t1,cantonales
11779,14,CALVADOS,7880,5258,198,5060,2004,t1,cantonales
11780,14,CALVADOS,6551,3928,194,3734,2004,t1,cantonales
11781,14,CALVADOS,9227,5862,252,5610,2004,t1,cantonales
11782,14,CALVADOS,8121,4779,256,4523,2004,t1,cantonales
11783,14,CALVADOS,4934,3207,133,3074,2004,t1,cantonales
11784,14,CALVADOS,7246,4459,241,4218,2004,t1,cantonales
11785,14,CALVADOS,10871,6677,164,6513,2004,t1,cantonales
11786,14,CALVADOS,6594,3925,113,3812,2004,t1,cantonales
11787,14,CALVADOS,9447,5514,196,5318,2004,t1,cantonales
11788,14,CALVADOS,13634,8434,360,8074,2004,t1,cantonales
11789,14,CALVADOS,9280,5508,397,5111,2004,t1,cantonales
11790,15,CANTAL,6176,3760,229,3531,2004,t1,cantonales
11791,15,CANTAL,2512,1942,73,1869,2004,t1,cantonales
11792,15,CANTAL,2149,1637,43,1594,2004,t1,cantonales
11793,15,CANTAL,2788,1841,80,1761,2004,t1,cantonales
11794,15,CANTAL,6224,4239,189,4050,2004,t1,cantonales
11795,15,CANTAL,5366,4063,194,3869,2004,t1,cantonales
11796,15,CANTAL,3987,2855,169,2686,2004,t1,cantonales
11797,15,CANTAL,5376,3803,190,3613,2004,t1,cantonales
11798,15,CANTAL,2231,1571,50,1521,2004,t1,cantonales
11799,15,CANTAL,5945,4002,328,3674,2004,t1,cantonales
11800,15,CANTAL,6679,4523,387,4136,2004,t1,cantonales
11801,15,CANTAL,4703,3509,145,3364,2004,t1,cantonales
11802,15,CANTAL,3344,2290,84,2206,2004,t1,cantonales
11803,15,CANTAL,6490,4557,166,4391,2004,t1,cantonales
11804,16,CHARENTE,4053,3068,166,2902,2004,t1,cantonales
11805,16,CHARENTE,7721,4794,183,4611,2004,t1,cantonales
11806,16,CHARENTE,8255,4938,161,4777,2004,t1,cantonales
11807,16,CHARENTE,2497,1844,75,1769,2004,t1,cantonales
11808,16,CHARENTE,3199,2187,123,2064,2004,t1,cantonales
11809,16,CHARENTE,11220,6958,298,6660,2004,t1,cantonales
11810,16,CHARENTE,3661,2677,134,2543,2004,t1,cantonales
11811,16,CHARENTE,5129,3583,184,3399,2004,t1,cantonales
11812,16,CHARENTE,8938,5810,277,5533,2004,t1,cantonales
11813,16,CHARENTE,9262,5821,288,5533,2004,t1,cantonales
11814,16,CHARENTE,5682,4113,230,3883,2004,t1,cantonales
11815,16,CHARENTE,3927,2661,118,2543,2004,t1,cantonales
11816,16,CHARENTE,6683,4689,237,4452,2004,t1,cantonales
11817,16,CHARENTE,6513,4378,195,4183,2004,t1,cantonales
11818,16,CHARENTE,8369,5710,273,5437,2004,t1,cantonales
11819,16,CHARENTE,9134,5709,324,5385,2004,t1,cantonales
11820,16,CHARENTE,6015,4150,137,4013,2004,t1,cantonales
11821,16,CHARENTE,9028,5389,190,5199,2004,t1,cantonales
11822,17,CHARENTE MARITIME,8036,5313,237,5076,2004,t1,cantonales
11823,17,CHARENTE MARITIME,4990,3333,124,3209,2004,t1,cantonales
11824,17,CHARENTE MARITIME,4998,3356,175,3181,2004,t1,cantonales
11825,17,CHARENTE MARITIME,3867,2610,72,2538,2004,t1,cantonales
11826,17,CHARENTE MARITIME,7829,4788,221,4567,2004,t1,cantonales
11827,17,CHARENTE MARITIME,9827,6126,222,5904,2004,t1,cantonales
11828,17,CHARENTE MARITIME,4928,3475,157,3318,2004,t1,cantonales
11829,17,CHARENTE MARITIME,4722,3132,133,2999,2004,t1,cantonales
11830,17,CHARENTE MARITIME,9036,6138,235,5903,2004,t1,cantonales
11831,17,CHARENTE MARITIME,9566,6088,196,5892,2004,t1,cantonales
11832,17,CHARENTE MARITIME,6817,3920,177,3743,2004,t1,cantonales
11833,17,CHARENTE MARITIME,6260,3742,119,3623,2004,t1,cantonales
11834,17,CHARENTE MARITIME,14365,8612,269,8343,2004,t1,cantonales
11835,17,CHARENTE MARITIME,5681,3783,108,3675,2004,t1,cantonales
11836,17,CHARENTE MARITIME,12293,7818,373,7445,2004,t1,cantonales
11837,17,CHARENTE MARITIME,9780,6531,197,6334,2004,t1,cantonales
11838,17,CHARENTE MARITIME,9888,6221,268,5953,2004,t1,cantonales
11839,17,CHARENTE MARITIME,10940,7147,342,6805,2004,t1,cantonales
11840,17,CHARENTE MARITIME,12140,7697,357,7340,2004,t1,cantonales
11841,17,CHARENTE MARITIME,10231,6726,223,6503,2004,t1,cantonales
11842,17,CHARENTE MARITIME,2518,1830,62,1768,2004,t1,cantonales
11843,17,CHARENTE MARITIME,5303,2978,96,2882,2004,t1,cantonales
11844,17,CHARENTE MARITIME,8643,5460,174,5286,2004,t1,cantonales
11845,17,CHARENTE MARITIME,15682,9614,323,9291,2004,t1,cantonales
11846,17,CHARENTE MARITIME,12121,7873,671,7202,2004,t1,cantonales
11847,17,CHARENTE MARITIME,9040,5292,197,5095,2004,t1,cantonales
11848,18,CHER,4233,2818,102,2716,2004,t1,cantonales
11849,18,CHER,6624,4571,168,4403,2004,t1,cantonales
11850,18,CHER,2122,1538,53,1485,2004,t1,cantonales
11851,18,CHER,3107,2148,140,2008,2004,t1,cantonales
11852,18,CHER,10322,6406,280,6126,2004,t1,cantonales
11853,18,CHER,2192,1495,78,1417,2004,t1,cantonales
11854,18,CHER,2793,1978,64,1914,2004,t1,cantonales
11855,18,CHER,7621,5002,205,4797,2004,t1,cantonales
11856,18,CHER,3221,2327,117,2210,2004,t1,cantonales
11857,18,CHER,8038,5047,229,4818,2004,t1,cantonales
11858,18,CHER,3516,2351,84,2267,2004,t1,cantonales
11859,18,CHER,12708,8451,304,8147,2004,t1,cantonales
11860,18,CHER,4146,2801,120,2681,2004,t1,cantonales
11861,18,CHER,2995,2082,73,2009,2004,t1,cantonales
11862,18,CHER,10943,6439,234,6205,2004,t1,cantonales
11863,18,CHER,14764,9196,409,8787,2004,t1,cantonales
11864,18,CHER,10035,5635,236,5399,2004,t1,cantonales
11865,18,CHER,7000,3865,172,3693,2004,t1,cantonales
11866,19,CORREZE,5307,3951,391,3560,2004,t1,cantonales
11867,19,CORREZE,6494,5107,225,4882,2004,t1,cantonales
11868,19,CORREZE,3355,2652,90,2562,2004,t1,cantonales
11869,19,CORREZE,2061,1675,76,1599,2004,t1,cantonales
11870,19,CORREZE,3049,2515,144,2371,2004,t1,cantonales
11871,19,CORREZE,8032,5937,352,5585,2004,t1,cantonales
11872,19,CORREZE,2131,1590,143,1447,2004,t1,cantonales
11873,19,CORREZE,4201,3309,176,3133,2004,t1,cantonales
11874,19,CORREZE,1663,1341,56,1285,2004,t1,cantonales
11875,19,CORREZE,8214,5803,295,5508,2004,t1,cantonales
11876,19,CORREZE,3188,2544,154,2390,2004,t1,cantonales
11877,19,CORREZE,2876,2307,115,2192,2004,t1,cantonales
11878,19,CORREZE,4384,3458,286,3172,2004,t1,cantonales
11879,19,CORREZE,5133,3624,200,3424,2004,t1,cantonales
11880,19,CORREZE,5413,4324,217,4107,2004,t1,cantonales
11881,19,CORREZE,5845,3132,133,2999,2004,t1,cantonales
11882,19,CORREZE,7253,4151,215,3936,2004,t1,cantonales
11883,19,CORREZE,10844,7408,481,6927,2004,t1,cantonales
11884,19,CORREZE,4470,3217,203,3014,2004,t1,cantonales
11885,2A,CORSE SUD,6179,4577,235,4342,2004,t1,cantonales
11886,2A,CORSE SUD,2495,2112,39,2073,2004,t1,cantonales
11887,2A,CORSE SUD,1985,1666,59,1607,2004,t1,cantonales
11888,2A,CORSE SUD,2783,2018,110,1908,2004,t1,cantonales
11889,2A,CORSE SUD,3737,3170,83,3087,2004,t1,cantonales
11890,2A,CORSE SUD,2540,1591,194,1397,2004,t1,cantonales
11891,2A,CORSE SUD,8761,5620,232,5388,2004,t1,cantonales
11892,2A,CORSE SUD,1867,1504,44,1460,2004,t1,cantonales
11893,2A,CORSE SUD,4136,2935,115,2820,2004,t1,cantonales
11894,2A,CORSE SUD,3165,2372,83,2289,2004,t1,cantonales
11895,2A,CORSE SUD,3965,2749,111,2638,2004,t1,cantonales
11896,2B,HAUTE CORSE,3176,2502,138,2364,2004,t1,cantonales
11897,2B,HAUTE CORSE,3370,2885,50,2835,2004,t1,cantonales
11898,2B,HAUTE CORSE,3352,2319,402,1917,2004,t1,cantonales
11899,2B,HAUTE CORSE,2965,2375,73,2302,2004,t1,cantonales
11900,2B,HAUTE CORSE,2570,2234,39,2195,2004,t1,cantonales
11901,2B,HAUTE CORSE,4523,2975,232,2743,2004,t1,cantonales
11902,2B,HAUTE CORSE,3512,2957,134,2823,2004,t1,cantonales
11903,2B,HAUTE CORSE,4455,2961,270,2691,2004,t1,cantonales
11904,2B,HAUTE CORSE,2983,2469,77,2392,2004,t1,cantonales
11905,2B,HAUTE CORSE,3617,2521,227,2294,2004,t1,cantonales
11906,2B,HAUTE CORSE,5162,4001,101,3900,2004,t1,cantonales
11907,2B,HAUTE CORSE,2722,2070,80,1990,2004,t1,cantonales
11908,2B,HAUTE CORSE,1798,1527,33,1494,2004,t1,cantonales
11909,2B,HAUTE CORSE,1441,1073,80,993,2004,t1,cantonales
11910,21,COTE D'OR,1424,999,53,946,2004,t1,cantonales
11911,21,COTE D'OR,4223,2816,92,2724,2004,t1,cantonales
11912,21,COTE D'OR,9164,5443,195,5248,2004,t1,cantonales
11913,21,COTE D'OR,11163,6783,231,6552,2004,t1,cantonales
11914,21,COTE D'OR,2387,1650,104,1546,2004,t1,cantonales
11915,21,COTE D'OR,9978,5761,175,5586,2004,t1,cantonales
11916,21,COTE D'OR,10649,7130,260,6870,2004,t1,cantonales
11917,21,COTE D'OR,972,782,41,741,2004,t1,cantonales
11918,21,COTE D'OR,8402,5619,159,5460,2004,t1,cantonales
11919,21,COTE D'OR,5743,3933,140,3793,2004,t1,cantonales
11920,21,COTE D'OR,8288,5443,227,5216,2004,t1,cantonales
11921,21,COTE D'OR,2128,1499,38,1461,2004,t1,cantonales
11922,21,COTE D'OR,10391,6838,303,6535,2004,t1,cantonales
11923,21,COTE D'OR,5506,3613,118,3495,2004,t1,cantonales
11924,21,COTE D'OR,7471,4390,143,4247,2004,t1,cantonales
11925,21,COTE D'OR,2498,1749,68,1681,2004,t1,cantonales
11926,21,COTE D'OR,2802,1945,52,1893,2004,t1,cantonales
11927,21,COTE D'OR,2849,2013,108,1905,2004,t1,cantonales
11928,21,COTE D'OR,15699,10246,264,9982,2004,t1,cantonales
11929,21,COTE D'OR,12974,8195,176,8019,2004,t1,cantonales
11930,21,COTE D'OR,22674,15137,522,14615,2004,t1,cantonales
11931,22,COTES D'ARMOR,3474,2650,69,2581,2004,t1,cantonales
11932,22,COTES D'ARMOR,6084,4560,140,4420,2004,t1,cantonales
11933,22,COTES D'ARMOR,6750,5029,144,4885,2004,t1,cantonales
11934,22,COTES D'ARMOR,2381,1936,49,1887,2004,t1,cantonales
11935,22,COTES D'ARMOR,17766,12148,590,11558,2004,t1,cantonales
11936,22,COTES D'ARMOR,11056,7349,249,7100,2004,t1,cantonales
11937,22,COTES D'ARMOR,4586,3424,119,3305,2004,t1,cantonales
11938,22,COTES D'ARMOR,5866,4350,234,4116,2004,t1,cantonales
11939,22,COTES D'ARMOR,11405,7867,280,7587,2004,t1,cantonales
11940,22,COTES D'ARMOR,4175,3272,95,3177,2004,t1,cantonales
11941,22,COTES D'ARMOR,10745,7706,290,7416,2004,t1,cantonales
11942,22,COTES D'ARMOR,9127,6430,254,6176,2004,t1,cantonales
11943,22,COTES D'ARMOR,15187,9718,303,9415,2004,t1,cantonales
11944,22,COTES D'ARMOR,21760,14351,390,13961,2004,t1,cantonales
11945,22,COTES D'ARMOR,3891,2969,89,2880,2004,t1,cantonales
11946,22,COTES D'ARMOR,7924,6068,154,5914,2004,t1,cantonales
11947,22,COTES D'ARMOR,4635,3395,157,3238,2004,t1,cantonales
11948,22,COTES D'ARMOR,7542,5457,221,5236,2004,t1,cantonales
11949,22,COTES D'ARMOR,5603,3940,98,3842,2004,t1,cantonales
11950,22,COTES D'ARMOR,5024,3858,100,3758,2004,t1,cantonales
11951,22,COTES D'ARMOR,4653,3488,104,3384,2004,t1,cantonales
11952,22,COTES D'ARMOR,6603,5076,165,4911,2004,t1,cantonales
11953,22,COTES D'ARMOR,3253,2425,91,2334,2004,t1,cantonales
11954,22,COTES D'ARMOR,16605,11267,402,10865,2004,t1,cantonales
11955,22,COTES D'ARMOR,14689,10425,403,10022,2004,t1,cantonales
11956,22,COTES D'ARMOR,11474,7082,204,6878,2004,t1,cantonales
11957,23,CREUSE,3623,2488,160,2328,2004,t1,cantonales
11958,23,CREUSE,5444,3663,159,3504,2004,t1,cantonales
11959,23,CREUSE,3119,2243,127,2116,2004,t1,cantonales
11960,23,CREUSE,2412,1698,80,1618,2004,t1,cantonales
11961,23,CREUSE,4632,2988,150,2838,2004,t1,cantonales
11962,23,CREUSE,4610,3130,184,2946,2004,t1,cantonales
11963,23,CREUSE,3067,2169,110,2059,2004,t1,cantonales
11964,23,CREUSE,3279,2312,134,2178,2004,t1,cantonales
11965,23,CREUSE,1334,1052,32,1020,2004,t1,cantonales
11966,23,CREUSE,3369,2120,137,1983,2004,t1,cantonales
11967,23,CREUSE,1654,1192,60,1132,2004,t1,cantonales
11968,23,CREUSE,1803,1379,49,1330,2004,t1,cantonales
11969,23,CREUSE,5423,3526,214,3312,2004,t1,cantonales
11970,24,DORDOGNE,2775,2215,83,2132,2004,t1,cantonales
11971,24,DORDOGNE,15040,9506,408,9098,2004,t1,cantonales
11972,24,DORDOGNE,5620,4194,176,4018,2004,t1,cantonales
11973,24,DORDOGNE,3715,2837,133,2704,2004,t1,cantonales
11974,24,DORDOGNE,3058,2422,144,2278,2004,t1,cantonales
11975,24,DORDOGNE,2984,2230,113,2117,2004,t1,cantonales
11976,24,DORDOGNE,3302,2818,135,2683,2004,t1,cantonales
11977,24,DORDOGNE,4033,3135,158,2977,2004,t1,cantonales
11978,24,DORDOGNE,8675,6073,310,5763,2004,t1,cantonales
11979,24,DORDOGNE,6362,4705,225,4480,2004,t1,cantonales
11980,24,DORDOGNE,4575,3753,190,3563,2004,t1,cantonales
11981,24,DORDOGNE,3763,3036,179,2857,2004,t1,cantonales
11982,24,DORDOGNE,6815,5166,205,4961,2004,t1,cantonales
11983,24,DORDOGNE,7772,5573,271,5302,2004,t1,cantonales
11984,24,DORDOGNE,7109,5396,391,5005,2004,t1,cantonales
11985,24,DORDOGNE,3046,2475,72,2403,2004,t1,cantonales
11986,24,DORDOGNE,11941,8479,368,8111,2004,t1,cantonales
11987,24,DORDOGNE,6970,5386,292,5094,2004,t1,cantonales
11988,24,DORDOGNE,6821,4892,202,4690,2004,t1,cantonales
11989,24,DORDOGNE,4535,3469,147,3322,2004,t1,cantonales
11990,24,DORDOGNE,3703,2910,142,2768,2004,t1,cantonales
11991,24,DORDOGNE,3519,2700,109,2591,2004,t1,cantonales
11992,24,DORDOGNE,1939,1593,74,1519,2004,t1,cantonales
11993,24,DORDOGNE,11655,7865,392,7473,2004,t1,cantonales
11994,24,DORDOGNE,12331,8531,432,8099,2004,t1,cantonales
11995,24,DORDOGNE,14649,10157,650,9507,2004,t1,cantonales
11996,25,DOUBS,15681,9073,403,8670,2004,t1,cantonales
11997,25,DOUBS,4754,3331,207,3124,2004,t1,cantonales
11998,25,DOUBS,12547,8129,381,7748,2004,t1,cantonales
11999,25,DOUBS,5574,3576,124,3452,2004,t1,cantonales
12000,25,DOUBS,8228,6040,166,5874,2004,t1,cantonales
12001,25,DOUBS,5494,3674,290,3384,2004,t1,cantonales
12002,25,DOUBS,21035,13183,794,12389,2004,t1,cantonales
12003,25,DOUBS,10837,7265,300,6965,2004,t1,cantonales
12004,25,DOUBS,6429,4657,202,4455,2004,t1,cantonales
12005,25,DOUBS,3104,2263,131,2132,2004,t1,cantonales
12006,25,DOUBS,6021,4245,208,4037,2004,t1,cantonales
12007,25,DOUBS,4538,3351,151,3200,2004,t1,cantonales
12008,25,DOUBS,3577,2570,120,2450,2004,t1,cantonales
12009,25,DOUBS,7836,5621,256,5365,2004,t1,cantonales
12010,25,DOUBS,12316,7525,268,7257,2004,t1,cantonales
12011,25,DOUBS,12508,7991,369,7622,2004,t1,cantonales
12012,25,DOUBS,8228,4748,183,4565,2004,t1,cantonales
12013,25,DOUBS,9305,6216,292,5924,2004,t1,cantonales
12014,26,DROME,19423,12471,427,12044,2004,t1,cantonales
12015,26,DROME,14672,9962,263,9699,2004,t1,cantonales
12016,26,DROME,1698,1234,27,1207,2004,t1,cantonales
12017,26,DROME,4608,3248,89,3159,2004,t1,cantonales
12018,26,DROME,5669,4097,120,3977,2004,t1,cantonales
12019,26,DROME,5815,4327,97,4230,2004,t1,cantonales
12020,26,DROME,1557,1192,30,1162,2004,t1,cantonales
12021,26,DROME,12538,7597,312,7285,2004,t1,cantonales
12022,26,DROME,965,765,27,738,2004,t1,cantonales
12023,26,DROME,9831,6744,245,6499,2004,t1,cantonales
12024,26,DROME,12372,8010,311,7699,2004,t1,cantonales
12025,26,DROME,1287,969,28,941,2004,t1,cantonales
12026,26,DROME,4970,3565,100,3465,2004,t1,cantonales
12027,26,DROME,14387,9602,388,9214,2004,t1,cantonales
12028,26,DROME,9909,6276,185,6091,2004,t1,cantonales
12029,26,DROME,16059,10320,320,10000,2004,t1,cantonales
12030,26,DROME,16736,10775,407,10368,2004,t1,cantonales
12031,26,DROME,8705,5272,136,5136,2004,t1,cantonales
12032,27,EURE,10743,7277,321,6956,2004,t1,cantonales
12033,27,EURE,12725,7770,331,7439,2004,t1,cantonales
12034,27,EURE,3637,2511,90,2421,2004,t1,cantonales
12035,27,EURE,8985,5892,284,5608,2004,t1,cantonales
12036,27,EURE,6193,4200,154,4046,2004,t1,cantonales
12037,27,EURE,7394,5004,195,4809,2004,t1,cantonales
12038,27,EURE,10076,6691,316,6375,2004,t1,cantonales
12039,27,EURE,6240,4239,138,4101,2004,t1,cantonales
12040,27,EURE,11031,7062,294,6768,2004,t1,cantonales
12041,27,EURE,3606,2567,94,2473,2004,t1,cantonales
12042,27,EURE,5208,3411,126,3285,2004,t1,cantonales
12043,27,EURE,10079,6595,196,6399,2004,t1,cantonales
12044,27,EURE,7219,4800,194,4606,2004,t1,cantonales
12045,27,EURE,16776,10536,515,10021,2004,t1,cantonales
12046,27,EURE,6207,3846,120,3726,2004,t1,cantonales
12047,27,EURE,9042,5208,232,4976,2004,t1,cantonales
12048,27,EURE,5371,3494,261,3233,2004,t1,cantonales
12049,27,EURE,7847,4762,268,4494,2004,t1,cantonales
12050,27,EURE,11474,7268,223,7045,2004,t1,cantonales
12051,27,EURE,9818,6524,229,6295,2004,t1,cantonales
12052,27,EURE,12206,7540,300,7240,2004,t1,cantonales
12053,27,EURE,7655,5212,171,5041,2004,t1,cantonales
12054,28,EURE ET LOIR,7241,4943,125,4818,2004,t1,cantonales
12055,28,EURE ET LOIR,12651,8021,270,7751,2004,t1,cantonales
12056,28,EURE ET LOIR,15810,10229,567,9662,2004,t1,cantonales
12057,28,EURE ET LOIR,6666,4284,197,4087,2004,t1,cantonales
12058,28,EURE ET LOIR,1822,1201,64,1137,2004,t1,cantonales
12059,28,EURE ET LOIR,7538,4601,209,4392,2004,t1,cantonales
12060,28,EURE ET LOIR,6397,4103,172,3931,2004,t1,cantonales
12061,28,EURE ET LOIR,21036,12682,550,12132,2004,t1,cantonales
12062,28,EURE ET LOIR,11313,6999,273,6726,2004,t1,cantonales
12063,28,EURE ET LOIR,4007,2895,71,2824,2004,t1,cantonales
12064,28,EURE ET LOIR,4201,2704,119,2585,2004,t1,cantonales
12065,28,EURE ET LOIR,20449,12504,517,11987,2004,t1,cantonales
12066,28,EURE ET LOIR,11031,6284,277,6007,2004,t1,cantonales
12067,28,EURE ET LOIR,12265,7240,340,6900,2004,t1,cantonales
12068,29,FINISTERE,4028,2944,112,2832,2004,t1,cantonales
12069,29,FINISTERE,7452,4897,191,4706,2004,t1,cantonales
12070,29,FINISTERE,11715,7583,241,7342,2004,t1,cantonales
12071,29,FINISTERE,8861,4958,102,4856,2004,t1,cantonales
12072,29,FINISTERE,12138,9180,243,8937,2004,t1,cantonales
12073,29,FINISTERE,21069,12670,438,12232,2004,t1,cantonales
12074,29,FINISTERE,13372,8997,301,8696,2004,t1,cantonales
12075,29,FINISTERE,19743,13438,367,13071,2004,t1,cantonales
12076,29,FINISTERE,20378,14054,472,13582,2004,t1,cantonales
12077,29,FINISTERE,9985,6976,175,6801,2004,t1,cantonales
12078,29,FINISTERE,12672,8710,183,8527,2004,t1,cantonales
12079,29,FINISTERE,14029,9668,310,9358,2004,t1,cantonales
12080,29,FINISTERE,6542,4855,166,4689,2004,t1,cantonales
12081,29,FINISTERE,12667,8703,219,8484,2004,t1,cantonales
12082,29,FINISTERE,7053,4694,149,4545,2004,t1,cantonales
12083,29,FINISTERE,7297,5216,187,5029,2004,t1,cantonales
12084,29,FINISTERE,14613,9750,262,9488,2004,t1,cantonales
12085,29,FINISTERE,14145,9657,284,9373,2004,t1,cantonales
12086,29,FINISTERE,10113,7117,271,6846,2004,t1,cantonales
12087,29,FINISTERE,15581,10095,323,9772,2004,t1,cantonales
12088,29,FINISTERE,5564,4027,82,3945,2004,t1,cantonales
12089,29,FINISTERE,12657,8367,217,8150,2004,t1,cantonales
12090,29,FINISTERE,11230,7026,177,6849,2004,t1,cantonales
12091,29,FINISTERE,8897,5164,130,5034,2004,t1,cantonales
12092,29,FINISTERE,15002,10362,385,9977,2004,t1,cantonales
12093,29,FINISTERE,9547,5170,134,5036,2004,t1,cantonales
12094,29,FINISTERE,13632,8360,164,8196,2004,t1,cantonales
12095,29,FINISTERE,8739,4898,82,4816,2004,t1,cantonales
12096,30,GARD,12885,8828,374,8454,2004,t1,cantonales
12097,30,GARD,14349,9252,387,8865,2004,t1,cantonales
12098,30,GARD,17836,11293,459,10834,2004,t1,cantonales
12099,30,GARD,959,705,39,666,2004,t1,cantonales
12100,30,GARD,2820,2291,61,2230,2004,t1,cantonales
12101,30,GARD,4524,3339,79,3260,2004,t1,cantonales
12102,30,GARD,4405,3345,125,3220,2004,t1,cantonales
12103,30,GARD,13545,8361,243,8118,2004,t1,cantonales
12104,30,GARD,13752,9894,464,9430,2004,t1,cantonales
12105,30,GARD,14372,9951,352,9599,2004,t1,cantonales
12106,30,GARD,997,849,34,815,2004,t1,cantonales
12107,30,GARD,8756,6284,219,6065,2004,t1,cantonales
12108,30,GARD,2743,2076,89,1987,2004,t1,cantonales
12109,30,GARD,9862,6825,232,6593,2004,t1,cantonales
12110,30,GARD,17090,11687,424,11263,2004,t1,cantonales
12111,30,GARD,2312,1718,42,1676,2004,t1,cantonales
12112,30,GARD,1174,1029,17,1012,2004,t1,cantonales
12113,30,GARD,13996,9213,289,8924,2004,t1,cantonales
12114,30,GARD,13254,8622,267,8355,2004,t1,cantonales
12115,30,GARD,6018,4212,159,4053,2004,t1,cantonales
12116,30,GARD,6508,4677,149,4528,2004,t1,cantonales
12117,30,GARD,9559,5568,204,5364,2004,t1,cantonales
12118,30,GARD,8743,5548,169,5379,2004,t1,cantonales
12119,31,HAUTE GARONNE,3259,2323,116,2207,2004,t1,cantonales
12120,31,HAUTE GARONNE,5393,3812,144,3668,2004,t1,cantonales
12121,31,HAUTE GARONNE,4263,3123,164,2959,2004,t1,cantonales
12122,31,HAUTE GARONNE,3342,2556,99,2457,2004,t1,cantonales
12123,31,HAUTE GARONNE,25786,18641,595,18046,2004,t1,cantonales
12124,31,HAUTE GARONNE,7937,5599,294,5305,2004,t1,cantonales
12125,31,HAUTE GARONNE,3954,2961,111,2850,2004,t1,cantonales
12126,31,HAUTE GARONNE,24562,16694,705,15989,2004,t1,cantonales
12127,31,HAUTE GARONNE,3895,3207,89,3118,2004,t1,cantonales
12128,31,HAUTE GARONNE,5500,4245,162,4083,2004,t1,cantonales
12129,31,HAUTE GARONNE,11185,7613,428,7185,2004,t1,cantonales
12130,31,HAUTE GARONNE,29317,19215,780,18435,2004,t1,cantonales
12131,31,HAUTE GARONNE,9374,6761,234,6527,2004,t1,cantonales
12132,31,HAUTE GARONNE,5866,4314,160,4154,2004,t1,cantonales
12133,31,HAUTE GARONNE,3351,2469,127,2342,2004,t1,cantonales
12134,31,HAUTE GARONNE,15754,9861,666,9195,2004,t1,cantonales
12135,31,HAUTE GARONNE,2717,1955,108,1847,2004,t1,cantonales
12136,31,HAUTE GARONNE,16063,9021,223,8798,2004,t1,cantonales
12137,31,HAUTE GARONNE,20994,12433,347,12086,2004,t1,cantonales
12138,31,HAUTE GARONNE,17547,10024,271,9753,2004,t1,cantonales
12139,31,HAUTE GARONNE,8637,6487,291,6196,2004,t1,cantonales
12140,31,HAUTE GARONNE,17671,10052,306,9746,2004,t1,cantonales
12141,31,HAUTE GARONNE,20655,11210,446,10764,2004,t1,cantonales
12142,31,HAUTE GARONNE,25621,16358,638,15720,2004,t1,cantonales
12143,31,HAUTE GARONNE,30927,20046,991,19055,2004,t1,cantonales
12144,31,HAUTE GARONNE,22102,14498,484,14014,2004,t1,cantonales
12145,31,HAUTE GARONNE,32104,21173,756,20417,2004,t1,cantonales
12146,32,GERS,4998,3449,164,3285,2004,t1,cantonales
12147,32,GERS,3779,2633,153,2480,2004,t1,cantonales
12148,32,GERS,2140,1663,76,1587,2004,t1,cantonales
12149,32,GERS,7545,5281,272,5009,2004,t1,cantonales
12150,32,GERS,2668,2098,101,1997,2004,t1,cantonales
12151,32,GERS,3900,2852,137,2715,2004,t1,cantonales
12152,32,GERS,3579,2837,104,2733,2004,t1,cantonales
12153,32,GERS,3801,2830,115,2715,2004,t1,cantonales
12154,32,GERS,1608,1274,44,1230,2004,t1,cantonales
12155,32,GERS,3862,2774,132,2642,2004,t1,cantonales
12156,32,GERS,3276,2439,156,2283,2004,t1,cantonales
12157,32,GERS,5388,4011,206,3805,2004,t1,cantonales
12158,32,GERS,2191,1669,76,1593,2004,t1,cantonales
12159,32,GERS,2257,1847,51,1796,2004,t1,cantonales
12160,32,GERS,3539,2636,107,2529,2004,t1,cantonales
12161,32,GERS,6741,4793,237,4556,2004,t1,cantonales
12162,33,GIRONDE,10741,6589,139,6450,2004,t1,cantonales
12163,33,GIRONDE,38226,25147,1321,23826,2004,t1,cantonales
12164,33,GIRONDE,3703,2878,157,2721,2004,t1,cantonales
12165,33,GIRONDE,9419,6434,321,6113,2004,t1,cantonales
12166,33,GIRONDE,14005,8274,264,8010,2004,t1,cantonales
12167,33,GIRONDE,12703,7585,234,7351,2004,t1,cantonales
12168,33,GIRONDE,9111,6226,268,5958,2004,t1,cantonales
12169,33,GIRONDE,9138,5986,358,5628,2004,t1,cantonales
12170,33,GIRONDE,8577,6121,244,5877,2004,t1,cantonales
12171,33,GIRONDE,1758,1437,42,1395,2004,t1,cantonales
12172,33,GIRONDE,24054,15507,530,14977,2004,t1,cantonales
12173,33,GIRONDE,19746,12772,579,12193,2004,t1,cantonales
12174,33,GIRONDE,10219,6768,410,6358,2004,t1,cantonales
12175,33,GIRONDE,23943,16444,689,15755,2004,t1,cantonales
12176,33,GIRONDE,25846,16768,790,15978,2004,t1,cantonales
12177,33,GIRONDE,3388,2464,132,2332,2004,t1,cantonales
12178,33,GIRONDE,8275,5478,186,5292,2004,t1,cantonales
12179,33,GIRONDE,16912,11051,362,10689,2004,t1,cantonales
12180,33,GIRONDE,5601,3845,175,3670,2004,t1,cantonales
12181,33,GIRONDE,8653,6305,280,6025,2004,t1,cantonales
12182,33,GIRONDE,6156,4415,178,4237,2004,t1,cantonales
12183,33,GIRONDE,6040,4227,210,4017,2004,t1,cantonales
12184,33,GIRONDE,2935,2257,83,2174,2004,t1,cantonales
12185,33,GIRONDE,4670,3478,153,3325,2004,t1,cantonales
12186,33,GIRONDE,3379,2572,93,2479,2004,t1,cantonales
12187,33,GIRONDE,15148,9674,285,9389,2004,t1,cantonales
12188,33,GIRONDE,26144,15783,494,15289,2004,t1,cantonales
12189,33,GIRONDE,20707,13020,554,12466,2004,t1,cantonales
12190,33,GIRONDE,19669,13268,369,12899,2004,t1,cantonales
12191,33,GIRONDE,15843,9230,320,8910,2004,t1,cantonales
12192,33,GIRONDE,26180,16829,725,16104,2004,t1,cantonales
12193,34,HERAULT,12572,8459,360,8099,2004,t1,cantonales
12194,34,HERAULT,30282,20917,686,20231,2004,t1,cantonales
12195,34,HERAULT,1040,880,21,859,2004,t1,cantonales
12196,34,HERAULT,13034,9144,326,8818,2004,t1,cantonales
12197,34,HERAULT,7041,5293,183,5110,2004,t1,cantonales
12198,34,HERAULT,28940,19366,841,18525,2004,t1,cantonales
12199,34,HERAULT,21526,15234,508,14726,2004,t1,cantonales
12200,34,HERAULT,25204,17163,564,16599,2004,t1,cantonales
12201,34,HERAULT,15384,9568,219,9349,2004,t1,cantonales
12202,34,HERAULT,7873,5740,179,5561,2004,t1,cantonales
12203,34,HERAULT,3456,2628,172,2456,2004,t1,cantonales
12204,34,HERAULT,10804,7733,257,7476,2004,t1,cantonales
12205,34,HERAULT,5947,4199,215,3984,2004,t1,cantonales
12206,34,HERAULT,5953,4599,185,4414,2004,t1,cantonales
12207,34,HERAULT,1395,1053,57,996,2004,t1,cantonales
12208,34,HERAULT,8650,6150,207,5943,2004,t1,cantonales
12209,34,HERAULT,15638,9561,396,9165,2004,t1,cantonales
12210,34,HERAULT,19535,12538,612,11926,2004,t1,cantonales
12211,34,HERAULT,24919,15845,602,15243,2004,t1,cantonales
12212,34,HERAULT,9521,5799,206,5593,2004,t1,cantonales
12213,34,HERAULT,12731,7605,291,7314,2004,t1,cantonales
12214,34,HERAULT,11165,6773,250,6523,2004,t1,cantonales
12215,34,HERAULT,22135,13998,501,13497,2004,t1,cantonales
12216,34,HERAULT,16660,11014,430,10584,2004,t1,cantonales
12217,34,HERAULT,22041,14929,442,14487,2004,t1,cantonales
12218,34,HERAULT,19481,13290,569,12721,2004,t1,cantonales
12219,35,ILLE ET VILAINE,12551,7663,339,7324,2004,t1,cantonales
12220,35,ILLE ET VILAINE,6612,4839,176,4663,2004,t1,cantonales
12221,35,ILLE ET VILAINE,11707,7563,328,7235,2004,t1,cantonales
12222,35,ILLE ET VILAINE,8289,5386,291,5095,2004,t1,cantonales
12223,35,ILLE ET VILAINE,9384,6538,220,6318,2004,t1,cantonales
12224,35,ILLE ET VILAINE,13653,8758,372,8386,2004,t1,cantonales
12225,35,ILLE ET VILAINE,3340,2273,125,2148,2004,t1,cantonales
12226,35,ILLE ET VILAINE,8596,6231,183,6048,2004,t1,cantonales
12227,35,ILLE ET VILAINE,16429,11368,464,10904,2004,t1,cantonales
12228,35,ILLE ET VILAINE,6733,4531,185,4346,2004,t1,cantonales
12229,35,ILLE ET VILAINE,9277,5865,253,5612,2004,t1,cantonales
12230,35,ILLE ET VILAINE,6025,4358,170,4188,2004,t1,cantonales
12231,35,ILLE ET VILAINE,10439,7202,291,6911,2004,t1,cantonales
12232,35,ILLE ET VILAINE,10198,6134,115,6019,2004,t1,cantonales
12233,35,ILLE ET VILAINE,11506,7178,160,7018,2004,t1,cantonales
12234,35,ILLE ET VILAINE,12076,7263,159,7104,2004,t1,cantonales
12235,35,ILLE ET VILAINE,8897,5678,283,5395,2004,t1,cantonales
12236,35,ILLE ET VILAINE,16062,10552,538,10014,2004,t1,cantonales
12237,35,ILLE ET VILAINE,8207,6004,281,5723,2004,t1,cantonales
12238,35,ILLE ET VILAINE,18391,11236,478,10758,2004,t1,cantonales
12239,35,ILLE ET VILAINE,3884,2808,124,2684,2004,t1,cantonales
12240,35,ILLE ET VILAINE,9537,6316,428,5888,2004,t1,cantonales
12241,35,ILLE ET VILAINE,8881,5404,134,5270,2004,t1,cantonales
12242,35,ILLE ET VILAINE,22781,14644,594,14050,2004,t1,cantonales
12243,35,ILLE ET VILAINE,27125,17845,596,17249,2004,t1,cantonales
12244,35,ILLE ET VILAINE,11276,6384,181,6203,2004,t1,cantonales
12245,35,ILLE ET VILAINE,15863,10839,261,10578,2004,t1,cantonales
12246,36,INDRE,5511,3788,130,3658,2004,t1,cantonales
12247,36,INDRE,9842,7210,316,6894,2004,t1,cantonales
12248,36,INDRE,3150,2251,142,2109,2004,t1,cantonales
12249,36,INDRE,3635,2746,171,2575,2004,t1,cantonales
12250,36,INDRE,9363,6252,285,5967,2004,t1,cantonales
12251,36,INDRE,3030,2322,135,2187,2004,t1,cantonales
12252,36,INDRE,5085,3598,146,3452,2004,t1,cantonales
12253,36,INDRE,3609,2501,105,2396,2004,t1,cantonales
12254,36,INDRE,2934,1902,66,1836,2004,t1,cantonales
12255,36,INDRE,3818,2785,154,2631,2004,t1,cantonales
12256,36,INDRE,6860,4840,303,4537,2004,t1,cantonales
12257,36,INDRE,12766,7907,376,7531,2004,t1,cantonales
12258,36,INDRE,10788,7003,443,6560,2004,t1,cantonales
12259,37,INDRE ET LOIRE ,9221,6022,222,5800,2004,t1,cantonales
12260,37,INDRE ET LOIRE ,15497,10159,608,9551,2004,t1,cantonales
12261,37,INDRE ET LOIRE ,8805,5455,299,5156,2004,t1,cantonales
12262,37,INDRE ET LOIRE ,6575,4394,165,4229,2004,t1,cantonales
12263,37,INDRE ET LOIRE ,3390,2525,79,2446,2004,t1,cantonales
12264,37,INDRE ET LOIRE ,5750,4077,128,3949,2004,t1,cantonales
12265,37,INDRE ET LOIRE ,5571,4001,169,3832,2004,t1,cantonales
12266,37,INDRE ET LOIRE ,15988,10183,366,9817,2004,t1,cantonales
12267,37,INDRE ET LOIRE ,4304,2975,120,2855,2004,t1,cantonales
12268,37,INDRE ET LOIRE ,4389,3060,126,2934,2004,t1,cantonales
12269,37,INDRE ET LOIRE ,6553,4131,236,3895,2004,t1,cantonales
12270,37,INDRE ET LOIRE ,10146,6174,189,5985,2004,t1,cantonales
12271,37,INDRE ET LOIRE ,9233,5280,120,5160,2004,t1,cantonales
12272,37,INDRE ET LOIRE ,8895,5145,143,5002,2004,t1,cantonales
12273,37,INDRE ET LOIRE ,10745,6167,208,5959,2004,t1,cantonales
12274,37,INDRE ET LOIRE ,10128,6067,222,5845,2004,t1,cantonales
12275,37,INDRE ET LOIRE ,11280,6428,186,6242,2004,t1,cantonales
12276,37,INDRE ET LOIRE ,15008,9668,368,9300,2004,t1,cantonales
12277,37,INDRE ET LOIRE ,14316,9130,371,8759,2004,t1,cantonales
12278,38,ISERE,8664,5132,167,4965,2004,t1,cantonales
12279,38,ISERE,14398,8562,351,8211,2004,t1,cantonales
12280,38,ISERE,1639,1294,26,1268,2004,t1,cantonales
12281,38,ISERE,1922,1436,34,1402,2004,t1,cantonales
12282,38,ISERE,19301,11708,363,11345,2004,t1,cantonales
12283,38,ISERE,9653,6316,229,6087,2004,t1,cantonales
12284,38,ISERE,16258,9642,260,9382,2004,t1,cantonales
12285,38,ISERE,12262,7324,184,7140,2004,t1,cantonales
12286,38,ISERE,13052,8028,266,7762,2004,t1,cantonales
12287,38,ISERE,2550,1965,45,1920,2004,t1,cantonales
12288,38,ISERE,3258,2441,67,2374,2004,t1,cantonales
12289,38,ISERE,16390,9798,387,9411,2004,t1,cantonales
12290,38,ISERE,9935,6504,267,6237,2004,t1,cantonales
12291,38,ISERE,29817,18044,726,17318,2004,t1,cantonales
12292,38,ISERE,6427,3995,149,3846,2004,t1,cantonales
12293,38,ISERE,10820,7089,246,6843,2004,t1,cantonales
12294,38,ISERE,15007,9515,285,9230,2004,t1,cantonales
12295,38,ISERE,16758,10495,330,10165,2004,t1,cantonales
12296,38,ISERE,8118,5205,179,5026,2004,t1,cantonales
12297,38,ISERE,1871,1384,19,1365,2004,t1,cantonales
12298,38,ISERE,11070,6491,242,6249,2004,t1,cantonales
12299,38,ISERE,20708,12761,495,12266,2004,t1,cantonales
12300,38,ISERE,8527,5761,128,5633,2004,t1,cantonales
12301,38,ISERE,5896,3912,217,3695,2004,t1,cantonales
12302,38,ISERE,29331,18372,716,17656,2004,t1,cantonales
12303,38,ISERE,7913,4849,210,4639,2004,t1,cantonales
12304,38,ISERE,17509,11214,293,10921,2004,t1,cantonales
12305,38,ISERE,8807,5443,181,5262,2004,t1,cantonales
12306,38,ISERE,10449,5766,203,5563,2004,t1,cantonales
12307,39,JURA,4854,3517,198,3319,2004,t1,cantonales
12308,39,JURA,3324,2355,105,2250,2004,t1,cantonales
12309,39,JURA,4706,3227,120,3107,2004,t1,cantonales
12310,39,JURA,1973,1340,64,1276,2004,t1,cantonales
12311,39,JURA,7541,4889,196,4693,2004,t1,cantonales
12312,39,JURA,3777,2729,129,2600,2004,t1,cantonales
12313,39,JURA,4559,3059,116,2943,2004,t1,cantonales
12314,39,JURA,12718,8438,287,8151,2004,t1,cantonales
12315,39,JURA,10120,5998,268,5730,2004,t1,cantonales
12316,39,JURA,4127,2834,98,2736,2004,t1,cantonales
12317,39,JURA,3482,2591,88,2503,2004,t1,cantonales
12318,39,JURA,2274,1664,40,1624,2004,t1,cantonales
12319,39,JURA,9443,5390,229,5161,2004,t1,cantonales
12320,39,JURA,2420,1709,93,1616,2004,t1,cantonales
12321,39,JURA,1661,1110,107,1003,2004,t1,cantonales
12322,39,JURA,2445,1765,72,1693,2004,t1,cantonales
12323,39,JURA,2789,2050,65,1985,2004,t1,cantonales
12324,40,LANDES,5584,4213,195,4018,2004,t1,cantonales
12325,40,LANDES,7726,5693,242,5451,2004,t1,cantonales
12326,40,LANDES,14710,9836,582,9254,2004,t1,cantonales
12327,40,LANDES,2901,2229,111,2118,2004,t1,cantonales
12328,40,LANDES,3516,2739,67,2672,2004,t1,cantonales
12329,40,LANDES,7332,5755,237,5518,2004,t1,cantonales
12330,40,LANDES,2331,1723,114,1609,2004,t1,cantonales
12331,40,LANDES,8259,5593,277,5316,2004,t1,cantonales
12332,40,LANDES,12068,7613,363,7250,2004,t1,cantonales
12333,40,LANDES,7136,5226,531,4695,2004,t1,cantonales
12334,40,LANDES,7961,5772,288,5484,2004,t1,cantonales
12335,40,LANDES,2456,1652,64,1588,2004,t1,cantonales
12336,40,LANDES,19449,12548,572,11976,2004,t1,cantonales
12337,40,LANDES,4147,2928,300,2628,2004,t1,cantonales
12338,40,LANDES,22558,14842,735,14107,2004,t1,cantonales
12339,41,LOIR ET CHER,9238,5984,249,5735,2004,t1,cantonales
12340,41,LOIR ET CHER,12115,7852,300,7552,2004,t1,cantonales
12341,41,LOIR ET CHER,4498,3179,119,3060,2004,t1,cantonales
12342,41,LOIR ET CHER,4978,3288,178,3110,2004,t1,cantonales
12343,41,LOIR ET CHER,7256,4893,252,4641,2004,t1,cantonales
12344,41,LOIR ET CHER,11747,8034,255,7779,2004,t1,cantonales
12345,41,LOIR ET CHER,4359,2841,140,2701,2004,t1,cantonales
12346,41,LOIR ET CHER,3895,2907,103,2804,2004,t1,cantonales
12347,41,LOIR ET CHER,8916,5540,256,5284,2004,t1,cantonales
12348,41,LOIR ET CHER,10925,6667,374,6293,2004,t1,cantonales
12349,41,LOIR ET CHER,4632,3094,130,2964,2004,t1,cantonales
12350,41,LOIR ET CHER,9709,5751,231,5520,2004,t1,cantonales
12351,41,LOIR ET CHER,5171,2538,76,2462,2004,t1,cantonales
12352,41,LOIR ET CHER,11093,7060,348,6712,2004,t1,cantonales
12353,41,LOIR ET CHER,6831,4307,198,4109,2004,t1,cantonales
12354,42,LOIRE,4133,2728,106,2622,2004,t1,cantonales
12355,42,LOIRE,4867,3397,118,3279,2004,t1,cantonales
12356,42,LOIRE,7178,5003,160,4843,2004,t1,cantonales
12357,42,LOIRE,17704,10257,354,9903,2004,t1,cantonales
12358,42,LOIRE,19422,11880,599,11281,2004,t1,cantonales
12359,42,LOIRE,3397,2317,74,2243,2004,t1,cantonales
12360,42,LOIRE,11188,6925,384,6541,2004,t1,cantonales
12361,42,LOIRE,16531,10052,301,9751,2004,t1,cantonales
12362,42,LOIRE,21875,12301,555,11746,2004,t1,cantonales
12363,42,LOIRE,6022,3965,157,3808,2004,t1,cantonales
12364,42,LOIRE,12811,7551,268,7283,2004,t1,cantonales
12365,42,LOIRE,12122,6125,147,5978,2004,t1,cantonales
12366,42,LOIRE,20823,12105,344,11761,2004,t1,cantonales
12367,42,LOIRE,6064,4422,141,4281,2004,t1,cantonales
12368,42,LOIRE,3464,2369,103,2266,2004,t1,cantonales
12369,42,LOIRE,9640,6059,255,5804,2004,t1,cantonales
12370,42,LOIRE,20209,13060,346,12714,2004,t1,cantonales
12371,42,LOIRE,4048,2543,103,2440,2004,t1,cantonales
12372,42,LOIRE,13655,7355,166,7189,2004,t1,cantonales
12373,42,LOIRE,7068,3656,76,3580,2004,t1,cantonales
12374,42,LOIRE,10310,5362,151,5211,2004,t1,cantonales
12375,42,LOIRE,10241,5840,179,5661,2004,t1,cantonales
12376,43,HAUTE LOIRE,7262,4699,233,4466,2004,t1,cantonales
12377,43,HAUTE LOIRE,1877,1404,85,1319,2004,t1,cantonales
12378,43,HAUTE LOIRE,5494,3712,241,3471,2004,t1,cantonales
12379,43,HAUTE LOIRE,1733,1159,82,1077,2004,t1,cantonales
12380,43,HAUTE LOIRE,2222,1713,63,1650,2004,t1,cantonales
12381,43,HAUTE LOIRE,3694,2739,148,2591,2004,t1,cantonales
12382,43,HAUTE LOIRE,9610,6177,399,5778,2004,t1,cantonales
12383,43,HAUTE LOIRE,5598,3931,240,3691,2004,t1,cantonales
12384,43,HAUTE LOIRE,2742,2096,74,2022,2004,t1,cantonales
12385,43,HAUTE LOIRE,5350,3740,231,3509,2004,t1,cantonales
12386,43,HAUTE LOIRE,3793,2860,108,2752,2004,t1,cantonales
12387,43,HAUTE LOIRE,3719,2888,49,2839,2004,t1,cantonales
12388,43,HAUTE LOIRE,4230,3277,89,3188,2004,t1,cantonales
12389,43,HAUTE LOIRE,6708,4310,186,4124,2004,t1,cantonales
12390,43,HAUTE LOIRE,7820,4952,277,4675,2004,t1,cantonales
12391,43,HAUTE LOIRE,4862,3026,138,2888,2004,t1,cantonales
12392,43,HAUTE LOIRE,5878,3800,160,3640,2004,t1,cantonales
12393,44,LOIRE ATLANTIQUE,14767,10185,443,9742,2004,t1,cantonales
12394,44,LOIRE ATLANTIQUE,16314,10802,477,10325,2004,t1,cantonales
12395,44,LOIRE ATLANTIQUE,12024,8114,275,7839,2004,t1,cantonales
12396,44,LOIRE ATLANTIQUE,27456,18120,635,17485,2004,t1,cantonales
12397,44,LOIRE ATLANTIQUE,14452,9544,481,9063,2004,t1,cantonales
12398,44,LOIRE ATLANTIQUE,5850,4181,138,4043,2004,t1,cantonales
12399,44,LOIRE ATLANTIQUE,6264,4694,144,4550,2004,t1,cantonales
12400,44,LOIRE ATLANTIQUE,9545,6559,244,6315,2004,t1,cantonales
12401,44,LOIRE ATLANTIQUE,15572,10193,392,9801,2004,t1,cantonales
12402,44,LOIRE ATLANTIQUE,16453,9635,207,9428,2004,t1,cantonales
12403,44,LOIRE ATLANTIQUE,16411,8935,160,8775,2004,t1,cantonales
12404,44,LOIRE ATLANTIQUE,15218,8613,314,8299,2004,t1,cantonales
12405,44,LOIRE ATLANTIQUE,12907,7240,192,7048,2004,t1,cantonales
12406,44,LOIRE ATLANTIQUE,15679,10596,420,10176,2004,t1,cantonales
12407,44,LOIRE ATLANTIQUE,10869,7195,262,6933,2004,t1,cantonales
12408,44,LOIRE ATLANTIQUE,18670,12199,571,11628,2004,t1,cantonales
12409,44,LOIRE ATLANTIQUE,4817,3495,165,3330,2004,t1,cantonales
12410,44,LOIRE ATLANTIQUE,3158,2269,110,2159,2004,t1,cantonales
12411,44,LOIRE ATLANTIQUE,24115,15720,495,15225,2004,t1,cantonales
12412,44,LOIRE ATLANTIQUE,13327,7656,237,7419,2004,t1,cantonales
12413,44,LOIRE ATLANTIQUE,12432,8414,397,8017,2004,t1,cantonales
12414,44,LOIRE ATLANTIQUE,14317,9434,418,9016,2004,t1,cantonales
12415,44,LOIRE ATLANTIQUE,5848,4158,201,3957,2004,t1,cantonales
12416,44,LOIRE ATLANTIQUE,20351,13897,401,13496,2004,t1,cantonales
12417,44,LOIRE ATLANTIQUE,19608,11856,297,11559,2004,t1,cantonales
12418,44,LOIRE ATLANTIQUE,16094,9525,354,9171,2004,t1,cantonales
12419,44,LOIRE ATLANTIQUE,14420,8605,279,8326,2004,t1,cantonales
12420,44,LOIRE ATLANTIQUE,23926,15478,394,15084,2004,t1,cantonales
12421,44,LOIRE ATLANTIQUE,22628,13365,380,12985,2004,t1,cantonales
12422,44,LOIRE ATLANTIQUE,11319,6342,201,6141,2004,t1,cantonales
12423,45,LOIRET,6258,4173,188,3985,2004,t1,cantonales
12424,45,LOIRET,8549,5441,284,5157,2004,t1,cantonales
12425,45,LOIRET,13249,8402,365,8037,2004,t1,cantonales
12426,45,LOIRET,7414,4725,208,4517,2004,t1,cantonales
12427,45,LOIRET,5434,3454,174,3280,2004,t1,cantonales
12428,45,LOIRET,12087,7995,288,7707,2004,t1,cantonales
12429,45,LOIRET,6096,4320,123,4197,2004,t1,cantonales
12430,45,LOIRET,7174,4234,237,3997,2004,t1,cantonales
12431,45,LOIRET,12929,8067,296,7771,2004,t1,cantonales
12432,45,LOIRET,8384,4697,181,4516,2004,t1,cantonales
12433,45,LOIRET,9659,5450,163,5287,2004,t1,cantonales
12434,45,LOIRET,11209,6381,203,6178,2004,t1,cantonales
12435,45,LOIRET,4174,2791,193,2598,2004,t1,cantonales
12436,45,LOIRET,15051,9607,323,9284,2004,t1,cantonales
12437,45,LOIRET,4722,3155,124,3031,2004,t1,cantonales
12438,45,LOIRET,7943,5234,222,5012,2004,t1,cantonales
12439,45,LOIRET,12937,8098,334,7764,2004,t1,cantonales
12440,45,LOIRET,13235,8102,287,7815,2004,t1,cantonales
12441,45,LOIRET,13376,8290,371,7919,2004,t1,cantonales
12442,45,LOIRET,13210,8451,295,8156,2004,t1,cantonales
12443,46,LOT,5182,3544,222,3322,2004,t1,cantonales
12444,46,LOT,7379,4823,496,4327,2004,t1,cantonales
12445,46,LOT,2629,2088,65,2023,2004,t1,cantonales
12446,46,LOT,2064,1623,68,1555,2004,t1,cantonales
12447,46,LOT,6514,4498,320,4178,2004,t1,cantonales
12448,46,LOT,7533,5251,324,4927,2004,t1,cantonales
12449,46,LOT,5694,4175,179,3996,2004,t1,cantonales
12450,46,LOT,5135,3838,325,3513,2004,t1,cantonales
12451,46,LOT,1417,1132,53,1079,2004,t1,cantonales
12452,46,LOT,5111,3637,316,3321,2004,t1,cantonales
12453,46,LOT,4095,3032,261,2771,2004,t1,cantonales
12454,46,LOT,1938,1382,160,1222,2004,t1,cantonales
12455,46,LOT,1709,1295,134,1161,2004,t1,cantonales
12456,46,LOT,5799,4316,200,4116,2004,t1,cantonales
12457,46,LOT,1302,1051,38,1013,2004,t1,cantonales
12458,46,LOT,8221,5432,456,4976,2004,t1,cantonales
12459,47,LOT ET GARONNE ,7087,4643,175,4468,2004,t1,cantonales
12460,47,LOT ET GARONNE ,1885,1493,34,1459,2004,t1,cantonales
12461,47,LOT ET GARONNE ,2090,1642,49,1593,2004,t1,cantonales
12462,47,LOT ET GARONNE ,4469,3335,151,3184,2004,t1,cantonales
12463,47,LOT ET GARONNE ,3693,2802,88,2714,2004,t1,cantonales
12464,47,LOT ET GARONNE ,3667,2667,132,2535,2004,t1,cantonales
12465,47,LOT ET GARONNE ,8110,5902,266,5636,2004,t1,cantonales
12466,47,LOT ET GARONNE ,1291,1006,36,970,2004,t1,cantonales
12467,47,LOT ET GARONNE ,2995,2302,124,2178,2004,t1,cantonales
12468,47,LOT ET GARONNE ,11468,7410,421,6989,2004,t1,cantonales
12469,47,LOT ET GARONNE ,3603,2679,127,2552,2004,t1,cantonales
12470,47,LOT ET GARONNE ,3040,2326,108,2218,2004,t1,cantonales
12471,47,LOT ET GARONNE ,4487,3371,142,3229,2004,t1,cantonales
12472,47,LOT ET GARONNE ,3381,2536,94,2442,2004,t1,cantonales
12473,47,LOT ET GARONNE ,5803,4106,167,3939,2004,t1,cantonales
12474,47,LOT ET GARONNE ,9948,6699,278,6421,2004,t1,cantonales
12475,47,LOT ET GARONNE ,11315,7308,372,6936,2004,t1,cantonales
12476,47,LOT ET GARONNE ,8686,5792,286,5506,2004,t1,cantonales
12477,47,LOT ET GARONNE ,11969,7855,375,7480,2004,t1,cantonales
12478,47,LOT ET GARONNE ,9155,6266,297,5969,2004,t1,cantonales
12479,48,LOZERE,1867,1572,37,1535,2004,t1,cantonales
12480,48,LOZERE,1866,1500,44,1456,2004,t1,cantonales
12481,48,LOZERE,1387,1028,142,886,2004,t1,cantonales
12482,48,LOZERE,1292,1091,49,1042,2004,t1,cantonales
12483,48,LOZERE,3739,2789,101,2688,2004,t1,cantonales
12484,48,LOZERE,2115,1715,119,1596,2004,t1,cantonales
12485,48,LOZERE,1086,922,10,912,2004,t1,cantonales
12486,48,LOZERE,1136,945,26,919,2004,t1,cantonales
12487,48,LOZERE,1895,1482,103,1379,2004,t1,cantonales
12488,48,LOZERE,1132,829,67,762,2004,t1,cantonales
12489,48,LOZERE,2531,1853,100,1753,2004,t1,cantonales
12490,48,LOZERE,1524,1081,43,1038,2004,t1,cantonales
12491,49,MAINE ET LOIRE ,7954,5136,246,4890,2004,t1,cantonales
12492,49,MAINE ET LOIRE ,5043,3269,232,3037,2004,t1,cantonales
12493,49,MAINE ET LOIRE ,8269,5635,275,5360,2004,t1,cantonales
12494,49,MAINE ET LOIRE ,18262,10930,765,10165,2004,t1,cantonales
12495,49,MAINE ET LOIRE ,10075,6199,430,5769,2004,t1,cantonales
12496,49,MAINE ET LOIRE ,7004,4695,166,4529,2004,t1,cantonales
12497,49,MAINE ET LOIRE ,5116,3361,164,3197,2004,t1,cantonales
12498,49,MAINE ET LOIRE ,11187,7211,636,6575,2004,t1,cantonales
12499,49,MAINE ET LOIRE ,27956,18614,929,17685,2004,t1,cantonales
12500,49,MAINE ET LOIRE ,7466,5227,208,5019,2004,t1,cantonales
12501,49,MAINE ET LOIRE ,12598,8744,600,8144,2004,t1,cantonales
12502,49,MAINE ET LOIRE ,11296,7651,480,7171,2004,t1,cantonales
12503,49,MAINE ET LOIRE ,7980,4521,336,4185,2004,t1,cantonales
12504,49,MAINE ET LOIRE ,7702,4674,261,4413,2004,t1,cantonales
12505,49,MAINE ET LOIRE ,20638,12950,574,12376,2004,t1,cantonales
12506,49,MAINE ET LOIRE ,11778,7396,472,6924,2004,t1,cantonales
12507,49,MAINE ET LOIRE ,17760,10388,530,9858,2004,t1,cantonales
12508,49,MAINE ET LOIRE ,18887,11861,485,11376,2004,t1,cantonales
12509,49,MAINE ET LOIRE ,15407,8636,342,8294,2004,t1,cantonales
12510,49,MAINE ET LOIRE ,20869,12431,549,11882,2004,t1,cantonales
12511,50,MANCHE,5979,3878,135,3743,2004,t1,cantonales
12512,50,MANCHE,7939,5131,326,4805,2004,t1,cantonales
12513,50,MANCHE,4503,3114,277,2837,2004,t1,cantonales
12514,50,MANCHE,8405,5409,227,5182,2004,t1,cantonales
12515,50,MANCHE,7705,4742,197,4545,2004,t1,cantonales
12516,50,MANCHE,8861,5413,198,5215,2004,t1,cantonales
12517,50,MANCHE,8547,5247,256,4991,2004,t1,cantonales
12518,50,MANCHE,6184,4014,176,3838,2004,t1,cantonales
12519,50,MANCHE,2451,1934,56,1878,2004,t1,cantonales
12520,50,MANCHE,2056,1414,113,1301,2004,t1,cantonales
12521,50,MANCHE,4002,2664,185,2479,2004,t1,cantonales
12522,50,MANCHE,4625,3128,119,3009,2004,t1,cantonales
12523,50,MANCHE,5150,3457,272,3185,2004,t1,cantonales
12524,50,MANCHE,5260,3645,161,3484,2004,t1,cantonales
12525,50,MANCHE,4844,3146,135,3011,2004,t1,cantonales
12526,50,MANCHE,7819,5047,328,4719,2004,t1,cantonales
12527,50,MANCHE,5840,3677,170,3507,2004,t1,cantonales
12528,50,MANCHE,6704,4237,164,4073,2004,t1,cantonales
12529,50,MANCHE,3952,2913,120,2793,2004,t1,cantonales
12530,50,MANCHE,2640,1692,188,1504,2004,t1,cantonales
12531,50,MANCHE,9057,6004,385,5619,2004,t1,cantonales
12532,50,MANCHE,9993,5970,287,5683,2004,t1,cantonales
12533,50,MANCHE,6229,3839,229,3610,2004,t1,cantonales
12534,50,MANCHE,7112,3957,144,3813,2004,t1,cantonales
12535,50,MANCHE,17729,10389,386,10003,2004,t1,cantonales
12536,50,MANCHE,9616,6214,231,5983,2004,t1,cantonales
12537,51,MARNE,7325,4541,186,4355,2004,t1,cantonales
12538,51,MARNE,6623,4090,189,3901,2004,t1,cantonales
12539,51,MARNE,3291,2082,78,2004,2004,t1,cantonales
12540,51,MARNE,5411,3533,322,3211,2004,t1,cantonales
12541,51,MARNE,8980,4702,128,4574,2004,t1,cantonales
12542,51,MARNE,4329,2684,232,2452,2004,t1,cantonales
12543,51,MARNE,3238,2126,81,2045,2004,t1,cantonales
12544,51,MARNE,18370,10091,284,9807,2004,t1,cantonales
12545,51,MARNE,8890,4862,121,4741,2004,t1,cantonales
12546,51,MARNE,6659,4259,192,4067,2004,t1,cantonales
12547,51,MARNE,3523,2471,95,2376,2004,t1,cantonales
12548,51,MARNE,7609,4357,178,4179,2004,t1,cantonales
12549,51,MARNE,8611,4680,224,4456,2004,t1,cantonales
12550,51,MARNE,8613,5304,221,5083,2004,t1,cantonales
12551,51,MARNE,9599,6273,244,6029,2004,t1,cantonales
12552,51,MARNE,9175,5560,185,5375,2004,t1,cantonales
12553,51,MARNE,10662,5721,281,5440,2004,t1,cantonales
12554,51,MARNE,14708,7751,360,7391,2004,t1,cantonales
12555,51,MARNE,14088,7726,227,7499,2004,t1,cantonales
12556,51,MARNE,9010,5176,146,5030,2004,t1,cantonales
12557,51,MARNE,12945,6440,165,6275,2004,t1,cantonales
12558,51,MARNE,11511,6128,223,5905,2004,t1,cantonales
12559,52,HAUTE MARNE,2269,1654,117,1537,2004,t1,cantonales
12560,52,HAUTE MARNE,1575,1135,44,1091,2004,t1,cantonales
12561,52,HAUTE MARNE,3446,2210,99,2111,2004,t1,cantonales
12562,52,HAUTE MARNE,9176,5420,305,5115,2004,t1,cantonales
12563,52,HAUTE MARNE,2075,1499,58,1441,2004,t1,cantonales
12564,52,HAUTE MARNE,3685,2368,390,1978,2004,t1,cantonales
12565,52,HAUTE MARNE,2491,1711,75,1636,2004,t1,cantonales
12566,52,HAUTE MARNE,9705,5817,432,5385,2004,t1,cantonales
12567,52,HAUTE MARNE,5433,3551,252,3299,2004,t1,cantonales
12568,52,HAUTE MARNE,4095,2744,116,2628,2004,t1,cantonales
12569,52,HAUTE MARNE,2891,1929,124,1805,2004,t1,cantonales
12570,52,HAUTE MARNE,8569,4420,177,4243,2004,t1,cantonales
12571,52,HAUTE MARNE,4494,2991,157,2834,2004,t1,cantonales
12572,52,HAUTE MARNE,6062,3603,129,3474,2004,t1,cantonales
12573,52,HAUTE MARNE,4855,2873,116,2757,2004,t1,cantonales
12574,52,HAUTE MARNE,7855,4695,191,4504,2004,t1,cantonales
12575,53,MAYENNE,4157,2875,129,2746,2004,t1,cantonales
12576,53,MAYENNE,6893,4580,357,4223,2004,t1,cantonales
12577,53,MAYENNE,6498,4254,266,3988,2004,t1,cantonales
12578,53,MAYENNE,7667,4615,362,4253,2004,t1,cantonales
12579,53,MAYENNE,8253,5476,340,5136,2004,t1,cantonales
12580,53,MAYENNE,5499,3828,300,3528,2004,t1,cantonales
12581,53,MAYENNE,5619,3723,385,3338,2004,t1,cantonales
12582,53,MAYENNE,10263,6659,309,6350,2004,t1,cantonales
12583,53,MAYENNE,7849,4833,269,4564,2004,t1,cantonales
12584,53,MAYENNE,11077,7344,373,6971,2004,t1,cantonales
12585,53,MAYENNE,10926,7163,616,6547,2004,t1,cantonales
12586,53,MAYENNE,9812,6566,389,6177,2004,t1,cantonales
12587,53,MAYENNE,6141,3611,237,3374,2004,t1,cantonales
12588,53,MAYENNE,8540,5469,233,5236,2004,t1,cantonales
12589,53,MAYENNE,4702,2806,139,2667,2004,t1,cantonales
12590,53,MAYENNE,7553,4834,239,4595,2004,t1,cantonales
12591,53,MAYENNE,11808,7746,366,7380,2004,t1,cantonales
12592,54,MEURTHE ET MOSELLE,1125,876,23,853,2004,t1,cantonales
12593,54,MEURTHE ET MOSELLE,14592,8195,372,7823,2004,t1,cantonales
12594,54,MEURTHE ET MOSELLE,2431,1701,73,1628,2004,t1,cantonales
12595,54,MEURTHE ET MOSELLE,4275,2999,164,2835,2004,t1,cantonales
12596,54,MEURTHE ET MOSELLE,5489,3731,185,3546,2004,t1,cantonales
12597,54,MEURTHE ET MOSELLE,14203,8472,337,8135,2004,t1,cantonales
12598,54,MEURTHE ET MOSELLE,6326,4459,162,4297,2004,t1,cantonales
12599,54,MEURTHE ET MOSELLE,9395,5490,231,5259,2004,t1,cantonales
12600,54,MEURTHE ET MOSELLE,10371,5336,168,5168,2004,t1,cantonales
12601,54,MEURTHE ET MOSELLE,11414,6227,169,6058,2004,t1,cantonales
12602,54,MEURTHE ET MOSELLE,12040,6820,171,6649,2004,t1,cantonales
12603,54,MEURTHE ET MOSELLE,7097,4639,241,4398,2004,t1,cantonales
12604,54,MEURTHE ET MOSELLE,13126,7739,302,7437,2004,t1,cantonales
12605,54,MEURTHE ET MOSELLE,18778,11523,440,11083,2004,t1,cantonales
12606,54,MEURTHE ET MOSELLE,3282,2264,115,2149,2004,t1,cantonales
12607,54,MEURTHE ET MOSELLE,9554,6137,274,5863,2004,t1,cantonales
12608,54,MEURTHE ET MOSELLE,11937,6069,254,5815,2004,t1,cantonales
12609,54,MEURTHE ET MOSELLE,12255,6981,264,6717,2004,t1,cantonales
12610,54,MEURTHE ET MOSELLE,11503,6226,252,5974,2004,t1,cantonales
12611,54,MEURTHE ET MOSELLE,17373,10474,340,10134,2004,t1,cantonales
12612,54,MEURTHE ET MOSELLE,16166,10057,444,9613,2004,t1,cantonales
12613,54,MEURTHE ET MOSELLE,12693,8031,290,7741,2004,t1,cantonales
12614,55,MEUSE,7618,4970,229,4741,2004,t1,cantonales
12615,55,MEUSE,8009,4968,210,4758,2004,t1,cantonales
12616,55,MEUSE,6291,3987,188,3799,2004,t1,cantonales
12617,55,MEUSE,2462,1897,48,1849,2004,t1,cantonales
12618,55,MEUSE,3704,2542,106,2436,2004,t1,cantonales
12619,55,MEUSE,1758,1243,73,1170,2004,t1,cantonales
12620,55,MEUSE,2785,1893,145,1748,2004,t1,cantonales
12621,55,MEUSE,5631,3747,168,3579,2004,t1,cantonales
12622,55,MEUSE,5803,3739,122,3617,2004,t1,cantonales
12623,55,MEUSE,1621,1290,62,1228,2004,t1,cantonales
12624,55,MEUSE,1176,890,57,833,2004,t1,cantonales
12625,55,MEUSE,2323,1669,65,1604,2004,t1,cantonales
12626,55,MEUSE,3870,2555,118,2437,2004,t1,cantonales
12627,55,MEUSE,2998,2184,114,2070,2004,t1,cantonales
12628,55,MEUSE,7043,3679,130,3549,2004,t1,cantonales
12629,56,MORBIHAN,7069,5127,181,4946,2004,t1,cantonales
12630,56,MORBIHAN,5435,4008,157,3851,2004,t1,cantonales
12631,56,MORBIHAN,10838,7434,394,7040,2004,t1,cantonales
12632,56,MORBIHAN,14348,8396,352,8044,2004,t1,cantonales
12633,56,MORBIHAN,9222,6384,177,6207,2004,t1,cantonales
12634,56,MORBIHAN,10730,7156,339,6817,2004,t1,cantonales
12635,56,MORBIHAN,13371,8866,378,8488,2004,t1,cantonales
12636,56,MORBIHAN,18770,12633,629,12004,2004,t1,cantonales
12637,56,MORBIHAN,20504,13907,507,13400,2004,t1,cantonales
12638,56,MORBIHAN,10667,7836,252,7584,2004,t1,cantonales
12639,56,MORBIHAN,14137,9371,201,9170,2004,t1,cantonales
12640,56,MORBIHAN,10419,7274,268,7006,2004,t1,cantonales
12641,56,MORBIHAN,6436,4603,178,4425,2004,t1,cantonales
12642,56,MORBIHAN,7045,5000,323,4677,2004,t1,cantonales
12643,56,MORBIHAN,7527,5321,208,5113,2004,t1,cantonales
12644,56,MORBIHAN,10610,7443,180,7263,2004,t1,cantonales
12645,56,MORBIHAN,4129,3069,72,2997,2004,t1,cantonales
12646,56,MORBIHAN,21651,14201,526,13675,2004,t1,cantonales
12647,56,MORBIHAN,15885,9960,322,9638,2004,t1,cantonales
12648,56,MORBIHAN,16288,10097,345,9752,2004,t1,cantonales
12649,56,MORBIHAN,22616,14179,427,13752,2004,t1,cantonales
12650,57,MOSELLE,10122,5859,536,5323,2004,t1,cantonales
12651,57,MOSELLE,13842,8495,485,8010,2004,t1,cantonales
12652,57,MOSELLE,15697,8163,445,7718,2004,t1,cantonales
12653,57,MOSELLE,4832,3324,124,3200,2004,t1,cantonales
12654,57,MOSELLE,3871,2618,122,2496,2004,t1,cantonales
12655,57,MOSELLE,16542,8538,342,8196,2004,t1,cantonales
12656,57,MOSELLE,13786,6162,239,5923,2004,t1,cantonales
12657,57,MOSELLE,15696,9149,470,8679,2004,t1,cantonales
12658,57,MOSELLE,5181,3232,168,3064,2004,t1,cantonales
12659,57,MOSELLE,13094,6399,213,6186,2004,t1,cantonales
12660,57,MOSELLE,15542,7510,278,7232,2004,t1,cantonales
12661,57,MOSELLE,21483,12036,448,11588,2004,t1,cantonales
12662,57,MOSELLE,19396,11067,594,10473,2004,t1,cantonales
12663,57,MOSELLE,16227,7407,346,7061,2004,t1,cantonales
12664,57,MOSELLE,2955,2027,108,1919,2004,t1,cantonales
12665,57,MOSELLE,22260,12373,523,11850,2004,t1,cantonales
12666,57,MOSELLE,20496,11173,328,10845,2004,t1,cantonales
12667,57,MOSELLE,19516,10583,465,10118,2004,t1,cantonales
12668,57,MOSELLE,13866,8909,242,8667,2004,t1,cantonales
12669,57,MOSELLE,19062,10921,444,10477,2004,t1,cantonales
12670,57,MOSELLE,12593,6051,212,5839,2004,t1,cantonales
12671,57,MOSELLE,13427,7284,309,6975,2004,t1,cantonales
12672,57,MOSELLE,16328,10021,378,9643,2004,t1,cantonales
12673,57,MOSELLE,16513,9282,371,8911,2004,t1,cantonales
12674,57,MOSELLE,19664,10793,794,9999,2004,t1,cantonales
12675,57,MOSELLE,19914,10211,438,9773,2004,t1,cantonales
12676,58,NIEVRE,8052,5070,230,4840,2004,t1,cantonales
12677,58,NIEVRE,4010,2711,116,2595,2004,t1,cantonales
12678,58,NIEVRE,6591,4235,158,4077,2004,t1,cantonales
12679,58,NIEVRE,3289,2228,72,2156,2004,t1,cantonales
12680,58,NIEVRE,3745,2684,85,2599,2004,t1,cantonales
12681,58,NIEVRE,3963,2710,144,2566,2004,t1,cantonales
12682,58,NIEVRE,3574,2083,184,1899,2004,t1,cantonales
12683,58,NIEVRE,3447,2233,59,2174,2004,t1,cantonales
12684,58,NIEVRE,2696,1965,93,1872,2004,t1,cantonales
12685,58,NIEVRE,2449,1759,70,1689,2004,t1,cantonales
12686,58,NIEVRE,3471,2431,62,2369,2004,t1,cantonales
12687,58,NIEVRE,5861,3493,134,3359,2004,t1,cantonales
12688,58,NIEVRE,9066,5631,237,5394,2004,t1,cantonales
12689,58,NIEVRE,5978,3483,165,3318,2004,t1,cantonales
12690,58,NIEVRE,12467,7562,277,7285,2004,t1,cantonales
12691,58,NIEVRE,6118,3806,172,3634,2004,t1,cantonales
12692,59,NORD,13610,9973,318,9655,2004,t1,cantonales
12693,59,NORD,37575,23278,929,22349,2004,t1,cantonales
12694,59,NORD,6405,4118,181,3937,2004,t1,cantonales
12695,59,NORD,13271,8751,437,8314,2004,t1,cantonales
12696,59,NORD,13723,9539,499,9040,2004,t1,cantonales
12697,59,NORD,19098,12716,521,12195,2004,t1,cantonales
12698,59,NORD,16426,10276,448,9828,2004,t1,cantonales
12699,59,NORD,14151,10299,471,9828,2004,t1,cantonales
12700,59,NORD,7381,5628,260,5368,2004,t1,cantonales
12701,59,NORD,12289,8382,448,7934,2004,t1,cantonales
12702,59,NORD,30498,17152,508,16644,2004,t1,cantonales
12703,59,NORD,20008,13461,459,13002,2004,t1,cantonales
12704,59,NORD,35335,21535,1021,20514,2004,t1,cantonales
12705,59,NORD,28702,17784,582,17202,2004,t1,cantonales
12706,59,NORD,18441,12507,526,11981,2004,t1,cantonales
12707,59,NORD,17604,11557,879,10678,2004,t1,cantonales
12708,59,NORD,8155,5694,247,5447,2004,t1,cantonales
12709,59,NORD,46634,28684,1216,27468,2004,t1,cantonales
12710,59,NORD,19033,10110,339,9771,2004,t1,cantonales
12711,59,NORD,30290,16706,508,16198,2004,t1,cantonales
12712,59,NORD,29685,18420,576,17844,2004,t1,cantonales
12713,59,NORD,22327,11450,303,11147,2004,t1,cantonales
12714,59,NORD,23491,13965,432,13533,2004,t1,cantonales
12715,59,NORD,27616,18256,679,17577,2004,t1,cantonales
12716,59,NORD,8602,5987,204,5783,2004,t1,cantonales
12717,59,NORD,19837,10192,363,9829,2004,t1,cantonales
12718,59,NORD,23024,13730,521,13209,2004,t1,cantonales
12719,59,NORD,13122,9245,417,8828,2004,t1,cantonales
12720,59,NORD,6896,4363,173,4190,2004,t1,cantonales
12721,59,NORD,42248,24554,910,23644,2004,t1,cantonales
12722,59,NORD,33221,17311,603,16708,2004,t1,cantonales
12723,59,NORD,34072,20483,681,19802,2004,t1,cantonales
12724,59,NORD,22225,13193,541,12652,2004,t1,cantonales
12725,59,NORD,11658,8445,365,8080,2004,t1,cantonales
12726,59,NORD,33562,21382,988,20394,2004,t1,cantonales
12727,59,NORD,23382,13351,521,12830,2004,t1,cantonales
12728,59,NORD,20765,10388,367,10021,2004,t1,cantonales
12729,59,NORD,19318,11764,392,11372,2004,t1,cantonales
12730,59,NORD,21834,13642,491,13151,2004,t1,cantonales
12731,59,NORD,23852,14895,514,14381,2004,t1,cantonales
12732,60,OISE,10271,6061,255,5806,2004,t1,cantonales
12733,60,OISE,14351,8650,372,8278,2004,t1,cantonales
12734,60,OISE,12254,7938,398,7540,2004,t1,cantonales
12735,60,OISE,16161,9482,361,9121,2004,t1,cantonales
12736,60,OISE,20688,12687,591,12096,2004,t1,cantonales
12737,60,OISE,5297,3851,242,3609,2004,t1,cantonales
12738,60,OISE,6006,4216,169,4047,2004,t1,cantonales
12739,60,OISE,4587,3403,160,3243,2004,t1,cantonales
12740,60,OISE,5169,3447,143,3304,2004,t1,cantonales
12741,60,OISE,6258,4215,140,4075,2004,t1,cantonales
12742,60,OISE,5635,4021,214,3807,2004,t1,cantonales
12743,60,OISE,10053,6573,241,6332,2004,t1,cantonales
12744,60,OISE,14514,9265,404,8861,2004,t1,cantonales
12745,60,OISE,14722,9359,335,9024,2004,t1,cantonales
12746,60,OISE,17482,10671,405,10266,2004,t1,cantonales
12747,60,OISE,17190,11152,400,10752,2004,t1,cantonales
12748,60,OISE,12212,8499,338,8161,2004,t1,cantonales
12749,60,OISE,22650,12950,519,12431,2004,t1,cantonales
12750,60,OISE,5244,3901,171,3730,2004,t1,cantonales
12751,60,OISE,25209,14269,493,13776,2004,t1,cantonales
12752,61,ORNE,4543,2913,123,2790,2004,t1,cantonales
12753,61,ORNE,3532,2406,118,2288,2004,t1,cantonales
12754,61,ORNE,3820,2569,296,2273,2004,t1,cantonales
12755,61,ORNE,8311,5291,368,4923,2004,t1,cantonales
12756,61,ORNE,2205,1582,68,1514,2004,t1,cantonales
12757,61,ORNE,9931,6259,253,6006,2004,t1,cantonales
12758,61,ORNE,5447,3701,198,3503,2004,t1,cantonales
12759,61,ORNE,3356,2112,133,1979,2004,t1,cantonales
12760,61,ORNE,3396,2298,73,2225,2004,t1,cantonales
12761,61,ORNE,3150,2195,75,2120,2004,t1,cantonales
12762,61,ORNE,3100,2033,158,1875,2004,t1,cantonales
12763,61,ORNE,3060,2149,114,2035,2004,t1,cantonales
12764,61,ORNE,3046,1949,103,1846,2004,t1,cantonales
12765,61,ORNE,5368,3343,162,3181,2004,t1,cantonales
12766,61,ORNE,6578,4547,174,4373,2004,t1,cantonales
12767,61,ORNE,5611,3703,146,3557,2004,t1,cantonales
12768,61,ORNE,6482,4111,127,3984,2004,t1,cantonales
12769,61,ORNE,9533,6181,189,5992,2004,t1,cantonales
12770,61,ORNE,7286,4490,251,4239,2004,t1,cantonales
12771,61,ORNE,9994,6480,749,5731,2004,t1,cantonales
12772,62,PAS DE CALAIS,13890,9549,564,8985,2004,t1,cantonales
12773,62,PAS DE CALAIS,13082,8523,408,8115,2004,t1,cantonales
12774,62,PAS DE CALAIS,22743,15379,808,14571,2004,t1,cantonales
12775,62,PAS DE CALAIS,17796,12021,654,11367,2004,t1,cantonales
12776,62,PAS DE CALAIS,6650,4918,259,4659,2004,t1,cantonales
12777,62,PAS DE CALAIS,9532,7207,362,6845,2004,t1,cantonales
12778,62,PAS DE CALAIS,16808,10432,342,10090,2004,t1,cantonales
12779,62,PAS DE CALAIS,18926,11038,519,10519,2004,t1,cantonales
12780,62,PAS DE CALAIS,19722,10824,539,10285,2004,t1,cantonales
12781,62,PAS DE CALAIS,13967,9686,446,9240,2004,t1,cantonales
12782,62,PAS DE CALAIS,8146,6309,396,5913,2004,t1,cantonales
12783,62,PAS DE CALAIS,16873,10974,348,10626,2004,t1,cantonales
12784,62,PAS DE CALAIS,11001,8231,452,7779,2004,t1,cantonales
12785,62,PAS DE CALAIS,14575,8649,451,8198,2004,t1,cantonales
12786,62,PAS DE CALAIS,6997,5319,458,4861,2004,t1,cantonales
12787,62,PAS DE CALAIS,15077,9706,486,9220,2004,t1,cantonales
12788,62,PAS DE CALAIS,16777,12028,707,11321,2004,t1,cantonales
12789,62,PAS DE CALAIS,5960,4312,240,4072,2004,t1,cantonales
12790,62,PAS DE CALAIS,11197,8094,594,7500,2004,t1,cantonales
12791,62,PAS DE CALAIS,17611,12645,552,12093,2004,t1,cantonales
12792,62,PAS DE CALAIS,20861,14151,610,13541,2004,t1,cantonales
12793,62,PAS DE CALAIS,16146,9705,492,9213,2004,t1,cantonales
12794,62,PAS DE CALAIS,15398,9680,354,9326,2004,t1,cantonales
12795,62,PAS DE CALAIS,15248,9849,474,9375,2004,t1,cantonales
12796,62,PAS DE CALAIS,16377,9317,453,8864,2004,t1,cantonales
12797,62,PAS DE CALAIS,13866,8969,466,8503,2004,t1,cantonales
12798,62,PAS DE CALAIS,18212,11626,555,11071,2004,t1,cantonales
12799,62,PAS DE CALAIS,14241,9490,729,8761,2004,t1,cantonales
12800,62,PAS DE CALAIS,13698,8735,345,8390,2004,t1,cantonales
12801,62,PAS DE CALAIS,13518,7626,292,7334,2004,t1,cantonales
12802,62,PAS DE CALAIS,14249,7231,401,6830,2004,t1,cantonales
12803,62,PAS DE CALAIS,14410,8990,414,8576,2004,t1,cantonales
12804,62,PAS DE CALAIS,17865,11343,433,10910,2004,t1,cantonales
12805,62,PAS DE CALAIS,15607,9965,498,9467,2004,t1,cantonales
12806,62,PAS DE CALAIS,14007,10051,407,9644,2004,t1,cantonales
12807,62,PAS DE CALAIS,14308,9460,544,8916,2004,t1,cantonales
12808,62,PAS DE CALAIS,14156,8476,324,8152,2004,t1,cantonales
12809,62,PAS DE CALAIS,13166,8024,245,7779,2004,t1,cantonales
12810,63,PUY DE DOME,8548,5544,239,5305,2004,t1,cantonales
12811,63,PUY DE DOME,7069,4957,262,4695,2004,t1,cantonales
12812,63,PUY DE DOME,2991,2481,107,2374,2004,t1,cantonales
12813,63,PUY DE DOME,4854,3491,149,3342,2004,t1,cantonales
12814,63,PUY DE DOME,10248,6180,224,5956,2004,t1,cantonales
12815,63,PUY DE DOME,5177,3689,154,3535,2004,t1,cantonales
12816,63,PUY DE DOME,1924,1455,68,1387,2004,t1,cantonales
12817,63,PUY DE DOME,15046,10025,452,9573,2004,t1,cantonales
12818,63,PUY DE DOME,2767,2106,85,2021,2004,t1,cantonales
12819,63,PUY DE DOME,9730,6655,310,6345,2004,t1,cantonales
12820,63,PUY DE DOME,7690,5339,296,5043,2004,t1,cantonales
12821,63,PUY DE DOME,6748,4807,180,4627,2004,t1,cantonales
12822,63,PUY DE DOME,2343,1740,50,1690,2004,t1,cantonales
12823,63,PUY DE DOME,15000,9986,410,9576,2004,t1,cantonales
12824,63,PUY DE DOME,4445,3356,99,3257,2004,t1,cantonales
12825,63,PUY DE DOME,12896,8644,350,8294,2004,t1,cantonales
12826,63,PUY DE DOME,1302,964,24,940,2004,t1,cantonales
12827,63,PUY DE DOME,2238,1530,53,1477,2004,t1,cantonales
12828,63,PUY DE DOME,3680,2805,77,2728,2004,t1,cantonales
12829,63,PUY DE DOME,6888,4577,203,4374,2004,t1,cantonales
12830,63,PUY DE DOME,4915,3490,182,3308,2004,t1,cantonales
12831,63,PUY DE DOME,10016,6420,294,6126,2004,t1,cantonales
12832,63,PUY DE DOME,17380,11914,461,11453,2004,t1,cantonales
12833,63,PUY DE DOME,9642,6715,328,6387,2004,t1,cantonales
12834,63,PUY DE DOME,9689,6266,262,6004,2004,t1,cantonales
12835,63,PUY DE DOME,6363,3647,123,3524,2004,t1,cantonales
12836,63,PUY DE DOME,8051,4797,192,4605,2004,t1,cantonales
12837,63,PUY DE DOME,14757,9610,386,9224,2004,t1,cantonales
12838,63,PUY DE DOME,12365,8285,255,8030,2004,t1,cantonales
12839,63,PUY DE DOME,12946,8575,302,8273,2004,t1,cantonales
12840,64,PYRENEES ATLANTIQUES,2770,2287,55,2232,2004,t1,cantonales
12841,64,PYRENEES ATLANTIQUES,7598,5618,239,5379,2004,t1,cantonales
12842,64,PYRENEES ATLANTIQUES,4576,3687,99,3588,2004,t1,cantonales
12843,64,PYRENEES ATLANTIQUES,6935,3993,131,3862,2004,t1,cantonales
12844,64,PYRENEES ATLANTIQUES,11840,7041,340,6701,2004,t1,cantonales
12845,64,PYRENEES ATLANTIQUES,6410,5134,184,4950,2004,t1,cantonales
12846,64,PYRENEES ATLANTIQUES,3510,2771,131,2640,2004,t1,cantonales
12847,64,PYRENEES ATLANTIQUES,4719,3539,118,3421,2004,t1,cantonales
12848,64,PYRENEES ATLANTIQUES,10490,7043,365,6678,2004,t1,cantonales
12849,64,PYRENEES ATLANTIQUES,3035,2504,64,2440,2004,t1,cantonales
12850,64,PYRENEES ATLANTIQUES,2441,1894,88,1806,2004,t1,cantonales
12851,64,PYRENEES ATLANTIQUES,4169,3352,102,3250,2004,t1,cantonales
12852,64,PYRENEES ATLANTIQUES,22748,15850,839,15011,2004,t1,cantonales
12853,64,PYRENEES ATLANTIQUES,6691,4836,382,4454,2004,t1,cantonales
12854,64,PYRENEES ATLANTIQUES,4698,3670,91,3579,2004,t1,cantonales
12855,64,PYRENEES ATLANTIQUES,11673,8602,316,8286,2004,t1,cantonales
12856,64,PYRENEES ATLANTIQUES,9348,6806,348,6458,2004,t1,cantonales
12857,64,PYRENEES ATLANTIQUES,13794,8344,323,8021,2004,t1,cantonales
12858,64,PYRENEES ATLANTIQUES,5268,4073,110,3963,2004,t1,cantonales
12859,64,PYRENEES ATLANTIQUES,3005,2264,77,2187,2004,t1,cantonales
12860,64,PYRENEES ATLANTIQUES,12381,7826,218,7608,2004,t1,cantonales
12861,64,PYRENEES ATLANTIQUES,12575,7368,263,7105,2004,t1,cantonales
12862,64,PYRENEES ATLANTIQUES,10543,5416,212,5204,2004,t1,cantonales
12863,64,PYRENEES ATLANTIQUES,14672,10074,416,9658,2004,t1,cantonales
12864,64,PYRENEES ATLANTIQUES,10969,7085,317,6768,2004,t1,cantonales
12865,64,PYRENEES ATLANTIQUES,10689,6983,225,6758,2004,t1,cantonales
12866,65,HAUTES PYRENEES,3005,2177,87,2090,2004,t1,cantonales
12867,65,HAUTES PYRENEES,1872,1500,74,1426,2004,t1,cantonales
12868,65,HAUTES PYRENEES,1131,917,49,868,2004,t1,cantonales
12869,65,HAUTES PYRENEES,3872,2769,107,2662,2004,t1,cantonales
12870,65,HAUTES PYRENEES,2383,1711,121,1590,2004,t1,cantonales
12871,65,HAUTES PYRENEES,9348,6647,345,6302,2004,t1,cantonales
12872,65,HAUTES PYRENEES,3574,2510,98,2412,2004,t1,cantonales
12873,65,HAUTES PYRENEES,3634,2548,172,2376,2004,t1,cantonales
12874,65,HAUTES PYRENEES,1685,1401,53,1348,2004,t1,cantonales
12875,65,HAUTES PYRENEES,7340,5071,241,4830,2004,t1,cantonales
12876,65,HAUTES PYRENEES,2980,2265,68,2197,2004,t1,cantonales
12877,65,HAUTES PYRENEES,7376,4928,247,4681,2004,t1,cantonales
12878,65,HAUTES PYRENEES,2415,1857,71,1786,2004,t1,cantonales
12879,65,HAUTES PYRENEES,5481,3478,105,3373,2004,t1,cantonales
12880,65,HAUTES PYRENEES,6194,3891,127,3764,2004,t1,cantonales
12881,65,HAUTES PYRENEES,4975,3210,112,3098,2004,t1,cantonales
12882,65,HAUTES PYRENEES,8243,6045,255,5790,2004,t1,cantonales
12883,66,PYRENEES ORIENTALES,19245,13414,433,12981,2004,t1,cantonales
12884,66,PYRENEES ORIENTALES,3641,2578,101,2477,2004,t1,cantonales
12885,66,PYRENEES ORIENTALES,7349,4493,149,4344,2004,t1,cantonales
12886,66,PYRENEES ORIENTALES,5404,3039,133,2906,2004,t1,cantonales
12887,66,PYRENEES ORIENTALES,9867,6769,265,6504,2004,t1,cantonales
12888,66,PYRENEES ORIENTALES,2289,1801,46,1755,2004,t1,cantonales
12889,66,PYRENEES ORIENTALES,16090,11284,432,10852,2004,t1,cantonales
12890,66,PYRENEES ORIENTALES,15191,11046,340,10706,2004,t1,cantonales
12891,66,PYRENEES ORIENTALES,3268,2527,134,2393,2004,t1,cantonales
12892,66,PYRENEES ORIENTALES,1065,866,22,844,2004,t1,cantonales
12893,66,PYRENEES ORIENTALES,14091,10127,347,9780,2004,t1,cantonales
12894,66,PYRENEES ORIENTALES,10683,7359,238,7121,2004,t1,cantonales
12895,66,PYRENEES ORIENTALES,11687,7347,262,7085,2004,t1,cantonales
12896,66,PYRENEES ORIENTALES,13222,8434,272,8162,2004,t1,cantonales
12897,66,PYRENEES ORIENTALES,7907,4469,127,4342,2004,t1,cantonales
12898,66,PYRENEES ORIENTALES,15429,10386,300,10086,2004,t1,cantonales
12899,67,BAS RHIN,23269,14174,528,13646,2004,t1,cantonales
12900,67,BAS RHIN,8633,5884,368,5516,2004,t1,cantonales
12901,67,BAS RHIN,20968,12399,728,11671,2004,t1,cantonales
12902,67,BAS RHIN,15339,9429,458,8971,2004,t1,cantonales
12903,67,BAS RHIN,2890,2074,54,2020,2004,t1,cantonales
12904,67,BAS RHIN,11136,7703,291,7412,2004,t1,cantonales
12905,67,BAS RHIN,16855,10153,438,9715,2004,t1,cantonales
12906,67,BAS RHIN,15539,8684,255,8429,2004,t1,cantonales
12907,67,BAS RHIN,10100,6710,230,6480,2004,t1,cantonales
12908,67,BAS RHIN,20851,13249,596,12653,2004,t1,cantonales
12909,67,BAS RHIN,9449,5462,138,5324,2004,t1,cantonales
12910,67,BAS RHIN,15682,10743,380,10363,2004,t1,cantonales
12911,67,BAS RHIN,8238,5841,358,5483,2004,t1,cantonales
12912,67,BAS RHIN,15808,10176,376,9800,2004,t1,cantonales
12913,67,BAS RHIN,12619,7744,553,7191,2004,t1,cantonales
12914,67,BAS RHIN,9568,6337,374,5963,2004,t1,cantonales
12915,67,BAS RHIN,17199,9247,257,8990,2004,t1,cantonales
12916,67,BAS RHIN,12519,6890,242,6648,2004,t1,cantonales
12917,67,BAS RHIN,14051,7897,242,7655,2004,t1,cantonales
12918,67,BAS RHIN,10269,5459,156,5303,2004,t1,cantonales
12919,67,BAS RHIN,35561,20233,630,19603,2004,t1,cantonales
12920,67,BAS RHIN,33580,20519,742,19777,2004,t1,cantonales
12921,68,HAUT RHIN,16801,10933,499,10434,2004,t1,cantonales
12922,68,HAUT RHIN,17584,12437,554,11883,2004,t1,cantonales
12923,68,HAUT RHIN,9091,5873,249,5624,2004,t1,cantonales
12924,68,HAUT RHIN,17841,11761,565,11196,2004,t1,cantonales
12925,68,HAUT RHIN,14070,8830,384,8446,2004,t1,cantonales
12926,68,HAUT RHIN,23388,13995,495,13500,2004,t1,cantonales
12927,68,HAUT RHIN,30854,17594,644,16950,2004,t1,cantonales
12928,68,HAUT RHIN,12350,8444,330,8114,2004,t1,cantonales
12929,68,HAUT RHIN,15479,9823,347,9476,2004,t1,cantonales
12930,68,HAUT RHIN,8553,5899,194,5705,2004,t1,cantonales
12931,68,HAUT RHIN,12567,8230,373,7857,2004,t1,cantonales
12932,68,HAUT RHIN,10245,7247,345,6902,2004,t1,cantonales
12933,68,HAUT RHIN,7302,4650,199,4451,2004,t1,cantonales
12934,68,HAUT RHIN,14482,9899,361,9538,2004,t1,cantonales
12935,69,RHONE,16347,10468,280,10188,2004,t1,cantonales
12936,69,RHONE,24843,15771,509,15262,2004,t1,cantonales
12937,69,RHONE,8718,5512,172,5340,2004,t1,cantonales
12938,69,RHONE,10654,6944,245,6699,2004,t1,cantonales
12939,69,RHONE,21885,13361,450,12911,2004,t1,cantonales
12940,69,RHONE,4543,3166,96,3070,2004,t1,cantonales
12941,69,RHONE,20827,13762,306,13456,2004,t1,cantonales
12942,69,RHONE,26629,16723,410,16313,2004,t1,cantonales
12943,69,RHONE,13969,8933,163,8770,2004,t1,cantonales
12944,69,RHONE,14189,9160,210,8950,2004,t1,cantonales
12945,69,RHONE,15421,9567,241,9326,2004,t1,cantonales
12946,69,RHONE,18122,10483,308,10175,2004,t1,cantonales
12947,69,RHONE,8605,6095,227,5868,2004,t1,cantonales
12948,69,RHONE,8620,5283,181,5102,2004,t1,cantonales
12949,69,RHONE,31940,20347,824,19523,2004,t1,cantonales
12950,69,RHONE,20398,11632,323,11309,2004,t1,cantonales
12951,69,RHONE,20728,11403,317,11086,2004,t1,cantonales
12952,69,RHONE,32641,19444,486,18958,2004,t1,cantonales
12953,69,RHONE,19107,11303,311,10992,2004,t1,cantonales
12954,69,RHONE,15303,9464,252,9212,2004,t1,cantonales
12955,69,RHONE,22649,12779,387,12392,2004,t1,cantonales
12956,69,RHONE,15328,7907,256,7651,2004,t1,cantonales
12957,69,RHONE,23057,13394,381,13013,2004,t1,cantonales
12958,69,RHONE,16140,9958,297,9661,2004,t1,cantonales
12959,69,RHONE,19968,11599,364,11235,2004,t1,cantonales
12960,69,RHONE,14595,8929,226,8703,2004,t1,cantonales
12961,69,RHONE,16003,9403,295,9108,2004,t1,cantonales
12962,70,HAUTE SAONE,3348,2468,120,2348,2004,t1,cantonales
12963,70,HAUTE SAONE,4040,2852,97,2755,2004,t1,cantonales
12964,70,HAUTE SAONE,9006,5928,292,5636,2004,t1,cantonales
12965,70,HAUTE SAONE,2319,1812,62,1750,2004,t1,cantonales
12966,70,HAUTE SAONE,2672,2035,79,1956,2004,t1,cantonales
12967,70,HAUTE SAONE,4110,3101,107,2994,2004,t1,cantonales
12968,70,HAUTE SAONE,3597,2852,144,2708,2004,t1,cantonales
12969,70,HAUTE SAONE,3416,2451,169,2282,2004,t1,cantonales
12970,70,HAUTE SAONE,6935,4726,293,4433,2004,t1,cantonales
12971,70,HAUTE SAONE,4843,3361,143,3218,2004,t1,cantonales
12972,70,HAUTE SAONE,5079,3172,226,2946,2004,t1,cantonales
12973,70,HAUTE SAONE,4353,3239,142,3097,2004,t1,cantonales
12974,70,HAUTE SAONE,3451,2624,107,2517,2004,t1,cantonales
12975,70,HAUTE SAONE,12733,8395,381,8014,2004,t1,cantonales
12976,70,HAUTE SAONE,7260,4700,293,4407,2004,t1,cantonales
12977,70,HAUTE SAONE,6562,4211,280,3931,2004,t1,cantonales
12978,71,SAONE ET LOIRE ,7602,5157,280,4877,2004,t1,cantonales
12979,71,SAONE ET LOIRE ,3354,2324,105,2219,2004,t1,cantonales
12980,71,SAONE ET LOIRE ,17213,10869,577,10292,2004,t1,cantonales
12981,71,SAONE ET LOIRE ,6126,4104,215,3889,2004,t1,cantonales
12982,71,SAONE ET LOIRE ,7027,4774,179,4595,2004,t1,cantonales
12983,71,SAONE ET LOIRE ,4853,3412,142,3270,2004,t1,cantonales
12984,71,SAONE ET LOIRE ,5041,3057,123,2934,2004,t1,cantonales
12985,71,SAONE ET LOIRE ,7971,4993,201,4792,2004,t1,cantonales
12986,71,SAONE ET LOIRE ,3773,2540,108,2432,2004,t1,cantonales
12987,71,SAONE ET LOIRE ,9076,5914,338,5576,2004,t1,cantonales
12988,71,SAONE ET LOIRE ,2574,1862,108,1754,2004,t1,cantonales
12989,71,SAONE ET LOIRE ,1880,1443,41,1402,2004,t1,cantonales
12990,71,SAONE ET LOIRE ,3497,2406,118,2288,2004,t1,cantonales
12991,71,SAONE ET LOIRE ,6099,4021,171,3850,2004,t1,cantonales
12992,71,SAONE ET LOIRE ,9024,5095,273,4822,2004,t1,cantonales
12993,71,SAONE ET LOIRE ,4925,3290,130,3160,2004,t1,cantonales
12994,71,SAONE ET LOIRE ,2831,2035,75,1960,2004,t1,cantonales
12995,71,SAONE ET LOIRE ,3258,2520,87,2433,2004,t1,cantonales
12996,71,SAONE ET LOIRE ,12001,6722,273,6449,2004,t1,cantonales
12997,71,SAONE ET LOIRE ,2413,1760,58,1702,2004,t1,cantonales
12998,71,SAONE ET LOIRE ,10943,6789,268,6521,2004,t1,cantonales
12999,71,SAONE ET LOIRE ,4751,3496,146,3350,2004,t1,cantonales
13000,71,SAONE ET LOIRE ,5948,3994,170,3824,2004,t1,cantonales
13001,71,SAONE ET LOIRE ,3110,2298,89,2209,2004,t1,cantonales
13002,71,SAONE ET LOIRE ,4216,2927,121,2806,2004,t1,cantonales
13003,71,SAONE ET LOIRE ,6431,4516,148,4368,2004,t1,cantonales
13004,71,SAONE ET LOIRE ,13612,7818,335,7483,2004,t1,cantonales
13005,71,SAONE ET LOIRE ,10935,6308,227,6081,2004,t1,cantonales
13006,72,SARTHE,5932,4039,239,3800,2004,t1,cantonales
13007,72,SARTHE,5533,3899,142,3757,2004,t1,cantonales
13008,72,SARTHE,7309,4875,228,4647,2004,t1,cantonales
13009,72,SARTHE,4144,2861,109,2752,2004,t1,cantonales
13010,72,SARTHE,6699,4280,227,4053,2004,t1,cantonales
13011,72,SARTHE,7224,4585,308,4277,2004,t1,cantonales
13012,72,SARTHE,8795,5670,317,5353,2004,t1,cantonales
13013,72,SARTHE,12674,7235,243,6992,2004,t1,cantonales
13014,72,SARTHE,4809,3437,177,3260,2004,t1,cantonales
13015,72,SARTHE,14401,8997,517,8480,2004,t1,cantonales
13016,72,SARTHE,18109,11205,667,10538,2004,t1,cantonales
13017,72,SARTHE,8000,5138,325,4813,2004,t1,cantonales
13018,72,SARTHE,8448,5374,211,5163,2004,t1,cantonales
13019,72,SARTHE,5074,3281,159,3122,2004,t1,cantonales
13020,72,SARTHE,22013,13287,607,12680,2004,t1,cantonales
13021,72,SARTHE,15749,9077,357,8720,2004,t1,cantonales
13022,72,SARTHE,20731,12992,615,12377,2004,t1,cantonales
13023,72,SARTHE,14290,8831,348,8483,2004,t1,cantonales
13024,72,SARTHE,12582,7655,339,7316,2004,t1,cantonales
13025,73,SAVOIE,10903,6123,278,5845,2004,t1,cantonales
13026,73,SAVOIE,9468,5702,268,5434,2004,t1,cantonales
13027,73,SAVOIE,10464,5932,323,5609,2004,t1,cantonales
13028,73,SAVOIE,7268,3895,192,3703,2004,t1,cantonales
13029,73,SAVOIE,7465,4509,118,4391,2004,t1,cantonales
13030,73,SAVOIE,5596,3543,100,3443,2004,t1,cantonales
13031,73,SAVOIE,3349,2484,78,2406,2004,t1,cantonales
13032,73,SAVOIE,3535,2584,52,2532,2004,t1,cantonales
13033,73,SAVOIE,5750,4034,73,3961,2004,t1,cantonales
13034,73,SAVOIE,2460,1683,76,1607,2004,t1,cantonales
13035,73,SAVOIE,9697,6405,223,6182,2004,t1,cantonales
13036,73,SAVOIE,6409,3967,242,3725,2004,t1,cantonales
13037,73,SAVOIE,4558,2946,58,2888,2004,t1,cantonales
13038,73,SAVOIE,4857,3303,74,3229,2004,t1,cantonales
13039,73,SAVOIE,11774,6932,310,6622,2004,t1,cantonales
13040,73,SAVOIE,9143,5618,171,5447,2004,t1,cantonales
13041,73,SAVOIE,10813,6603,315,6288,2004,t1,cantonales
13042,73,SAVOIE,13547,8811,277,8534,2004,t1,cantonales
13043,73,SAVOIE,11182,6647,308,6339,2004,t1,cantonales
13044,74,HAUTE SAVOIE,3689,2490,154,2336,2004,t1,cantonales
13045,74,HAUTE SAVOIE,7496,4761,263,4498,2004,t1,cantonales
13046,74,HAUTE SAVOIE,9782,5372,156,5216,2004,t1,cantonales
13047,74,HAUTE SAVOIE,19569,10480,266,10214,2004,t1,cantonales
13048,74,HAUTE SAVOIE,13426,7796,226,7570,2004,t1,cantonales
13049,74,HAUTE SAVOIE,14197,7591,285,7306,2004,t1,cantonales
13050,74,HAUTE SAVOIE,9147,6044,215,5829,2004,t1,cantonales
13051,74,HAUTE SAVOIE,4961,3309,89,3220,2004,t1,cantonales
13052,74,HAUTE SAVOIE,10684,6716,254,6462,2004,t1,cantonales
13053,74,HAUTE SAVOIE,13296,8924,278,8646,2004,t1,cantonales
13054,74,HAUTE SAVOIE,11893,7515,177,7338,2004,t1,cantonales
13055,74,HAUTE SAVOIE,6944,4764,107,4657,2004,t1,cantonales
13056,74,HAUTE SAVOIE,18065,9734,331,9403,2004,t1,cantonales
13057,74,HAUTE SAVOIE,3584,2303,83,2220,2004,t1,cantonales
13058,74,HAUTE SAVOIE,28063,17288,752,16536,2004,t1,cantonales
13059,74,HAUTE SAVOIE,27514,16888,606,16282,2004,t1,cantonales
13060,74,HAUTE SAVOIE,21828,12119,393,11726,2004,t1,cantonales
13061,76,SEINE MARITIME ,5277,3729,187,3542,2004,t1,cantonales
13062,76,SEINE MARITIME ,8252,5782,231,5551,2004,t1,cantonales
13063,76,SEINE MARITIME ,5487,3801,163,3638,2004,t1,cantonales
13064,76,SEINE MARITIME ,8059,5565,283,5282,2004,t1,cantonales
13065,76,SEINE MARITIME ,6905,4631,213,4418,2004,t1,cantonales
13066,76,SEINE MARITIME ,11326,7834,218,7616,2004,t1,cantonales
13067,76,SEINE MARITIME ,18306,12011,409,11602,2004,t1,cantonales
13068,76,SEINE MARITIME ,13600,8851,329,8522,2004,t1,cantonales
13069,76,SEINE MARITIME ,18564,12305,479,11826,2004,t1,cantonales
13070,76,SEINE MARITIME ,6000,4248,376,3872,2004,t1,cantonales
13071,76,SEINE MARITIME ,20998,12665,341,12324,2004,t1,cantonales
13072,76,SEINE MARITIME ,3834,2833,85,2748,2004,t1,cantonales
13073,76,SEINE MARITIME ,19426,12606,545,12061,2004,t1,cantonales
13074,76,SEINE MARITIME ,15115,8402,312,8090,2004,t1,cantonales
13075,76,SEINE MARITIME ,9798,5667,167,5500,2004,t1,cantonales
13076,76,SEINE MARITIME ,20039,12247,443,11804,2004,t1,cantonales
13077,76,SEINE MARITIME ,3820,2714,151,2563,2004,t1,cantonales
13078,76,SEINE MARITIME ,5647,4132,179,3953,2004,t1,cantonales
13079,76,SEINE MARITIME ,16478,10068,398,9670,2004,t1,cantonales
13080,76,SEINE MARITIME ,8718,5913,255,5658,2004,t1,cantonales
13081,76,SEINE MARITIME ,3375,2422,104,2318,2004,t1,cantonales
13082,76,SEINE MARITIME ,21818,14094,578,13516,2004,t1,cantonales
13083,76,SEINE MARITIME ,6089,3802,107,3695,2004,t1,cantonales
13084,76,SEINE MARITIME ,7660,4592,128,4464,2004,t1,cantonales
13085,76,SEINE MARITIME ,11248,6663,290,6373,2004,t1,cantonales
13086,76,SEINE MARITIME ,7061,4843,216,4627,2004,t1,cantonales
13087,76,SEINE MARITIME ,8837,5956,268,5688,2004,t1,cantonales
13088,76,SEINE MARITIME ,7993,5243,247,4996,2004,t1,cantonales
13089,76,SEINE MARITIME ,12383,6299,205,6094,2004,t1,cantonales
13090,76,SEINE MARITIME ,18191,10680,485,10195,2004,t1,cantonales
13091,76,SEINE MARITIME ,13481,8332,328,8004,2004,t1,cantonales
13092,76,SEINE MARITIME ,20254,12468,400,12068,2004,t1,cantonales
13093,76,SEINE MARITIME ,7199,4477,129,4348,2004,t1,cantonales
13094,76,SEINE MARITIME ,14008,8827,359,8468,2004,t1,cantonales
13095,76,SEINE MARITIME ,13343,8771,388,8383,2004,t1,cantonales
13096,77,SEINE ET MARNE ,10091,6667,251,6416,2004,t1,cantonales
13097,77,SEINE ET MARNE ,15804,9679,384,9295,2004,t1,cantonales
13098,77,SEINE ET MARNE ,18133,10267,533,9734,2004,t1,cantonales
13099,77,SEINE ET MARNE ,10034,6247,247,6000,2004,t1,cantonales
13100,77,SEINE ET MARNE ,23582,14863,666,14197,2004,t1,cantonales
13101,77,SEINE ET MARNE ,11490,7163,295,6868,2004,t1,cantonales
13102,77,SEINE ET MARNE ,18849,11835,507,11328,2004,t1,cantonales
13103,77,SEINE ET MARNE ,22478,14173,499,13674,2004,t1,cantonales
13104,77,SEINE ET MARNE ,13818,8703,355,8348,2004,t1,cantonales
13105,77,SEINE ET MARNE ,18763,12013,375,11638,2004,t1,cantonales
13106,77,SEINE ET MARNE ,12304,7617,339,7278,2004,t1,cantonales
13107,77,SEINE ET MARNE ,8686,5690,205,5485,2004,t1,cantonales
13108,77,SEINE ET MARNE ,15140,9531,347,9184,2004,t1,cantonales
13109,77,SEINE ET MARNE ,14867,9219,252,8967,2004,t1,cantonales
13110,77,SEINE ET MARNE ,5318,3639,193,3446,2004,t1,cantonales
13111,77,SEINE ET MARNE ,24097,14374,511,13863,2004,t1,cantonales
13112,77,SEINE ET MARNE ,22776,13953,457,13496,2004,t1,cantonales
13113,77,SEINE ET MARNE ,18751,10969,468,10501,2004,t1,cantonales
13114,77,SEINE ET MARNE ,16042,9864,449,9415,2004,t1,cantonales
13115,77,SEINE ET MARNE ,17259,10493,309,10184,2004,t1,cantonales
13116,77,SEINE ET MARNE ,25481,15105,716,14389,2004,t1,cantonales
13117,77,SEINE ET MARNE ,22247,13594,455,13139,2004,t1,cantonales
13118,77,SEINE ET MARNE ,23499,14086,508,13578,2004,t1,cantonales
13119,78,YVELINES,19801,12183,433,11750,2004,t1,cantonales
13120,78,YVELINES,19339,11839,233,11606,2004,t1,cantonales
13121,78,YVELINES,20667,13240,338,12902,2004,t1,cantonales
13122,78,YVELINES,12921,8499,256,8243,2004,t1,cantonales
13123,78,YVELINES,16880,11087,374,10713,2004,t1,cantonales
13124,78,YVELINES,24989,15858,642,15216,2004,t1,cantonales
13125,78,YVELINES,16195,8980,245,8735,2004,t1,cantonales
13126,78,YVELINES,19095,12237,277,11960,2004,t1,cantonales
13127,78,YVELINES,29221,19183,524,18659,2004,t1,cantonales
13128,78,YVELINES,12971,7958,249,7709,2004,t1,cantonales
13129,78,YVELINES,14709,9729,316,9413,2004,t1,cantonales
13130,78,YVELINES,16706,10348,353,9995,2004,t1,cantonales
13131,78,YVELINES,24992,15449,343,15106,2004,t1,cantonales
13132,78,YVELINES,17827,11285,230,11055,2004,t1,cantonales
13133,78,YVELINES,25643,16161,375,15786,2004,t1,cantonales
13134,78,YVELINES,19960,12851,315,12536,2004,t1,cantonales
13135,78,YVELINES,21746,13484,175,13309,2004,t1,cantonales
13136,78,YVELINES,15961,10307,233,10074,2004,t1,cantonales
13137,78,YVELINES,24234,15371,428,14943,2004,t1,cantonales
13138,78,YVELINES,27748,16789,529,16260,2004,t1,cantonales
13139,78,YVELINES,14552,9162,248,8914,2004,t1,cantonales
13140,79,DEUX SEVRES,7833,5154,642,4512,2004,t1,cantonales
13141,79,DEUX SEVRES,10376,7065,485,6580,2004,t1,cantonales
13142,79,DEUX SEVRES,4244,3085,139,2946,2004,t1,cantonales
13143,79,DEUX SEVRES,7569,5236,255,4981,2004,t1,cantonales
13144,79,DEUX SEVRES,4626,3215,146,3069,2004,t1,cantonales
13145,79,DEUX SEVRES,3689,2720,142,2578,2004,t1,cantonales
13146,79,DEUX SEVRES,8498,5787,801,4986,2004,t1,cantonales
13147,79,DEUX SEVRES,4005,2967,129,2838,2004,t1,cantonales
13148,79,DEUX SEVRES,17439,10573,531,10042,2004,t1,cantonales
13149,79,DEUX SEVRES,9824,6564,291,6273,2004,t1,cantonales
13150,79,DEUX SEVRES,6510,4568,217,4351,2004,t1,cantonales
13151,79,DEUX SEVRES,4165,2868,240,2628,2004,t1,cantonales
13152,79,DEUX SEVRES,4391,3175,148,3027,2004,t1,cantonales
13153,79,DEUX SEVRES,3419,2560,175,2385,2004,t1,cantonales
13154,79,DEUX SEVRES,8693,5458,282,5176,2004,t1,cantonales
13155,79,DEUX SEVRES,12471,7759,337,7422,2004,t1,cantonales
13156,80,SOMME,12564,8384,402,7982,2004,t1,cantonales
13157,80,SOMME,4825,3699,153,3546,2004,t1,cantonales
13158,80,SOMME,5731,4525,194,4331,2004,t1,cantonales
13159,80,SOMME,13237,9267,402,8865,2004,t1,cantonales
13160,80,SOMME,15823,10238,428,9810,2004,t1,cantonales
13161,80,SOMME,8699,6042,320,5722,2004,t1,cantonales
13162,80,SOMME,3093,2260,95,2165,2004,t1,cantonales
13163,80,SOMME,7064,5061,305,4756,2004,t1,cantonales
13164,80,SOMME,15007,10543,575,9968,2004,t1,cantonales
13165,80,SOMME,9737,6723,362,6361,2004,t1,cantonales
13166,80,SOMME,9708,7209,474,6735,2004,t1,cantonales
13167,80,SOMME,7779,5739,489,5250,2004,t1,cantonales
13168,80,SOMME,8832,6039,273,5766,2004,t1,cantonales
13169,80,SOMME,7227,5396,356,5040,2004,t1,cantonales
13170,80,SOMME,5981,4435,165,4270,2004,t1,cantonales
13171,80,SOMME,5885,4349,108,4241,2004,t1,cantonales
13172,80,SOMME,9322,6367,307,6060,2004,t1,cantonales
13173,80,SOMME,9679,6729,206,6523,2004,t1,cantonales
13174,80,SOMME,9835,7252,337,6915,2004,t1,cantonales
13175,80,SOMME,14851,8992,444,8548,2004,t1,cantonales
13176,80,SOMME,10375,6617,301,6316,2004,t1,cantonales
13177,80,SOMME,11565,6877,267,6610,2004,t1,cantonales
13178,80,SOMME,9581,6722,434,6288,2004,t1,cantonales
13179,81,TARN,2408,2002,61,1941,2004,t1,cantonales
13180,81,TARN,7281,5042,222,4820,2004,t1,cantonales
13181,81,TARN,690,554,12,542,2004,t1,cantonales
13182,81,TARN,2871,2159,100,2059,2004,t1,cantonales
13183,81,TARN,3034,2371,83,2288,2004,t1,cantonales
13184,81,TARN,1788,1419,62,1357,2004,t1,cantonales
13185,81,TARN,11533,7847,418,7429,2004,t1,cantonales
13186,81,TARN,8883,6563,339,6224,2004,t1,cantonales
13187,81,TARN,3478,2864,150,2714,2004,t1,cantonales
13188,81,TARN,3742,2723,135,2588,2004,t1,cantonales
13189,81,TARN,10451,7193,285,6908,2004,t1,cantonales
13190,81,TARN,2135,1788,63,1725,2004,t1,cantonales
13191,81,TARN,1567,1338,36,1302,2004,t1,cantonales
13192,81,TARN,6727,5253,294,4959,2004,t1,cantonales
13193,81,TARN,4945,3696,264,3432,2004,t1,cantonales
13194,81,TARN,3124,2388,106,2282,2004,t1,cantonales
13195,81,TARN,2102,1623,72,1551,2004,t1,cantonales
13196,81,TARN,2569,2046,122,1924,2004,t1,cantonales
13197,81,TARN,8812,6310,364,5946,2004,t1,cantonales
13198,81,TARN,9185,6405,357,6048,2004,t1,cantonales
13199,81,TARN,8993,6193,335,5858,2004,t1,cantonales
13200,81,TARN,8818,6078,332,5746,2004,t1,cantonales
13201,81,TARN,7240,5106,272,4834,2004,t1,cantonales
13202,82,TARN ET GARONNE,4829,3570,210,3360,2004,t1,cantonales
13203,82,TARN ET GARONNE,4628,2954,131,2823,2004,t1,cantonales
13204,82,TARN ET GARONNE,10134,7271,272,6999,2004,t1,cantonales
13205,82,TARN ET GARONNE,9346,6653,373,6280,2004,t1,cantonales
13206,82,TARN ET GARONNE,3619,2778,94,2684,2004,t1,cantonales
13207,82,TARN ET GARONNE,3643,2793,79,2714,2004,t1,cantonales
13208,82,TARN ET GARONNE,2542,1928,63,1865,2004,t1,cantonales
13209,82,TARN ET GARONNE,1922,1557,41,1516,2004,t1,cantonales
13210,82,TARN ET GARONNE,6307,4526,235,4291,2004,t1,cantonales
13211,82,TARN ET GARONNE,2566,1843,116,1727,2004,t1,cantonales
13212,82,TARN ET GARONNE,4067,2985,97,2888,2004,t1,cantonales
13213,82,TARN ET GARONNE,7178,5239,242,4997,2004,t1,cantonales
13214,82,TARN ET GARONNE,5617,3882,209,3673,2004,t1,cantonales
13215,82,TARN ET GARONNE,6680,4229,181,4048,2004,t1,cantonales
13216,83,VAR,8917,6229,294,5935,2004,t1,cantonales
13217,83,VAR,16707,10432,310,10122,2004,t1,cantonales
13218,83,VAR,4947,3257,158,3099,2004,t1,cantonales
13219,83,VAR,33093,20231,500,19731,2004,t1,cantonales
13220,83,VAR,16489,9372,331,9041,2004,t1,cantonales
13221,83,VAR,12049,8275,289,7986,2004,t1,cantonales
13222,83,VAR,13594,8997,338,8659,2004,t1,cantonales
13223,83,VAR,30578,18176,542,17634,2004,t1,cantonales
13224,83,VAR,8418,6021,177,5844,2004,t1,cantonales
13225,83,VAR,20745,13456,430,13026,2004,t1,cantonales
13226,83,VAR,16779,10215,268,9947,2004,t1,cantonales
13227,83,VAR,3986,2888,98,2790,2004,t1,cantonales
13228,83,VAR,23372,12028,562,11466,2004,t1,cantonales
13229,83,VAR,3459,2609,62,2547,2004,t1,cantonales
13230,83,VAR,14666,7618,282,7336,2004,t1,cantonales
13231,83,VAR,6069,2898,89,2809,2004,t1,cantonales
13232,83,VAR,8998,4823,137,4686,2004,t1,cantonales
13233,83,VAR,19157,12131,357,11774,2004,t1,cantonales
13234,83,VAR,26534,16002,569,15433,2004,t1,cantonales
13235,83,VAR,26518,14681,854,13827,2004,t1,cantonales
13236,83,VAR,18984,11110,344,10766,2004,t1,cantonales
13237,83,VAR,25686,15781,436,15345,2004,t1,cantonales
13238,83,VAR,17596,10318,403,9915,2004,t1,cantonales
13239,84,VAUCLUSE,15034,9587,336,9251,2004,t1,cantonales
13240,84,VAUCLUSE,12000,7316,289,7027,2004,t1,cantonales
13241,84,VAUCLUSE,3812,2912,103,2809,2004,t1,cantonales
13242,84,VAUCLUSE,23858,15651,545,15106,2004,t1,cantonales
13243,84,VAUCLUSE,3718,2629,132,2497,2004,t1,cantonales
13244,84,VAUCLUSE,12569,8502,360,8142,2004,t1,cantonales
13245,84,VAUCLUSE,19364,12299,526,11773,2004,t1,cantonales
13246,84,VAUCLUSE,26528,17885,734,17151,2004,t1,cantonales
13247,84,VAUCLUSE,3598,2863,94,2769,2004,t1,cantonales
13248,84,VAUCLUSE,6977,5353,186,5167,2004,t1,cantonales
13249,84,VAUCLUSE,18037,12038,507,11531,2004,t1,cantonales
13250,84,VAUCLUSE,21759,13693,486,13207,2004,t1,cantonales
13251,85,VENDEE,6690,4122,249,3873,2004,t1,cantonales
13252,85,VENDEE,5626,3768,157,3611,2004,t1,cantonales
13253,85,VENDEE,21302,12419,703,11716,2004,t1,cantonales
13254,85,VENDEE,12188,7685,486,7199,2004,t1,cantonales
13255,85,VENDEE,13913,9084,518,8566,2004,t1,cantonales
13256,85,VENDEE,18944,12703,707,11996,2004,t1,cantonales
13257,85,VENDEE,6775,4686,230,4456,2004,t1,cantonales
13258,85,VENDEE,4118,2499,134,2365,2004,t1,cantonales
13259,85,VENDEE,8392,5496,216,5280,2004,t1,cantonales
13260,85,VENDEE,18460,12799,632,12167,2004,t1,cantonales
13261,85,VENDEE,7369,5260,260,5000,2004,t1,cantonales
13262,85,VENDEE,20915,13157,567,12590,2004,t1,cantonales
13263,85,VENDEE,35928,20851,1037,19814,2004,t1,cantonales
13264,85,VENDEE,10988,7788,507,7281,2004,t1,cantonales
13265,85,VENDEE,6208,4261,275,3986,2004,t1,cantonales
13266,85,VENDEE,12975,8605,365,8240,2004,t1,cantonales
13267,86,VIENNE,3134,2173,153,2020,2004,t1,cantonales
13268,86,VIENNE,8475,5937,201,5736,2004,t1,cantonales
13269,86,VIENNE,6767,4794,184,4610,2004,t1,cantonales
13270,86,VIENNE,5794,4133,166,3967,2004,t1,cantonales
13271,86,VIENNE,3963,2754,117,2637,2004,t1,cantonales
13272,86,VIENNE,9270,5992,394,5598,2004,t1,cantonales
13273,86,VIENNE,8072,5616,232,5384,2004,t1,cantonales
13274,86,VIENNE,6652,4656,208,4448,2004,t1,cantonales
13275,86,VIENNE,4739,3452,163,3289,2004,t1,cantonales
13276,86,VIENNE,3810,2908,106,2802,2004,t1,cantonales
13277,86,VIENNE,11574,8096,348,7748,2004,t1,cantonales
13278,86,VIENNE,5229,3804,97,3707,2004,t1,cantonales
13279,86,VIENNE,11805,7602,398,7204,2004,t1,cantonales
13280,86,VIENNE,9203,6783,300,6483,2004,t1,cantonales
13281,86,VIENNE,2597,1839,73,1766,2004,t1,cantonales
13282,86,VIENNE,3841,2453,120,2333,2004,t1,cantonales
13283,86,VIENNE,10593,7471,303,7168,2004,t1,cantonales
13284,86,VIENNE,10145,6456,273,6183,2004,t1,cantonales
13285,86,VIENNE,11099,7317,221,7096,2004,t1,cantonales
13286,86,VIENNE,10460,6560,298,6262,2004,t1,cantonales
13287,87,HAUTE VIENNE,13827,9830,612,9218,2004,t1,cantonales
13288,87,HAUTE VIENNE,11648,8110,528,7582,2004,t1,cantonales
13289,87,HAUTE VIENNE,5639,4080,260,3820,2004,t1,cantonales
13290,87,HAUTE VIENNE,3396,2383,150,2233,2004,t1,cantonales
13291,87,HAUTE VIENNE,5110,3865,178,3687,2004,t1,cantonales
13292,87,HAUTE VIENNE,4809,2983,156,2827,2004,t1,cantonales
13293,87,HAUTE VIENNE,5740,3328,149,3179,2004,t1,cantonales
13294,87,HAUTE VIENNE,2967,2165,94,2071,2004,t1,cantonales
13295,87,HAUTE VIENNE,5614,4131,231,3900,2004,t1,cantonales
13296,87,HAUTE VIENNE,5083,3749,242,3507,2004,t1,cantonales
13297,87,HAUTE VIENNE,8344,5883,294,5589,2004,t1,cantonales
13298,87,HAUTE VIENNE,3584,2666,174,2492,2004,t1,cantonales
13299,87,HAUTE VIENNE,7862,5462,290,5172,2004,t1,cantonales
13300,87,HAUTE VIENNE,3628,2309,169,2140,2004,t1,cantonales
13301,87,HAUTE VIENNE,8724,5287,313,4974,2004,t1,cantonales
13302,87,HAUTE VIENNE,9398,6626,428,6198,2004,t1,cantonales
13303,87,HAUTE VIENNE,7315,5246,238,5008,2004,t1,cantonales
13304,87,HAUTE VIENNE,8342,5410,418,4992,2004,t1,cantonales
13305,87,HAUTE VIENNE,15665,11188,693,10495,2004,t1,cantonales
13306,87,HAUTE VIENNE,5882,3679,225,3454,2004,t1,cantonales
13307,87,HAUTE VIENNE,6349,3876,209,3667,2004,t1,cantonales
13308,88,VOSGES,1882,1410,53,1357,2004,t1,cantonales
13309,88,VOSGES,11423,7374,492,6882,2004,t1,cantonales
13310,88,VOSGES,14753,9022,453,8569,2004,t1,cantonales
13311,88,VOSGES,5074,3654,206,3448,2004,t1,cantonales
13312,88,VOSGES,4312,3105,244,2861,2004,t1,cantonales
13313,88,VOSGES,18856,11112,717,10395,2004,t1,cantonales
13314,88,VOSGES,9242,5627,326,5301,2004,t1,cantonales
13315,88,VOSGES,8160,5343,252,5091,2004,t1,cantonales
13316,88,VOSGES,8780,6035,336,5699,2004,t1,cantonales
13317,88,VOSGES,2143,1619,46,1573,2004,t1,cantonales
13318,88,VOSGES,10475,6713,348,6365,2004,t1,cantonales
13319,88,VOSGES,14143,8783,467,8316,2004,t1,cantonales
13320,88,VOSGES,15527,10422,577,9845,2004,t1,cantonales
13321,88,VOSGES,12363,7863,435,7428,2004,t1,cantonales
13322,88,VOSGES,8028,5221,262,4959,2004,t1,cantonales
13323,89,YONNE,9590,5828,262,5566,2004,t1,cantonales
13324,89,YONNE,8573,5512,198,5314,2004,t1,cantonales
13325,89,YONNE,3756,2528,117,2411,2004,t1,cantonales
13326,89,YONNE,2246,1626,30,1596,2004,t1,cantonales
13327,89,YONNE,3496,2244,128,2116,2004,t1,cantonales
13328,89,YONNE,4522,3205,136,3069,2004,t1,cantonales
13329,89,YONNE,2327,1723,52,1671,2004,t1,cantonales
13330,89,YONNE,3736,2331,115,2216,2004,t1,cantonales
13331,89,YONNE,2422,1799,46,1753,2004,t1,cantonales
13332,89,YONNE,3800,2457,103,2354,2004,t1,cantonales
13333,89,YONNE,10961,6901,319,6582,2004,t1,cantonales
13334,89,YONNE,1911,1467,54,1413,2004,t1,cantonales
13335,89,YONNE,4984,3012,170,2842,2004,t1,cantonales
13336,89,YONNE,8045,5049,225,4824,2004,t1,cantonales
13337,89,YONNE,8381,4830,210,4620,2004,t1,cantonales
13338,89,YONNE,5314,3451,192,3259,2004,t1,cantonales
13339,89,YONNE,3754,2574,113,2461,2004,t1,cantonales
13340,89,YONNE,3592,2555,103,2452,2004,t1,cantonales
13341,89,YONNE,6156,3996,154,3842,2004,t1,cantonales
13342,89,YONNE,10601,6003,341,5662,2004,t1,cantonales
13343,89,YONNE,8185,5175,232,4943,2004,t1,cantonales
13344,89,YONNE,8666,5204,232,4972,2004,t1,cantonales
13345,90,TERRITOIRE DE BELFORT,5538,3522,160,3362,2004,t1,cantonales
13346,90,TERRITOIRE DE BELFORT,7187,4906,224,4682,2004,t1,cantonales
13347,90,TERRITOIRE DE BELFORT,6911,4279,162,4117,2004,t1,cantonales
13348,90,TERRITOIRE DE BELFORT,4793,2948,165,2783,2004,t1,cantonales
13349,90,TERRITOIRE DE BELFORT,3968,2454,121,2333,2004,t1,cantonales
13350,90,TERRITOIRE DE BELFORT,7685,5293,246,5047,2004,t1,cantonales
13351,90,TERRITOIRE DE BELFORT,7364,5092,258,4834,2004,t1,cantonales
13352,90,TERRITOIRE DE BELFORT,4136,2700,145,2555,2004,t1,cantonales
13353,91,ESSONNE,24524,15415,444,14971,2004,t1,cantonales
13354,91,ESSONNE,20592,12184,429,11755,2004,t1,cantonales
13355,91,ESSONNE,10951,6717,219,6498,2004,t1,cantonales
13356,91,ESSONNE,10062,6691,221,6470,2004,t1,cantonales
13357,91,ESSONNE,14330,9469,393,9076,2004,t1,cantonales
13358,91,ESSONNE,22243,13508,462,13046,2004,t1,cantonales
13359,91,ESSONNE,11086,7217,203,7014,2004,t1,cantonales
13360,91,ESSONNE,9898,6527,215,6312,2004,t1,cantonales
13361,91,ESSONNE,10135,6707,234,6473,2004,t1,cantonales
13362,91,ESSONNE,22253,14355,462,13893,2004,t1,cantonales
13363,91,ESSONNE,16692,11605,271,11334,2004,t1,cantonales
13364,91,ESSONNE,18771,11802,410,11392,2004,t1,cantonales
13365,91,ESSONNE,21330,13160,313,12847,2004,t1,cantonales
13366,91,ESSONNE,17324,10952,285,10667,2004,t1,cantonales
13367,91,ESSONNE,15294,10219,268,9951,2004,t1,cantonales
13368,91,ESSONNE,14952,9046,277,8769,2004,t1,cantonales
13369,91,ESSONNE,14056,8400,284,8116,2004,t1,cantonales
13370,91,ESSONNE,15967,9855,279,9576,2004,t1,cantonales
13371,91,ESSONNE,9467,5015,188,4827,2004,t1,cantonales
13372,91,ESSONNE,12955,8342,228,8114,2004,t1,cantonales
13373,91,ESSONNE,10001,6344,192,6152,2004,t1,cantonales
13374,92,HAUTS DE SEINE,20065,12592,387,12205,2004,t1,cantonales
13375,92,HAUTS DE SEINE,20210,12413,239,12174,2004,t1,cantonales
13376,92,HAUTS DE SEINE,20724,14229,242,13987,2004,t1,cantonales
13377,92,HAUTS DE SEINE,18704,12365,297,12068,2004,t1,cantonales
13378,92,HAUTS DE SEINE,26118,17223,368,16855,2004,t1,cantonales
13379,92,HAUTS DE SEINE,11498,7341,176,7165,2004,t1,cantonales
13380,92,HAUTS DE SEINE,23866,15300,423,14877,2004,t1,cantonales
13381,92,HAUTS DE SEINE,15181,9925,211,9714,2004,t1,cantonales
13382,92,HAUTS DE SEINE,9910,5965,142,5823,2004,t1,cantonales
13383,92,HAUTS DE SEINE,17166,11970,282,11688,2004,t1,cantonales
13384,92,HAUTS DE SEINE,23567,14678,470,14208,2004,t1,cantonales
13385,92,HAUTS DE SEINE,24326,15529,308,15221,2004,t1,cantonales
13386,92,HAUTS DE SEINE,23409,15439,404,15035,2004,t1,cantonales
13387,92,HAUTS DE SEINE,8623,4817,141,4676,2004,t1,cantonales
13388,92,HAUTS DE SEINE,19780,12268,196,12072,2004,t1,cantonales
13389,92,HAUTS DE SEINE,25571,16039,458,15581,2004,t1,cantonales
13390,92,HAUTS DE SEINE,23723,16928,592,16336,2004,t1,cantonales
13391,92,HAUTS DE SEINE,33719,20009,613,19396,2004,t1,cantonales
13392,92,HAUTS DE SEINE,17319,11400,238,11162,2004,t1,cantonales
13393,92,HAUTS DE SEINE,15465,10517,233,10284,2004,t1,cantonales
13394,92,HAUTS DE SEINE,15699,10729,257,10472,2004,t1,cantonales
13395,92,HAUTS DE SEINE,14077,9530,237,9293,2004,t1,cantonales
13396,92,HAUTS DE SEINE,14856,8971,279,8692,2004,t1,cantonales
13397,93,SEINE SAINT-DENIS,13564,7137,246,6891,2004,t1,cantonales
13398,93,SEINE SAINT-DENIS,22235,11409,324,11085,2004,t1,cantonales
13399,93,SEINE SAINT-DENIS,12225,6778,224,6554,2004,t1,cantonales
13400,93,SEINE SAINT-DENIS,16873,9607,212,9395,2004,t1,cantonales
13401,93,SEINE SAINT-DENIS,20142,11280,294,10986,2004,t1,cantonales
13402,93,SEINE SAINT-DENIS,21043,12450,332,12118,2004,t1,cantonales
13403,93,SEINE SAINT-DENIS,17274,10372,308,10064,2004,t1,cantonales
13404,93,SEINE SAINT-DENIS,14251,8594,225,8369,2004,t1,cantonales
13405,93,SEINE SAINT-DENIS,32408,19402,666,18736,2004,t1,cantonales
13406,93,SEINE SAINT-DENIS,10586,6426,104,6322,2004,t1,cantonales
13407,93,SEINE SAINT-DENIS,19521,11934,373,11561,2004,t1,cantonales
13408,93,SEINE SAINT-DENIS,16458,9602,289,9313,2004,t1,cantonales
13409,93,SEINE SAINT-DENIS,11436,6536,203,6333,2004,t1,cantonales
13410,93,SEINE SAINT-DENIS,21029,11801,434,11367,2004,t1,cantonales
13411,93,SEINE SAINT-DENIS,10780,6000,191,5809,2004,t1,cantonales
13412,93,SEINE SAINT-DENIS,9686,5618,252,5366,2004,t1,cantonales
13413,93,SEINE SAINT-DENIS,18756,10727,369,10358,2004,t1,cantonales
13414,93,SEINE SAINT-DENIS,9068,5480,183,5297,2004,t1,cantonales
13415,93,SEINE SAINT-DENIS,14139,7720,270,7450,2004,t1,cantonales
13416,93,SEINE SAINT-DENIS,14658,7960,251,7709,2004,t1,cantonales
13417,94,VAL DE MARNE,7544,4553,145,4408,2004,t1,cantonales
13418,94,VAL DE MARNE,13536,8666,231,8435,2004,t1,cantonales
13419,94,VAL DE MARNE,24282,15452,398,15054,2004,t1,cantonales
13420,94,VAL DE MARNE,9342,5555,183,5372,2004,t1,cantonales
13421,94,VAL DE MARNE,17530,10757,280,10477,2004,t1,cantonales
13422,94,VAL DE MARNE,14598,8209,266,7943,2004,t1,cantonales
13423,94,VAL DE MARNE,11723,7035,200,6835,2004,t1,cantonales
13424,94,VAL DE MARNE,12842,7440,223,7217,2004,t1,cantonales
13425,94,VAL DE MARNE,15759,9978,317,9661,2004,t1,cantonales
13426,94,VAL DE MARNE,17161,10750,373,10377,2004,t1,cantonales
13427,94,VAL DE MARNE,18765,11808,277,11531,2004,t1,cantonales
13428,94,VAL DE MARNE,19648,11975,294,11681,2004,t1,cantonales
13429,94,VAL DE MARNE,19067,12485,254,12231,2004,t1,cantonales
13430,94,VAL DE MARNE,14514,9521,193,9328,2004,t1,cantonales
13431,94,VAL DE MARNE,11652,6474,204,6270,2004,t1,cantonales
13432,94,VAL DE MARNE,8838,4969,179,4790,2004,t1,cantonales
13433,94,VAL DE MARNE,14004,8732,212,8520,2004,t1,cantonales
13434,94,VAL DE MARNE,17093,9334,325,9009,2004,t1,cantonales
13435,94,VAL DE MARNE,14191,9323,234,9089,2004,t1,cantonales
13436,94,VAL DE MARNE,8284,5135,201,4934,2004,t1,cantonales
13437,94,VAL DE MARNE,12100,7439,183,7256,2004,t1,cantonales
13438,94,VAL DE MARNE,13083,8253,240,8013,2004,t1,cantonales
13439,94,VAL DE MARNE,13155,7417,265,7152,2004,t1,cantonales
13440,94,VAL DE MARNE,8772,4905,167,4738,2004,t1,cantonales
13441,94,VAL DE MARNE,13960,8018,216,7802,2004,t1,cantonales
13442,95,VAL D'OISE,12203,6872,204,6668,2004,t1,cantonales
13443,95,VAL D'OISE,17933,10437,364,10073,2004,t1,cantonales
13444,95,VAL D'OISE,15003,9482,293,9189,2004,t1,cantonales
13445,95,VAL D'OISE,17997,10609,351,10258,2004,t1,cantonales
13446,95,VAL D'OISE,19699,11536,333,11203,2004,t1,cantonales
13447,95,VAL D'OISE,17301,9494,444,9050,2004,t1,cantonales
13448,95,VAL D'OISE,10368,7003,312,6691,2004,t1,cantonales
13449,95,VAL D'OISE,7714,5275,169,5106,2004,t1,cantonales
13450,95,VAL D'OISE,16342,10292,260,10032,2004,t1,cantonales
13451,95,VAL D'OISE,15032,9020,281,8739,2004,t1,cantonales
13452,95,VAL D'OISE,14081,8698,294,8404,2004,t1,cantonales
13453,95,VAL D'OISE,12221,6511,184,6327,2004,t1,cantonales
13454,95,VAL D'OISE,13400,8793,297,8496,2004,t1,cantonales
13455,95,VAL D'OISE,14694,9127,290,8837,2004,t1,cantonales
13456,95,VAL D'OISE,17465,11039,356,10683,2004,t1,cantonales
13457,95,VAL D'OISE,11468,5213,212,5001,2004,t1,cantonales
13458,95,VAL D'OISE,12211,8411,228,8183,2004,t1,cantonales
13459,95,VAL D'OISE,15720,8739,254,8485,2004,t1,cantonales
13460,95,VAL D'OISE,8120,4434,195,4239,2004,t1,cantonales
13461,971,GUADELOUPE,7310,4218,393,3825,2004,t1,cantonales
13462,971,GUADELOUPE,9334,5878,280,5598,2004,t1,cantonales
13463,971,GUADELOUPE,14190,8760,559,8201,2004,t1,cantonales
13464,971,GUADELOUPE,5764,3319,320,2999,2004,t1,cantonales
13465,971,GUADELOUPE,1568,1162,25,1137,2004,t1,cantonales
13466,971,GUADELOUPE,9121,5778,365,5413,2004,t1,cantonales
13467,971,GUADELOUPE,6442,3744,232,3512,2004,t1,cantonales
13468,971,GUADELOUPE,6123,3529,251,3278,2004,t1,cantonales
13469,971,GUADELOUPE,10002,5407,359,5048,2004,t1,cantonales
13470,971,GUADELOUPE,5111,3067,266,2801,2004,t1,cantonales
13471,971,GUADELOUPE,10991,5712,556,5156,2004,t1,cantonales
13472,971,GUADELOUPE,4244,2426,207,2219,2004,t1,cantonales
13473,971,GUADELOUPE,4847,2667,336,2331,2004,t1,cantonales
13474,971,GUADELOUPE,6086,3593,535,3058,2004,t1,cantonales
13475,971,GUADELOUPE,6905,4777,202,4575,2004,t1,cantonales
13476,971,GUADELOUPE,4098,1658,84,1574,2004,t1,cantonales
13477,971,GUADELOUPE,7576,4048,197,3851,2004,t1,cantonales
13478,971,GUADELOUPE,7471,2463,193,2270,2004,t1,cantonales
13479,971,GUADELOUPE,8238,4988,452,4536,2004,t1,cantonales
13480,971,GUADELOUPE,8168,4808,516,4292,2004,t1,cantonales
13481,971,GUADELOUPE,5267,3114,243,2871,2004,t1,cantonales
13482,971,GUADELOUPE,6448,2032,172,1860,2004,t1,cantonales
13483,972,MARTINIQUE,9637,5126,397,4729,2004,t1,cantonales
13484,972,MARTINIQUE,3666,1404,57,1347,2004,t1,cantonales
13485,972,MARTINIQUE,4916,1980,177,1803,2004,t1,cantonales
13486,972,MARTINIQUE,6118,3976,254,3722,2004,t1,cantonales
13487,972,MARTINIQUE,2017,1439,44,1395,2004,t1,cantonales
13488,972,MARTINIQUE,3033,1787,149,1638,2004,t1,cantonales
13489,972,MARTINIQUE,1409,1119,22,1097,2004,t1,cantonales
13490,972,MARTINIQUE,9703,5662,264,5398,2004,t1,cantonales
13491,972,MARTINIQUE,7819,4077,257,3820,2004,t1,cantonales
13492,972,MARTINIQUE,7213,3802,295,3507,2004,t1,cantonales
13493,972,MARTINIQUE,6668,3240,410,2830,2004,t1,cantonales
13494,972,MARTINIQUE,6781,3249,308,2941,2004,t1,cantonales
13495,972,MARTINIQUE,8554,3926,431,3495,2004,t1,cantonales
13496,972,MARTINIQUE,3850,1949,135,1814,2004,t1,cantonales
13497,972,MARTINIQUE,7297,3577,280,3297,2004,t1,cantonales
13498,972,MARTINIQUE,8385,3775,421,3354,2004,t1,cantonales
13499,972,MARTINIQUE,8784,3782,550,3232,2004,t1,cantonales
13500,972,MARTINIQUE,6723,3087,358,2729,2004,t1,cantonales
13501,972,MARTINIQUE,6820,3415,415,3000,2004,t1,cantonales
13502,972,MARTINIQUE,7748,4005,584,3421,2004,t1,cantonales
13503,972,MARTINIQUE,7513,4072,428,3644,2004,t1,cantonales
13504,972,MARTINIQUE,9162,4408,559,3849,2004,t1,cantonales
13505,972,MARTINIQUE,7188,3591,344,3247,2004,t1,cantonales
13506,973,GUYANE,434,309,10,299,2004,t1,cantonales
13507,973,GUYANE,2401,1088,85,1003,2004,t1,cantonales
13508,973,GUYANE,877,591,26,565,2004,t1,cantonales
13509,973,GUYANE,6042,2954,349,2605,2004,t1,cantonales
13510,973,GUYANE,1585,928,31,897,2004,t1,cantonales
13511,973,GUYANE,6640,3371,230,3141,2004,t1,cantonales
13512,973,GUYANE,1285,801,52,749,2004,t1,cantonales
13513,973,GUYANE,1408,1132,41,1091,2004,t1,cantonales
13514,973,GUYANE,3199,1835,58,1777,2004,t1,cantonales
13515,974,LA REUNION,6001,4841,280,4561,2004,t1,cantonales
13516,974,LA REUNION,8368,5967,319,5648,2004,t1,cantonales
13517,974,LA REUNION,10063,5985,402,5583,2004,t1,cantonales
13518,974,LA REUNION,13430,8390,545,7845,2004,t1,cantonales
13519,974,LA REUNION,8201,5411,315,5096,2004,t1,cantonales
13520,974,LA REUNION,9056,5728,406,5322,2004,t1,cantonales
13521,974,LA REUNION,11082,5899,440,5459,2004,t1,cantonales
13522,974,LA REUNION,11197,7838,481,7357,2004,t1,cantonales
13523,974,LA REUNION,10679,7125,390,6735,2004,t1,cantonales
13524,974,LA REUNION,16090,12182,408,11774,2004,t1,cantonales
13525,974,LA REUNION,14722,11001,642,10359,2004,t1,cantonales
13526,974,LA REUNION,4570,3690,67,3623,2004,t1,cantonales
13527,974,LA REUNION,8873,5670,489,5181,2004,t1,cantonales
13528,974,LA REUNION,13350,8439,907,7532,2004,t1,cantonales
13529,974,LA REUNION,3925,2959,128,2831,2004,t1,cantonales
13530,974,LA REUNION,17558,10238,536,9702,2004,t1,cantonales
13531,974,LA REUNION,13512,9715,530,9185,2004,t1,cantonales
13532,974,LA REUNION,5142,3616,192,3424,2004,t1,cantonales
13533,974,LA REUNION,8312,6348,392,5956,2004,t1,cantonales
13534,974,LA REUNION,11012,6612,585,6027,2004,t1,cantonales
13535,974,LA REUNION,7482,4453,229,4224,2004,t1,cantonales
13536,974,LA REUNION,9644,6330,440,5890,2004,t1,cantonales
13537,974,LA REUNION,11149,7250,621,6629,2004,t1,cantonales
13538,974,LA REUNION,13577,7975,690,7285,2004,t1,cantonales
13539,974,LA REUNION,12179,8039,883,7156,2004,t1,cantonales
13540,985,MAYOTTE,2970,1778,27,1751,2004,t1,cantonales
13541,985,MAYOTTE,2594,1661,34,1627,2004,t1,cantonales
13542,985,MAYOTTE,3612,2276,122,2154,2004,t1,cantonales
13543,985,MAYOTTE,2792,1820,58,1762,2004,t1,cantonales
13544,985,MAYOTTE,2453,1717,41,1676,2004,t1,cantonales
13545,985,MAYOTTE,3093,1596,24,1572,2004,t1,cantonales
13546,985,MAYOTTE,3196,2023,33,1990,2004,t1,cantonales
13547,985,MAYOTTE,2377,1370,21,1349,2004,t1,cantonales
13548,985,MAYOTTE,2633,1644,23,1621,2004,t1,cantonales
13549,1,AIN,86218,75087,1070,74017,2007,t1,presidential
13550,1,AIN,92003,77395,1000,76395,2007,t1,presidential
13551,1,AIN,85399,72636,911,71725,2007,t1,presidential
13552,1,AIN,109279,95741,1280,94461,2007,t1,presidential
13553,2,AISNE,72153,60646,853,59793,2007,t1,presidential
13554,2,AISNE,74499,62535,863,61672,2007,t1,presidential
13555,2,AISNE,72034,60030,1003,59027,2007,t1,presidential
13556,2,AISNE,79058,65011,845,64166,2007,t1,presidential
13557,2,AISNE,79731,67279,972,66307,2007,t1,presidential
13558,3,ALLIER,58140,49351,954,48397,2007,t1,presidential
13559,3,ALLIER,66239,55594,1063,54531,2007,t1,presidential
13560,3,ALLIER,70570,61240,1196,60044,2007,t1,presidential
13561,3,ALLIER,64588,55340,928,54412,2007,t1,presidential
13562,4,ALPES-DE-HAUTE-PROVENCE,58333,50484,785,49699,2007,t1,presidential
13563,4,ALPES-DE-HAUTE-PROVENCE,60603,52309,868,51441,2007,t1,presidential
13564,5,HAUTES-ALPES,57317,49483,701,48782,2007,t1,presidential
13565,5,HAUTES-ALPES,45638,39044,503,38541,2007,t1,presidential
13566,6,ALPES-MARITIMES,57415,46808,483,46325,2007,t1,presidential
13567,6,ALPES-MARITIMES,60941,49784,423,49361,2007,t1,presidential
13568,6,ALPES-MARITIMES,69198,56745,520,56225,2007,t1,presidential
13569,6,ALPES-MARITIMES,72344,58371,596,57775,2007,t1,presidential
13570,6,ALPES-MARITIMES,86204,72506,775,71731,2007,t1,presidential
13571,6,ALPES-MARITIMES,106182,88986,984,88002,2007,t1,presidential
13572,6,ALPES-MARITIMES,97077,81391,826,80565,2007,t1,presidential
13573,6,ALPES-MARITIMES,66956,55852,540,55312,2007,t1,presidential
13574,6,ALPES-MARITIMES,105399,88881,923,87958,2007,t1,presidential
13575,7,ARDECHE,73603,63579,938,62641,2007,t1,presidential
13576,7,ARDECHE,88727,77597,1087,76510,2007,t1,presidential
13577,7,ARDECHE,73248,63556,825,62731,2007,t1,presidential
13578,8,ARDENNES,73307,60672,739,59933,2007,t1,presidential
13579,8,ARDENNES,66013,53098,619,52479,2007,t1,presidential
13580,8,ARDENNES,59795,49800,614,49186,2007,t1,presidential
13581,9,ARIEGE,55755,48463,709,47754,2007,t1,presidential
13582,9,ARIEGE,58076,50739,835,49904,2007,t1,presidential
13583,10,AUBE,57799,48494,682,47812,2007,t1,presidential
13584,10,AUBE,73077,61429,720,60709,2007,t1,presidential
13585,10,AUBE,73816,61239,759,60480,2007,t1,presidential
13586,11,AUDE,70005,60725,838,59887,2007,t1,presidential
13587,11,AUDE,110355,94324,1313,93011,2007,t1,presidential
13588,11,AUDE,74044,64890,906,63984,2007,t1,presidential
13589,12,AVEYRON,74415,66162,1007,65155,2007,t1,presidential
13590,12,AVEYRON,71656,62470,1045,61425,2007,t1,presidential
13591,12,AVEYRON,71910,63657,1237,62420,2007,t1,presidential
13592,13,BOUCHES-DU-RHONE,59972,49994,524,49470,2007,t1,presidential
13593,13,BOUCHES-DU-RHONE,64672,54826,464,54362,2007,t1,presidential
13594,13,BOUCHES-DU-RHONE,46096,37526,380,37146,2007,t1,presidential
13595,13,BOUCHES-DU-RHONE,47757,37808,390,37418,2007,t1,presidential
13596,13,BOUCHES-DU-RHONE,53751,44392,497,43895,2007,t1,presidential
13597,13,BOUCHES-DU-RHONE,69625,58443,639,57804,2007,t1,presidential
13598,13,BOUCHES-DU-RHONE,51792,41491,445,41046,2007,t1,presidential
13599,13,BOUCHES-DU-RHONE,73740,61349,713,60636,2007,t1,presidential
13600,13,BOUCHES-DU-RHONE,88927,75383,1016,74367,2007,t1,presidential
13601,13,BOUCHES-DU-RHONE,123209,103617,1265,102352,2007,t1,presidential
13602,13,BOUCHES-DU-RHONE,99240,84212,951,83261,2007,t1,presidential
13603,13,BOUCHES-DU-RHONE,108677,90249,1275,88974,2007,t1,presidential
13604,13,BOUCHES-DU-RHONE,88944,74926,1056,73870,2007,t1,presidential
13605,13,BOUCHES-DU-RHONE,100719,85275,1009,84266,2007,t1,presidential
13606,13,BOUCHES-DU-RHONE,99618,86014,1087,84927,2007,t1,presidential
13607,13,BOUCHES-DU-RHONE,84177,71449,1004,70445,2007,t1,presidential
13608,14,CALVADOS,70487,61610,657,60953,2007,t1,presidential
13609,14,CALVADOS,67102,57365,746,56619,2007,t1,presidential
13610,14,CALVADOS,74192,62636,853,61783,2007,t1,presidential
13611,14,CALVADOS,81421,70023,832,69191,2007,t1,presidential
13612,14,CALVADOS,101041,87820,967,86853,2007,t1,presidential
13613,14,CALVADOS,88434,77702,2197,75505,2007,t1,presidential
13614,15,CANTAL,64700,56075,900,55175,2007,t1,presidential
13615,15,CANTAL,58663,49775,865,48910,2007,t1,presidential
13616,16,CHARENTE,63423,53026,778,52248,2007,t1,presidential
13617,16,CHARENTE,62254,52541,744,51797,2007,t1,presidential
13618,16,CHARENTE,69019,59386,1056,58330,2007,t1,presidential
13619,16,CHARENTE,65060,55215,842,54373,2007,t1,presidential
13620,17,CHARENTE-MARITIME,95878,81552,914,80638,2007,t1,presidential
13621,17,CHARENTE-MARITIME,92011,78202,1040,77162,2007,t1,presidential
13622,17,CHARENTE-MARITIME,79631,67421,994,66427,2007,t1,presidential
13623,17,CHARENTE-MARITIME,85639,72559,1182,71377,2007,t1,presidential
13624,17,CHARENTE-MARITIME,100235,84878,1228,83650,2007,t1,presidential
13625,18,CHER,74886,61662,1088,60574,2007,t1,presidential
13626,18,CHER,70004,57560,941,56619,2007,t1,presidential
13627,18,CHER,87411,72268,1288,70980,2007,t1,presidential
13628,19,CORREZE,65881,58307,1056,57251,2007,t1,presidential
13629,19,CORREZE,69450,59399,1088,58311,2007,t1,presidential
13630,19,CORREZE,51902,45213,866,44347,2007,t1,presidential
13631,2A,CORSE-DU-SUD,44836,33853,499,33354,2007,t1,presidential
13632,2A,CORSE-DU-SUD,49719,37624,533,37091,2007,t1,presidential
13633,2B,HAUTE-CORSE,51489,39605,580,39025,2007,t1,presidential
13634,2B,HAUTE-CORSE,60350,44751,650,44101,2007,t1,presidential
13635,21,COTE-D'OR,66700,57998,559,57439,2007,t1,presidential
13636,21,COTE-D'OR,64112,54954,650,54304,2007,t1,presidential
13637,21,COTE-D'OR,68301,58043,724,57319,2007,t1,presidential
13638,21,COTE-D'OR,69290,59349,750,58599,2007,t1,presidential
13639,21,COTE-D'OR,81115,68961,865,68096,2007,t1,presidential
13640,22,COTES-D'ARMOR,88249,76924,970,75954,2007,t1,presidential
13641,22,COTES-D'ARMOR,91048,80935,1135,79800,2007,t1,presidential
13642,22,COTES-D'ARMOR,85448,76238,1043,75195,2007,t1,presidential
13643,22,COTES-D'ARMOR,79756,70477,874,69603,2007,t1,presidential
13644,22,COTES-D'ARMOR,101405,89245,977,88268,2007,t1,presidential
13645,23,CREUSE,50842,42404,854,41550,2007,t1,presidential
13646,23,CREUSE,48957,40872,837,40035,2007,t1,presidential
13647,24,DORDOGNE,74535,65337,1042,64295,2007,t1,presidential
13648,24,DORDOGNE,78824,69332,1126,68206,2007,t1,presidential
13649,24,DORDOGNE,70255,62458,1242,61216,2007,t1,presidential
13650,24,DORDOGNE,85492,75864,1143,74721,2007,t1,presidential
13651,25,DOUBS,71039,60742,770,59972,2007,t1,presidential
13652,25,DOUBS,74841,64255,804,63451,2007,t1,presidential
13653,25,DOUBS,65821,56165,879,55286,2007,t1,presidential
13654,25,DOUBS,67297,57079,876,56203,2007,t1,presidential
13655,25,DOUBS,74134,64834,971,63863,2007,t1,presidential
13656,26,DROME,72931,61088,816,60272,2007,t1,presidential
13657,26,DROME,88127,75991,1054,74937,2007,t1,presidential
13658,26,DROME,91734,80778,1116,79662,2007,t1,presidential
13659,26,DROME,85297,73721,1002,72719,2007,t1,presidential
13660,27,EURE,83090,70130,909,69221,2007,t1,presidential
13661,27,EURE,74559,63626,841,62785,2007,t1,presidential
13662,27,EURE,78059,66893,962,65931,2007,t1,presidential
13663,27,EURE,83193,69598,972,68626,2007,t1,presidential
13664,27,EURE,85363,71071,924,70147,2007,t1,presidential
13665,28,EURE-ET-LOIR,85111,71593,942,70651,2007,t1,presidential
13666,28,EURE-ET-LOIR,69916,57909,755,57154,2007,t1,presidential
13667,28,EURE-ET-LOIR,71088,59245,926,58319,2007,t1,presidential
13668,28,EURE-ET-LOIR,67736,57939,876,57063,2007,t1,presidential
13669,29,FINISTERE,84255,75134,871,74263,2007,t1,presidential
13670,29,FINISTERE,71216,60083,743,59340,2007,t1,presidential
13671,29,FINISTERE,92228,80447,896,79551,2007,t1,presidential
13672,29,FINISTERE,82203,72302,710,71592,2007,t1,presidential
13673,29,FINISTERE,88418,78856,861,77995,2007,t1,presidential
13674,29,FINISTERE,88547,77707,820,76887,2007,t1,presidential
13675,29,FINISTERE,79098,68384,773,67611,2007,t1,presidential
13676,29,FINISTERE,81697,70571,941,69630,2007,t1,presidential
13677,30,GARD,82547,69059,698,68361,2007,t1,presidential
13678,30,GARD,114130,98830,1121,97709,2007,t1,presidential
13679,30,GARD,113534,98339,1255,97084,2007,t1,presidential
13680,30,GARD,85284,73282,1100,72182,2007,t1,presidential
13681,30,GARD,93404,81934,1100,80834,2007,t1,presidential
13682,31,HAUTE-GARONNE,69211,57909,525,57384,2007,t1,presidential
13683,31,HAUTE-GARONNE,110031,96783,1047,95736,2007,t1,presidential
13684,31,HAUTE-GARONNE,84780,74811,772,74039,2007,t1,presidential
13685,31,HAUTE-GARONNE,54734,45784,459,45325,2007,t1,presidential
13686,31,HAUTE-GARONNE,137601,121810,1540,120270,2007,t1,presidential
13687,31,HAUTE-GARONNE,129182,114111,1359,112752,2007,t1,presidential
13688,31,HAUTE-GARONNE,120993,108580,1493,107087,2007,t1,presidential
13689,31,HAUTE-GARONNE,82662,70850,1188,69662,2007,t1,presidential
13690,32,GERS,71994,63713,1026,62687,2007,t1,presidential
13691,32,GERS,68330,60295,972,59323,2007,t1,presidential
13692,33,GIRONDE,81734,70507,662,69845,2007,t1,presidential
13693,33,GIRONDE,59354,50675,438,50237,2007,t1,presidential
13694,33,GIRONDE,71682,62150,742,61408,2007,t1,presidential
13695,33,GIRONDE,82347,70664,886,69778,2007,t1,presidential
13696,33,GIRONDE,95246,83516,1047,82469,2007,t1,presidential
13697,33,GIRONDE,88629,79260,870,78390,2007,t1,presidential
13698,33,GIRONDE,95981,85763,969,84794,2007,t1,presidential
13699,33,GIRONDE,118814,103823,1186,102637,2007,t1,presidential
13700,33,GIRONDE,98595,87238,1274,85964,2007,t1,presidential
13701,33,GIRONDE,78370,68104,965,67139,2007,t1,presidential
13702,33,GIRONDE,82774,71838,1065,70773,2007,t1,presidential
13703,34,HERAULT,75866,63889,664,63225,2007,t1,presidential
13704,34,HERAULT,66213,55615,598,55017,2007,t1,presidential
13705,34,HERAULT,125026,109413,1248,108165,2007,t1,presidential
13706,34,HERAULT,133693,117217,1439,115778,2007,t1,presidential
13707,34,HERAULT,95567,82368,1182,81186,2007,t1,presidential
13708,34,HERAULT,84022,70905,923,69982,2007,t1,presidential
13709,34,HERAULT,119297,101517,1459,100058,2007,t1,presidential
13710,35,ILLE-ET-VILAINE,73815,63979,620,63359,2007,t1,presidential
13711,35,ILLE-ET-VILAINE,97459,86465,874,85591,2007,t1,presidential
13712,35,ILLE-ET-VILAINE,90789,81017,944,80073,2007,t1,presidential
13713,35,ILLE-ET-VILAINE,109189,96642,1268,95374,2007,t1,presidential
13714,35,ILLE-ET-VILAINE,118144,105322,1463,103859,2007,t1,presidential
13715,35,ILLE-ET-VILAINE,77722,68347,1083,67264,2007,t1,presidential
13716,35,ILLE-ET-VILAINE,98528,82883,1167,81716,2007,t1,presidential
13717,36,INDRE,56103,46749,929,45820,2007,t1,presidential
13718,36,INDRE,64607,55059,1229,53830,2007,t1,presidential
13719,36,INDRE,56624,48409,974,47435,2007,t1,presidential
13720,37,INDRE-ET-LOIRE,53981,44868,446,44422,2007,t1,presidential
13721,37,INDRE-ET-LOIRE,91686,79291,1143,78148,2007,t1,presidential
13722,37,INDRE-ET-LOIRE,92147,79462,1251,78211,2007,t1,presidential
13723,37,INDRE-ET-LOIRE,86128,73463,1129,72334,2007,t1,presidential
13724,37,INDRE-ET-LOIRE,77736,66909,908,66001,2007,t1,presidential
13725,38,ISERE,78179,68281,621,67660,2007,t1,presidential
13726,38,ISERE,72527,63213,716,62497,2007,t1,presidential
13727,38,ISERE,59659,50914,514,50400,2007,t1,presidential
13728,38,ISERE,85050,73808,880,72928,2007,t1,presidential
13729,38,ISERE,92601,80888,1007,79881,2007,t1,presidential
13730,38,ISERE,105702,89965,1301,88664,2007,t1,presidential
13731,38,ISERE,99757,85979,1273,84706,2007,t1,presidential
13732,38,ISERE,102168,87346,1370,85976,2007,t1,presidential
13733,38,ISERE,88556,76465,1119,75346,2007,t1,presidential
13734,39,JURA,64394,55123,842,54281,2007,t1,presidential
13735,39,JURA,55147,47244,984,46260,2007,t1,presidential
13736,39,JURA,67542,58885,866,58019,2007,t1,presidential
13737,40,LANDES,92687,80381,1137,79244,2007,t1,presidential
13738,40,LANDES,107297,93771,1226,92545,2007,t1,presidential
13739,40,LANDES,83087,74033,1178,72855,2007,t1,presidential
13740,41,LOIR-ET-CHER,90113,76463,1055,75408,2007,t1,presidential
13741,41,LOIR-ET-CHER,79812,67835,1170,66665,2007,t1,presidential
13742,41,LOIR-ET-CHER,70617,60844,1019,59825,2007,t1,presidential
13743,42,LOIRE,68538,57661,646,57015,2007,t1,presidential
13744,42,LOIRE,49784,40823,384,40439,2007,t1,presidential
13745,42,LOIRE,78765,67334,906,66428,2007,t1,presidential
13746,42,LOIRE,68958,58042,840,57202,2007,t1,presidential
13747,42,LOIRE,68975,59108,1034,58074,2007,t1,presidential
13748,42,LOIRE,69274,60484,1031,59453,2007,t1,presidential
13749,42,LOIRE,101571,88393,1297,87096,2007,t1,presidential
13750,43,HAUTE-LOIRE,92988,81594,1462,80132,2007,t1,presidential
13751,43,HAUTE-LOIRE,80270,69302,1161,68141,2007,t1,presidential
13752,44,LOIRE-ATLANTIQUE,71997,61373,562,60811,2007,t1,presidential
13753,44,LOIRE-ATLANTIQUE,81658,68345,558,67787,2007,t1,presidential
13754,44,LOIRE-ATLANTIQUE,86360,73523,805,72718,2007,t1,presidential
13755,44,LOIRE-ATLANTIQUE,79130,68391,731,67660,2007,t1,presidential
13756,44,LOIRE-ATLANTIQUE,114315,101848,1323,100525,2007,t1,presidential
13757,44,LOIRE-ATLANTIQUE,76979,67775,1031,66744,2007,t1,presidential
13758,44,LOIRE-ATLANTIQUE,105145,92238,1089,91149,2007,t1,presidential
13759,44,LOIRE-ATLANTIQUE,78691,67395,761,66634,2007,t1,presidential
13760,44,LOIRE-ATLANTIQUE,99080,87729,1168,86561,2007,t1,presidential
13761,44,LOIRE-ATLANTIQUE,98661,89417,1245,88172,2007,t1,presidential
13762,45,LOIRET,82053,69887,855,69032,2007,t1,presidential
13763,45,LOIRET,81250,67768,870,66898,2007,t1,presidential
13764,45,LOIRET,89469,75839,1037,74802,2007,t1,presidential
13765,45,LOIRET,93383,78123,1106,77017,2007,t1,presidential
13766,45,LOIRET,89503,76452,1126,75326,2007,t1,presidential
13767,46,LOT,68531,60778,804,59974,2007,t1,presidential
13768,46,LOT,64365,57523,983,56540,2007,t1,presidential
13769,47,LOT-ET-GARONNE,85547,75352,1004,74348,2007,t1,presidential
13770,47,LOT-ET-GARONNE,77458,67088,1083,66005,2007,t1,presidential
13771,47,LOT-ET-GARONNE,75994,66023,963,65060,2007,t1,presidential
13772,48,LOZERE,32091,27800,383,27417,2007,t1,presidential
13773,48,LOZERE,27925,24870,362,24508,2007,t1,presidential
13774,49,MAINE-ET-LOIRE,79133,69369,901,68468,2007,t1,presidential
13775,49,MAINE-ET-LOIRE,85072,74986,1147,73839,2007,t1,presidential
13776,49,MAINE-ET-LOIRE,67572,58504,1086,57418,2007,t1,presidential
13777,49,MAINE-ET-LOIRE,71992,62606,1184,61422,2007,t1,presidential
13778,49,MAINE-ET-LOIRE,74046,65164,1051,64113,2007,t1,presidential
13779,49,MAINE-ET-LOIRE,89627,79903,1377,78526,2007,t1,presidential
13780,49,MAINE-ET-LOIRE,72460,63858,1046,62812,2007,t1,presidential
13781,50,MANCHE,74303,64233,991,63242,2007,t1,presidential
13782,50,MANCHE,75906,66156,1187,64969,2007,t1,presidential
13783,50,MANCHE,76686,65901,950,64951,2007,t1,presidential
13784,50,MANCHE,73117,63066,1400,61666,2007,t1,presidential
13785,50,MANCHE,71769,60930,744,60186,2007,t1,presidential
13786,51,MARNE,57287,45322,715,44607,2007,t1,presidential
13787,51,MARNE,67062,55124,785,54339,2007,t1,presidential
13788,51,MARNE,65357,53222,793,52429,2007,t1,presidential
13789,51,MARNE,61010,48690,612,48078,2007,t1,presidential
13790,51,MARNE,63724,53822,728,53094,2007,t1,presidential
13791,51,MARNE,67847,55018,726,54292,2007,t1,presidential
13792,52,HAUTE-MARNE,76229,63888,1094,62794,2007,t1,presidential
13793,52,HAUTE-MARNE,66124,54200,987,53213,2007,t1,presidential
13794,53,MAYENNE,81387,71016,1214,69802,2007,t1,presidential
13795,53,MAYENNE,66836,58438,1180,57258,2007,t1,presidential
13796,53,MAYENNE,71799,62697,1232,61465,2007,t1,presidential
13797,54,MEURTHE-ET-MOSELLE,52437,43358,451,42907,2007,t1,presidential
13798,54,MEURTHE-ET-MOSELLE,77904,66195,762,65433,2007,t1,presidential
13799,54,MEURTHE-ET-MOSELLE,57961,48371,521,47850,2007,t1,presidential
13800,54,MEURTHE-ET-MOSELLE,77744,65523,882,64641,2007,t1,presidential
13801,54,MEURTHE-ET-MOSELLE,75127,64673,850,63823,2007,t1,presidential
13802,54,MEURTHE-ET-MOSELLE,78151,65504,910,64594,2007,t1,presidential
13803,54,MEURTHE-ET-MOSELLE,70924,57476,668,56808,2007,t1,presidential
13804,55,MEUSE,79829,68821,1019,67802,2007,t1,presidential
13805,55,MEUSE,61438,51489,727,50762,2007,t1,presidential
13806,56,MORBIHAN,104038,92165,948,91217,2007,t1,presidential
13807,56,MORBIHAN,92762,81826,967,80859,2007,t1,presidential
13808,56,MORBIHAN,83298,73733,1049,72684,2007,t1,presidential
13809,56,MORBIHAN,87068,76273,922,75351,2007,t1,presidential
13810,56,MORBIHAN,80871,67117,945,66172,2007,t1,presidential
13811,56,MORBIHAN,86864,76215,1089,75126,2007,t1,presidential
13812,57,MOSELLE,74016,60534,763,59771,2007,t1,presidential
13813,57,MOSELLE,75089,62267,735,61532,2007,t1,presidential
13814,57,MOSELLE,72416,59157,662,58495,2007,t1,presidential
13815,57,MOSELLE,69711,59313,1017,58296,2007,t1,presidential
13816,57,MOSELLE,75112,61594,1294,60300,2007,t1,presidential
13817,57,MOSELLE,73096,57695,930,56765,2007,t1,presidential
13818,57,MOSELLE,79664,65980,987,64993,2007,t1,presidential
13819,57,MOSELLE,76210,64142,941,63201,2007,t1,presidential
13820,57,MOSELLE,73230,60051,806,59245,2007,t1,presidential
13821,57,MOSELLE,70345,56165,832,55333,2007,t1,presidential
13822,58,NIEVRE,55414,45656,757,44899,2007,t1,presidential
13823,58,NIEVRE,60493,51016,688,50328,2007,t1,presidential
13824,58,NIEVRE,53427,45002,709,44293,2007,t1,presidential
13825,59,NORD,58070,45203,537,44666,2007,t1,presidential
13826,59,NORD,72905,59004,682,58322,2007,t1,presidential
13827,59,NORD,63378,50630,513,50117,2007,t1,presidential
13828,59,NORD,72349,59099,697,58402,2007,t1,presidential
13829,59,NORD,87818,71811,987,70824,2007,t1,presidential
13830,59,NORD,80699,68857,812,68045,2007,t1,presidential
13831,59,NORD,70473,54897,757,54140,2007,t1,presidential
13832,59,NORD,71325,54015,777,53238,2007,t1,presidential
13833,59,NORD,69325,54890,553,54337,2007,t1,presidential
13834,59,NORD,77864,60449,898,59551,2007,t1,presidential
13835,59,NORD,86499,70823,1008,69815,2007,t1,presidential
13836,59,NORD,70093,56264,1153,55111,2007,t1,presidential
13837,59,NORD,64683,53325,850,52475,2007,t1,presidential
13838,59,NORD,74056,63185,1002,62183,2007,t1,presidential
13839,59,NORD,73735,60747,1156,59591,2007,t1,presidential
13840,59,NORD,82093,67153,1081,66072,2007,t1,presidential
13841,59,NORD,74900,60597,896,59701,2007,t1,presidential
13842,59,NORD,79181,65007,953,64054,2007,t1,presidential
13843,59,NORD,79894,64477,963,63514,2007,t1,presidential
13844,59,NORD,82402,65205,1032,64173,2007,t1,presidential
13845,59,NORD,78428,62153,926,61227,2007,t1,presidential
13846,59,NORD,74960,62631,932,61699,2007,t1,presidential
13847,59,NORD,66141,52986,722,52264,2007,t1,presidential
13848,59,NORD,64799,52002,783,51219,2007,t1,presidential
13849,60,OISE,79106,66784,986,65798,2007,t1,presidential
13850,60,OISE,83722,71048,1037,70011,2007,t1,presidential
13851,60,OISE,69495,57589,735,56854,2007,t1,presidential
13852,60,OISE,88218,73175,774,72401,2007,t1,presidential
13853,60,OISE,69400,58122,864,57258,2007,t1,presidential
13854,60,OISE,73366,60610,733,59877,2007,t1,presidential
13855,60,OISE,73445,60920,773,60147,2007,t1,presidential
13856,61,ORNE,72260,62142,973,61169,2007,t1,presidential
13857,61,ORNE,70336,59943,841,59102,2007,t1,presidential
13858,61,ORNE,73810,63730,865,62865,2007,t1,presidential
13859,62,PAS-DE-CALAIS,79597,68475,1050,67425,2007,t1,presidential
13860,62,PAS-DE-CALAIS,76222,65722,988,64734,2007,t1,presidential
13861,62,PAS-DE-CALAIS,75236,66275,1144,65131,2007,t1,presidential
13862,62,PAS-DE-CALAIS,78651,66364,1093,65271,2007,t1,presidential
13863,62,PAS-DE-CALAIS,64493,53129,740,52389,2007,t1,presidential
13864,62,PAS-DE-CALAIS,73438,60220,863,59357,2007,t1,presidential
13865,62,PAS-DE-CALAIS,85729,69463,1225,68238,2007,t1,presidential
13866,62,PAS-DE-CALAIS,68902,57749,1144,56605,2007,t1,presidential
13867,62,PAS-DE-CALAIS,80795,66895,1131,65764,2007,t1,presidential
13868,62,PAS-DE-CALAIS,72354,57343,1179,56164,2007,t1,presidential
13869,62,PAS-DE-CALAIS,96353,79629,1446,78183,2007,t1,presidential
13870,62,PAS-DE-CALAIS,78787,62347,1173,61174,2007,t1,presidential
13871,62,PAS-DE-CALAIS,72407,56923,1105,55818,2007,t1,presidential
13872,62,PAS-DE-CALAIS,75498,60076,1044,59032,2007,t1,presidential
13873,63,PUY-DE-DOME,61187,52012,797,51215,2007,t1,presidential
13874,63,PUY-DE-DOME,76265,67053,1021,66032,2007,t1,presidential
13875,63,PUY-DE-DOME,73945,64463,882,63581,2007,t1,presidential
13876,63,PUY-DE-DOME,77488,68033,1145,66888,2007,t1,presidential
13877,63,PUY-DE-DOME,66225,56684,1207,55477,2007,t1,presidential
13878,63,PUY-DE-DOME,88150,77523,1220,76303,2007,t1,presidential
13879,64,PYRENEES-ATLANTIQUES,67726,59380,606,58774,2007,t1,presidential
13880,64,PYRENEES-ATLANTIQUES,73711,65945,743,65202,2007,t1,presidential
13881,64,PYRENEES-ATLANTIQUES,79821,70735,899,69836,2007,t1,presidential
13882,64,PYRENEES-ATLANTIQUES,80071,69919,831,69088,2007,t1,presidential
13883,64,PYRENEES-ATLANTIQUES,82514,70721,844,69877,2007,t1,presidential
13884,64,PYRENEES-ATLANTIQUES,90829,77123,997,76126,2007,t1,presidential
13885,65,HAUTES-PYRENEES,60046,51885,817,51068,2007,t1,presidential
13886,65,HAUTES-PYRENEES,62965,55021,690,54331,2007,t1,presidential
13887,65,HAUTES-PYRENEES,53268,45892,658,45234,2007,t1,presidential
13888,66,PYRENEES-ORIENTALES,65728,54758,701,54057,2007,t1,presidential
13889,66,PYRENEES-ORIENTALES,96325,83006,1145,81861,2007,t1,presidential
13890,66,PYRENEES-ORIENTALES,65488,54727,785,53942,2007,t1,presidential
13891,66,PYRENEES-ORIENTALES,87228,75100,1098,74002,2007,t1,presidential
13892,67,BAS-RHIN,51238,42272,319,41953,2007,t1,presidential
13893,67,BAS-RHIN,50749,41118,386,40732,2007,t1,presidential
13894,67,BAS-RHIN,66223,53722,523,53199,2007,t1,presidential
13895,67,BAS-RHIN,113573,94938,964,93974,2007,t1,presidential
13896,67,BAS-RHIN,98504,82208,1325,80883,2007,t1,presidential
13897,67,BAS-RHIN,80391,67837,1024,66813,2007,t1,presidential
13898,67,BAS-RHIN,82489,68759,1194,67565,2007,t1,presidential
13899,67,BAS-RHIN,70250,57971,1239,56732,2007,t1,presidential
13900,67,BAS-RHIN,103920,87222,1229,85993,2007,t1,presidential
13901,68,HAUT-RHIN,71454,58609,806,57803,2007,t1,presidential
13902,68,HAUT-RHIN,74606,63306,1006,62300,2007,t1,presidential
13903,68,HAUT-RHIN,82848,70896,1115,69781,2007,t1,presidential
13904,68,HAUT-RHIN,72233,59749,870,58879,2007,t1,presidential
13905,68,HAUT-RHIN,54455,42495,649,41846,2007,t1,presidential
13906,68,HAUT-RHIN,74542,60336,940,59396,2007,t1,presidential
13907,68,HAUT-RHIN,76739,64493,1077,63416,2007,t1,presidential
13908,69,RHONE,63143,54309,494,53815,2007,t1,presidential
13909,69,RHONE,70563,61062,475,60587,2007,t1,presidential
13910,69,RHONE,66505,57207,500,56707,2007,t1,presidential
13911,69,RHONE,74041,64458,503,63955,2007,t1,presidential
13912,69,RHONE,83172,73330,635,72695,2007,t1,presidential
13913,69,RHONE,74007,62431,615,61816,2007,t1,presidential
13914,69,RHONE,60237,50151,540,49611,2007,t1,presidential
13915,69,RHONE,81918,72015,888,71127,2007,t1,presidential
13916,69,RHONE,80391,69156,919,68237,2007,t1,presidential
13917,69,RHONE,89347,79531,830,78701,2007,t1,presidential
13918,69,RHONE,79840,70232,847,69385,2007,t1,presidential
13919,69,RHONE,73622,63708,569,63139,2007,t1,presidential
13920,69,RHONE,90809,77568,856,76712,2007,t1,presidential
13921,69,RHONE,50040,41296,506,40790,2007,t1,presidential
13922,70,HAUTE-SAONE,63861,55154,829,54325,2007,t1,presidential
13923,70,HAUTE-SAONE,63966,54717,1038,53679,2007,t1,presidential
13924,70,HAUTE-SAONE,51679,44000,916,43084,2007,t1,presidential
13925,71,SAONE-ET-LOIRE,67123,56220,929,55291,2007,t1,presidential
13926,71,SAONE-ET-LOIRE,64342,54403,1011,53392,2007,t1,presidential
13927,71,SAONE-ET-LOIRE,66622,56489,1033,55456,2007,t1,presidential
13928,71,SAONE-ET-LOIRE,61737,50713,873,49840,2007,t1,presidential
13929,71,SAONE-ET-LOIRE,64190,52484,829,51655,2007,t1,presidential
13930,71,SAONE-ET-LOIRE,84932,71958,1346,70612,2007,t1,presidential
13931,72,SARTHE,71186,60738,1109,59629,2007,t1,presidential
13932,72,SARTHE,81934,68234,1531,66703,2007,t1,presidential
13933,72,SARTHE,83882,71797,1574,70223,2007,t1,presidential
13934,72,SARTHE,77754,66357,1336,65021,2007,t1,presidential
13935,72,SARTHE,86572,73882,1534,72348,2007,t1,presidential
13936,73,SAVOIE,108331,93443,1204,92239,2007,t1,presidential
13937,73,SAVOIE,84324,72241,1073,71168,2007,t1,presidential
13938,73,SAVOIE,95293,82594,1136,81458,2007,t1,presidential
13939,74,HAUTE-SAVOIE,103334,90399,1240,89159,2007,t1,presidential
13940,74,HAUTE-SAVOIE,86086,74131,866,73265,2007,t1,presidential
13941,74,HAUTE-SAVOIE,85959,72500,903,71597,2007,t1,presidential
13942,74,HAUTE-SAVOIE,91740,77420,944,76476,2007,t1,presidential
13943,74,HAUTE-SAVOIE,105703,89606,1171,88435,2007,t1,presidential
13944,75,PARIS,61427,53779,434,53345,2007,t1,presidential
13945,75,PARIS,52071,46463,366,46097,2007,t1,presidential
13946,75,PARIS,42419,37530,242,37288,2007,t1,presidential
13947,75,PARIS,57939,50852,391,50461,2007,t1,presidential
13948,75,PARIS,48573,42197,349,41848,2007,t1,presidential
13949,75,PARIS,64987,56513,469,56044,2007,t1,presidential
13950,75,PARIS,62754,55154,402,54752,2007,t1,presidential
13951,75,PARIS,69759,61407,548,60859,2007,t1,presidential
13952,75,PARIS,60912,53208,596,52612,2007,t1,presidential
13953,75,PARIS,63955,56712,479,56233,2007,t1,presidential
13954,75,PARIS,58930,51749,422,51327,2007,t1,presidential
13955,75,PARIS,66034,58216,384,57832,2007,t1,presidential
13956,75,PARIS,69401,61004,488,60516,2007,t1,presidential
13957,75,PARIS,49207,43348,268,43080,2007,t1,presidential
13958,75,PARIS,41992,36712,190,36522,2007,t1,presidential
13959,75,PARIS,54019,47822,293,47529,2007,t1,presidential
13960,75,PARIS,55561,48000,476,47524,2007,t1,presidential
13961,75,PARIS,55102,47713,372,47341,2007,t1,presidential
13962,75,PARIS,47498,40174,458,39716,2007,t1,presidential
13963,75,PARIS,65080,55671,487,55184,2007,t1,presidential
13964,75,PARIS,74373,64050,619,63431,2007,t1,presidential
13965,76,SEINE-MARITIME,60590,49708,538,49170,2007,t1,presidential
13966,76,SEINE-MARITIME,87197,74074,815,73259,2007,t1,presidential
13967,76,SEINE-MARITIME,56739,47598,683,46915,2007,t1,presidential
13968,76,SEINE-MARITIME,72247,60572,910,59662,2007,t1,presidential
13969,76,SEINE-MARITIME,88820,74784,1100,73684,2007,t1,presidential
13970,76,SEINE-MARITIME,78984,64655,949,63706,2007,t1,presidential
13971,76,SEINE-MARITIME,58586,46907,752,46155,2007,t1,presidential
13972,76,SEINE-MARITIME,52034,39678,789,38889,2007,t1,presidential
13973,76,SEINE-MARITIME,85233,72160,1004,71156,2007,t1,presidential
13974,76,SEINE-MARITIME,84676,72912,1070,71842,2007,t1,presidential
13975,76,SEINE-MARITIME,75368,63526,938,62588,2007,t1,presidential
13976,76,SEINE-MARITIME,73111,62378,1087,61291,2007,t1,presidential
13977,77,SEINE-ET-MARNE,88256,73711,911,72800,2007,t1,presidential
13978,77,SEINE-ET-MARNE,76791,66079,732,65347,2007,t1,presidential
13979,77,SEINE-ET-MARNE,76078,65227,876,64351,2007,t1,presidential
13980,77,SEINE-ET-MARNE,81923,70387,945,69442,2007,t1,presidential
13981,77,SEINE-ET-MARNE,92428,78587,953,77634,2007,t1,presidential
13982,77,SEINE-ET-MARNE,81474,69855,862,68993,2007,t1,presidential
13983,77,SEINE-ET-MARNE,88094,74470,774,73696,2007,t1,presidential
13984,77,SEINE-ET-MARNE,110339,94914,1158,93756,2007,t1,presidential
13985,77,SEINE-ET-MARNE,106750,91721,1214,90507,2007,t1,presidential
13986,78,YVELINES,90043,79666,675,78991,2007,t1,presidential
13987,78,YVELINES,75973,67119,517,66602,2007,t1,presidential
13988,78,YVELINES,68312,60326,444,59882,2007,t1,presidential
13989,78,YVELINES,74291,65252,535,64717,2007,t1,presidential
13990,78,YVELINES,69255,59719,544,59175,2007,t1,presidential
13991,78,YVELINES,59461,50956,430,50526,2007,t1,presidential
13992,78,YVELINES,74975,65194,684,64510,2007,t1,presidential
13993,78,YVELINES,67120,57703,683,57020,2007,t1,presidential
13994,78,YVELINES,86095,75338,901,74437,2007,t1,presidential
13995,78,YVELINES,100383,89423,897,88526,2007,t1,presidential
13996,78,YVELINES,57573,49542,566,48976,2007,t1,presidential
13997,78,YVELINES,70899,61646,594,61052,2007,t1,presidential
13998,79,DEUX-SEVRES,64192,55008,812,54196,2007,t1,presidential
13999,79,DEUX-SEVRES,73474,64319,995,63324,2007,t1,presidential
14000,79,DEUX-SEVRES,61660,53818,2300,51518,2007,t1,presidential
14001,79,DEUX-SEVRES,69951,61133,1050,60083,2007,t1,presidential
14002,80,SOMME,59964,48589,639,47950,2007,t1,presidential
14003,80,SOMME,64065,53063,637,52426,2007,t1,presidential
14004,80,SOMME,68474,59162,1025,58137,2007,t1,presidential
14005,80,SOMME,72959,61614,1025,60589,2007,t1,presidential
14006,80,SOMME,66015,55868,770,55098,2007,t1,presidential
14007,80,SOMME,78792,67601,975,66626,2007,t1,presidential
14008,81,TARN,57336,50691,947,49744,2007,t1,presidential
14009,81,TARN,79744,70139,1083,69056,2007,t1,presidential
14010,81,TARN,59456,52609,888,51721,2007,t1,presidential
14011,81,TARN,79818,70903,1098,69805,2007,t1,presidential
14012,82,TARN-ET-GARONNE,81667,72037,993,71044,2007,t1,presidential
14013,82,TARN-ET-GARONNE,84166,73931,1104,72827,2007,t1,presidential
14014,83,VAR,50946,40959,488,40471,2007,t1,presidential
14015,83,VAR,56502,45796,570,45226,2007,t1,presidential
14016,83,VAR,111170,93748,1066,92682,2007,t1,presidential
14017,83,VAR,120686,101848,1102,100746,2007,t1,presidential
14018,83,VAR,107439,90329,912,89417,2007,t1,presidential
14019,83,VAR,162548,138043,1625,136418,2007,t1,presidential
14020,83,VAR,107504,87558,1028,86530,2007,t1,presidential
14021,84,VAUCLUSE,71034,59708,689,59019,2007,t1,presidential
14022,84,VAUCLUSE,120183,103134,1301,101833,2007,t1,presidential
14023,84,VAUCLUSE,96928,83153,1035,82118,2007,t1,presidential
14024,84,VAUCLUSE,82480,70198,1023,69175,2007,t1,presidential
14025,85,VENDEE,95081,84366,1418,82948,2007,t1,presidential
14026,85,VENDEE,91352,80964,1305,79659,2007,t1,presidential
14027,85,VENDEE,108130,93142,1379,91763,2007,t1,presidential
14028,85,VENDEE,90612,81645,1454,80191,2007,t1,presidential
14029,85,VENDEE,79074,69033,1062,67971,2007,t1,presidential
14030,86,VIENNE,82625,71460,1022,70438,2007,t1,presidential
14031,86,VIENNE,73280,63234,799,62435,2007,t1,presidential
14032,86,VIENNE,67618,58199,1057,57142,2007,t1,presidential
14033,86,VIENNE,75662,63725,1186,62539,2007,t1,presidential
14034,87,HAUTE-VIENNE,54020,46351,868,45483,2007,t1,presidential
14035,87,HAUTE-VIENNE,73876,64778,1515,63263,2007,t1,presidential
14036,87,HAUTE-VIENNE,66078,57168,1212,55956,2007,t1,presidential
14037,87,HAUTE-VIENNE,71891,62379,1316,61063,2007,t1,presidential
14038,88,VOSGES,76650,64843,1036,63807,2007,t1,presidential
14039,88,VOSGES,75539,63092,1171,61921,2007,t1,presidential
14040,88,VOSGES,67228,58256,1189,57067,2007,t1,presidential
14041,88,VOSGES,69303,59145,920,58225,2007,t1,presidential
14042,89,YONNE,78941,66215,928,65287,2007,t1,presidential
14043,89,YONNE,73679,61750,922,60828,2007,t1,presidential
14044,89,YONNE,92919,77769,1030,76739,2007,t1,presidential
14045,90,TERRITOIRE DE BELFORT,46471,39282,575,38707,2007,t1,presidential
14046,90,TERRITOIRE DE BELFORT,47308,39799,634,39165,2007,t1,presidential
14047,91,ESSONNE,66993,57191,735,56456,2007,t1,presidential
14048,91,ESSONNE,83530,73119,828,72291,2007,t1,presidential
14049,91,ESSONNE,93085,81657,975,80682,2007,t1,presidential
14050,91,ESSONNE,84066,74246,819,73427,2007,t1,presidential
14051,91,ESSONNE,64758,57957,447,57510,2007,t1,presidential
14052,91,ESSONNE,72204,63672,656,63016,2007,t1,presidential
14053,91,ESSONNE,71548,60929,665,60264,2007,t1,presidential
14054,91,ESSONNE,72852,62718,720,61998,2007,t1,presidential
14055,91,ESSONNE,73590,64278,638,63640,2007,t1,presidential
14056,91,ESSONNE,60306,51142,603,50539,2007,t1,presidential
14057,92,HAUTS-DE-SEINE,58721,47443,734,46709,2007,t1,presidential
14058,92,HAUTS-DE-SEINE,61693,53335,604,52731,2007,t1,presidential
14059,92,HAUTS-DE-SEINE,80771,69298,730,68568,2007,t1,presidential
14060,92,HAUTS-DE-SEINE,66338,57621,749,56872,2007,t1,presidential
14061,92,HAUTS-DE-SEINE,67247,58041,541,57500,2007,t1,presidential
14062,92,HAUTS-DE-SEINE,64408,56979,417,56562,2007,t1,presidential
14063,92,HAUTS-DE-SEINE,80952,71761,592,71169,2007,t1,presidential
14064,92,HAUTS-DE-SEINE,66082,57641,540,57101,2007,t1,presidential
14065,92,HAUTS-DE-SEINE,59282,52453,477,51976,2007,t1,presidential
14066,92,HAUTS-DE-SEINE,65510,56942,600,56342,2007,t1,presidential
14067,92,HAUTS-DE-SEINE,64996,56444,648,55796,2007,t1,presidential
14068,92,HAUTS-DE-SEINE,84810,74686,753,73933,2007,t1,presidential
14069,92,HAUTS-DE-SEINE,83855,73863,822,73041,2007,t1,presidential
14070,93,SEINE-SAINT-DENIS,49991,40359,492,39867,2007,t1,presidential
14071,93,SEINE-SAINT-DENIS,49648,40337,564,39773,2007,t1,presidential
14072,93,SEINE-SAINT-DENIS,44630,36468,422,36046,2007,t1,presidential
14073,93,SEINE-SAINT-DENIS,44999,36403,544,35859,2007,t1,presidential
14074,93,SEINE-SAINT-DENIS,53033,42685,544,42141,2007,t1,presidential
14075,93,SEINE-SAINT-DENIS,60499,50715,586,50129,2007,t1,presidential
14076,93,SEINE-SAINT-DENIS,49341,40858,433,40425,2007,t1,presidential
14077,93,SEINE-SAINT-DENIS,60334,51202,596,50606,2007,t1,presidential
14078,93,SEINE-SAINT-DENIS,54850,44715,580,44135,2007,t1,presidential
14079,93,SEINE-SAINT-DENIS,51966,42846,582,42264,2007,t1,presidential
14080,93,SEINE-SAINT-DENIS,58487,49222,682,48540,2007,t1,presidential
14081,93,SEINE-SAINT-DENIS,61448,52345,579,51766,2007,t1,presidential
14082,93,SEINE-SAINT-DENIS,68945,59765,673,59092,2007,t1,presidential
14083,94,VAL-DE-MARNE,54312,47724,515,47209,2007,t1,presidential
14084,94,VAL-DE-MARNE,63828,54340,753,53587,2007,t1,presidential
14085,94,VAL-DE-MARNE,68176,58281,692,57589,2007,t1,presidential
14086,94,VAL-DE-MARNE,69715,60589,666,59923,2007,t1,presidential
14087,94,VAL-DE-MARNE,61354,51363,597,50766,2007,t1,presidential
14088,94,VAL-DE-MARNE,76757,65837,575,65262,2007,t1,presidential
14089,94,VAL-DE-MARNE,58048,50294,484,49810,2007,t1,presidential
14090,94,VAL-DE-MARNE,60960,52901,511,52390,2007,t1,presidential
14091,94,VAL-DE-MARNE,51329,43416,527,42889,2007,t1,presidential
14092,94,VAL-DE-MARNE,60423,50725,569,50156,2007,t1,presidential
14093,94,VAL-DE-MARNE,57125,48107,595,47512,2007,t1,presidential
14094,94,VAL-DE-MARNE,63929,54655,600,54055,2007,t1,presidential
14095,95,VAL-D'OISE,76571,67014,803,66211,2007,t1,presidential
14096,95,VAL-D'OISE,114025,99920,1316,98604,2007,t1,presidential
14097,95,VAL-D'OISE,83383,71616,802,70814,2007,t1,presidential
14098,95,VAL-D'OISE,71422,61532,737,60795,2007,t1,presidential
14099,95,VAL-D'OISE,64055,53060,643,52417,2007,t1,presidential
14100,95,VAL-D'OISE,71801,61449,622,60827,2007,t1,presidential
14101,95,VAL-D'OISE,80143,69294,772,68522,2007,t1,presidential
14102,95,VAL-D'OISE,48546,40074,564,39510,2007,t1,presidential
14103,95,VAL-D'OISE,65168,55021,829,54192,2007,t1,presidential
14104,971,GUADELOUPE,62272,35818,2660,33158,2007,t1,presidential
14105,971,GUADELOUPE,88472,51700,3075,48625,2007,t1,presidential
14106,971,GUADELOUPE,81868,50883,3262,47621,2007,t1,presidential
14107,971,GUADELOUPE,70699,40964,2480,38484,2007,t1,presidential
14108,972,MARTINIQUE,60689,37429,2351,35078,2007,t1,presidential
14109,972,MARTINIQUE,61503,35923,1712,34211,2007,t1,presidential
14110,972,MARTINIQUE,61914,36224,2430,33794,2007,t1,presidential
14111,972,MARTINIQUE,103359,60008,3713,56295,2007,t1,presidential
14112,973,GUYANE,22155,13192,568,12624,2007,t1,presidential
14113,973,GUYANE,40371,23551,747,22804,2007,t1,presidential
14114,974,LA REUNION,83247,60791,1606,59185,2007,t1,presidential
14115,974,LA REUNION,107570,76843,3247,73596,2007,t1,presidential
14116,974,LA REUNION,126613,94825,3279,91546,2007,t1,presidential
14117,974,LA REUNION,93622,68425,2404,66021,2007,t1,presidential
14118,974,LA REUNION,99506,69835,2218,67617,2007,t1,presidential
14119,975,SAINT-PIERRE-ET-MIQUELON,4923,3106,358,2748,2007,t1,presidential
14120,985,MAYOTTE,64440,29812,4960,24852,2007,t1,presidential
14121,986,WALLIS ET FUTUNA,11166,7208,32,7176,2007,t1,presidential
14122,987,POLYNESIE FRANCAISE,167593,115843,1129,114714,2007,t1,presidential
14123,988,NOUVELLE-CALEDONIE,146068,91596,1835,89761,2007,t1,presidential
14124,99,FRANCAIS DE L'ETRANGER,822944,331681,2480,329201,2007,t1,presidential
14125,1,AIN,86218,74541,3256,71285,2007,t2,presidential
14126,1,AIN,92002,77695,3263,74432,2007,t2,presidential
14127,1,AIN,85426,72431,3033,69398,2007,t2,presidential
14128,1,AIN,109309,94851,4112,90739,2007,t2,presidential
14129,2,AISNE,72174,61107,2799,58308,2007,t2,presidential
14130,2,AISNE,74478,63081,2820,60261,2007,t2,presidential
14131,2,AISNE,72022,60271,2752,57519,2007,t2,presidential
14132,2,AISNE,79062,65245,2791,62454,2007,t2,presidential
14133,2,AISNE,79619,67687,3222,64465,2007,t2,presidential
14134,3,ALLIER,58138,49404,2298,47106,2007,t2,presidential
14135,3,ALLIER,66196,55366,2672,52694,2007,t2,presidential
14136,3,ALLIER,70574,61049,3066,57983,2007,t2,presidential
14137,3,ALLIER,64595,54858,2773,52085,2007,t2,presidential
14138,4,ALPES DE HAUTE PROVENCE,58319,50885,2310,48575,2007,t2,presidential
14139,4,ALPES DE HAUTE PROVENCE,60609,52903,2434,50469,2007,t2,presidential
14140,5,HAUTES ALPES,57418,50072,2388,47684,2007,t2,presidential
14141,5,HAUTES ALPES,45634,39622,1687,37935,2007,t2,presidential
14142,6,ALPES MARITIMES,57411,47239,1541,45698,2007,t2,presidential
14143,6,ALPES MARITIMES,60941,50353,1553,48800,2007,t2,presidential
14144,6,ALPES MARITIMES,69199,57487,1776,55711,2007,t2,presidential
14145,6,ALPES MARITIMES,72370,59581,2121,57460,2007,t2,presidential
14146,6,ALPES MARITIMES,86216,73578,2659,70919,2007,t2,presidential
14147,6,ALPES MARITIMES,106189,90000,3193,86807,2007,t2,presidential
14148,6,ALPES MARITIMES,97187,82420,2742,79678,2007,t2,presidential
14149,6,ALPES MARITIMES,66978,56530,1785,54745,2007,t2,presidential
14150,6,ALPES MARITIMES,105421,89577,3106,86471,2007,t2,presidential
14151,7,ARDECHE,73564,63458,3131,60327,2007,t2,presidential
14152,7,ARDECHE,88735,76798,3444,73354,2007,t2,presidential
14153,7,ARDECHE,73245,63678,2824,60854,2007,t2,presidential
14154,8,ARDENNES,73296,61336,2824,58512,2007,t2,presidential
14155,8,ARDENNES,66014,53797,2295,51502,2007,t2,presidential
14156,8,ARDENNES,59794,50300,2266,48034,2007,t2,presidential
14157,9,ARIEGE,55749,48613,2184,46429,2007,t2,presidential
14158,9,ARIEGE,58042,50947,2300,48647,2007,t2,presidential
14159,10,AUBE,57810,48721,2129,46592,2007,t2,presidential
14160,10,AUBE,73089,61588,2680,58908,2007,t2,presidential
14161,10,AUBE,73836,61455,2789,58666,2007,t2,presidential
14162,11,AUDE,69995,60978,2570,58408,2007,t2,presidential
14163,11,AUDE,110349,94268,4457,89811,2007,t2,presidential
14164,11,AUDE,74040,65055,2952,62103,2007,t2,presidential
14165,12,AVEYRON,74333,66078,3035,63043,2007,t2,presidential
14166,12,AVEYRON,71642,62521,2703,59818,2007,t2,presidential
14167,12,AVEYRON,71880,63989,3037,60952,2007,t2,presidential
14168,13,BOUCHES DU RHONE,59951,50352,1730,48622,2007,t2,presidential
14169,13,BOUCHES DU RHONE,64651,55366,1659,53707,2007,t2,presidential
14170,13,BOUCHES DU RHONE,46090,38062,1152,36910,2007,t2,presidential
14171,13,BOUCHES DU RHONE,47760,38343,1069,37274,2007,t2,presidential
14172,13,BOUCHES DU RHONE,53743,44786,1431,43355,2007,t2,presidential
14173,13,BOUCHES DU RHONE,69617,58967,1936,57031,2007,t2,presidential
14174,13,BOUCHES DU RHONE,51771,42016,1205,40811,2007,t2,presidential
14175,13,BOUCHES DU RHONE,73717,62252,2153,60099,2007,t2,presidential
14176,13,BOUCHES DU RHONE,88934,76098,2984,73114,2007,t2,presidential
14177,13,BOUCHES DU RHONE,123223,104987,4251,100736,2007,t2,presidential
14178,13,BOUCHES DU RHONE,99242,85530,3344,82186,2007,t2,presidential
14179,13,BOUCHES DU RHONE,108673,91811,3716,88095,2007,t2,presidential
14180,13,BOUCHES DU RHONE,88941,75611,3347,72264,2007,t2,presidential
14181,13,BOUCHES DU RHONE,100698,86561,3226,83335,2007,t2,presidential
14182,13,BOUCHES DU RHONE,99621,86592,3657,82935,2007,t2,presidential
14183,13,BOUCHES DU RHONE,84176,72033,3197,68836,2007,t2,presidential
14184,14,CALVADOS,70451,61105,2455,58650,2007,t2,presidential
14185,14,CALVADOS,67114,57075,2167,54908,2007,t2,presidential
14186,14,CALVADOS,74185,62377,2583,59794,2007,t2,presidential
14187,14,CALVADOS,81436,69542,2724,66818,2007,t2,presidential
14188,14,CALVADOS,101042,87072,3428,83644,2007,t2,presidential
14189,14,CALVADOS,88447,77222,3430,73792,2007,t2,presidential
14190,15,CANTAL,64685,56396,2360,54036,2007,t2,presidential
14191,15,CANTAL,58637,50222,2069,48153,2007,t2,presidential
14192,16,CHARENTE,63439,53759,2218,51541,2007,t2,presidential
14193,16,CHARENTE,62257,52976,2142,50834,2007,t2,presidential
14194,16,CHARENTE,69008,59935,2662,57273,2007,t2,presidential
14195,16,CHARENTE,65091,55674,2333,53341,2007,t2,presidential
14196,17,CHARENTE MARITIME,95894,82384,3073,79311,2007,t2,presidential
14197,17,CHARENTE MARITIME,92023,78925,3136,75789,2007,t2,presidential
14198,17,CHARENTE MARITIME,79607,68248,2903,65345,2007,t2,presidential
14199,17,CHARENTE MARITIME,85646,73101,3245,69856,2007,t2,presidential
14200,17,CHARENTE MARITIME,100227,85621,3533,82088,2007,t2,presidential
14201,18,CHER,74856,62292,3129,59163,2007,t2,presidential
14202,18,CHER,69999,58077,2829,55248,2007,t2,presidential
14203,18,CHER,87385,73267,3908,69359,2007,t2,presidential
14204,19,CORREZE,65870,58970,2855,56115,2007,t2,presidential
14205,19,CORREZE,69427,59789,2839,56950,2007,t2,presidential
14206,19,CORREZE,51882,45769,2377,43392,2007,t2,presidential
14207,2A,CORSE SUD,44841,34901,1379,33522,2007,t2,presidential
14208,2A,CORSE SUD,49713,39096,1525,37571,2007,t2,presidential
14209,2B,HAUTE CORSE,51480,41112,1697,39415,2007,t2,presidential
14210,2B,HAUTE CORSE,60395,47112,1640,45472,2007,t2,presidential
14211,21,COTE D'OR,66707,58679,2258,56421,2007,t2,presidential
14212,21,COTE D'OR,64123,55543,2374,53169,2007,t2,presidential
14213,21,COTE D'OR,68309,58613,2503,56110,2007,t2,presidential
14214,21,COTE D'OR,69307,59703,2863,56840,2007,t2,presidential
14215,21,COTE D'OR,81095,69657,3219,66438,2007,t2,presidential
14216,22,COTES D'ARMOR,88187,76946,3038,73908,2007,t2,presidential
14217,22,COTES D'ARMOR,91006,81062,3116,77946,2007,t2,presidential
14218,22,COTES D'ARMOR,85413,76219,2758,73461,2007,t2,presidential
14219,22,COTES D'ARMOR,79738,70606,2649,67957,2007,t2,presidential
14220,22,COTES D'ARMOR,101406,89209,3282,85927,2007,t2,presidential
14221,23,CREUSE,50854,43125,1887,41238,2007,t2,presidential
14222,23,CREUSE,48937,41632,2052,39580,2007,t2,presidential
14223,24,DORDOGNE,74517,65147,2833,62314,2007,t2,presidential
14224,24,DORDOGNE,78798,69384,3313,66071,2007,t2,presidential
14225,24,DORDOGNE,70242,62748,2720,60028,2007,t2,presidential
14226,24,DORDOGNE,85444,76470,3332,73138,2007,t2,presidential
14227,25,DOUBS,71077,61753,2720,59033,2007,t2,presidential
14228,25,DOUBS,74861,65168,2837,62331,2007,t2,presidential
14229,25,DOUBS,65821,56621,2749,53872,2007,t2,presidential
14230,25,DOUBS,67286,57237,3015,54222,2007,t2,presidential
14231,25,DOUBS,74109,65464,2843,62621,2007,t2,presidential
14232,26,DROME,72924,61090,2431,58659,2007,t2,presidential
14233,26,DROME,88129,75689,3553,72136,2007,t2,presidential
14234,26,DROME,91771,80650,3691,76959,2007,t2,presidential
14235,26,DROME,85296,73347,3235,70112,2007,t2,presidential
14236,27,EURE,83092,70467,2952,67515,2007,t2,presidential
14237,27,EURE,74541,64340,2848,61492,2007,t2,presidential
14238,27,EURE,78058,66995,3165,63830,2007,t2,presidential
14239,27,EURE,83199,70299,2981,67318,2007,t2,presidential
14240,27,EURE,84801,71315,3074,68241,2007,t2,presidential
14241,28,EURE ET LOIR,85106,72504,3172,69332,2007,t2,presidential
14242,28,EURE ET LOIR,69918,58530,2417,56113,2007,t2,presidential
14243,28,EURE ET LOIR,71079,59866,2634,57232,2007,t2,presidential
14244,28,EURE ET LOIR,67741,58103,2727,55376,2007,t2,presidential
14245,29,FINISTERE,84244,75000,2977,72023,2007,t2,presidential
14246,29,FINISTERE,71163,60137,2172,57965,2007,t2,presidential
14247,29,FINISTERE,92124,80097,2968,77129,2007,t2,presidential
14248,29,FINISTERE,82160,72379,2589,69790,2007,t2,presidential
14249,29,FINISTERE,88432,78314,2847,75467,2007,t2,presidential
14250,29,FINISTERE,88476,77621,2939,74682,2007,t2,presidential
14251,29,FINISTERE,79066,68615,2857,65758,2007,t2,presidential
14252,29,FINISTERE,81689,70801,3175,67626,2007,t2,presidential
14253,30,GARD,82509,69371,2534,66837,2007,t2,presidential
14254,30,GARD,114092,98640,4205,94435,2007,t2,presidential
14255,30,GARD,113529,98257,4523,93734,2007,t2,presidential
14256,30,GARD,85273,73357,3483,69874,2007,t2,presidential
14257,30,GARD,93417,81674,3616,78058,2007,t2,presidential
14258,31,HAUTE GARONNE,69255,57188,2072,55116,2007,t2,presidential
14259,31,HAUTE GARONNE,110049,95716,3691,92025,2007,t2,presidential
14260,31,HAUTE GARONNE,84799,73957,2940,71017,2007,t2,presidential
14261,31,HAUTE GARONNE,54782,45229,1599,43630,2007,t2,presidential
14262,31,HAUTE GARONNE,137660,120622,4989,115633,2007,t2,presidential
14263,31,HAUTE GARONNE,129199,112792,4497,108295,2007,t2,presidential
14264,31,HAUTE GARONNE,121000,107785,4561,103224,2007,t2,presidential
14265,31,HAUTE GARONNE,82668,71102,3160,67942,2007,t2,presidential
14266,32,GERS,71970,63957,2964,60993,2007,t2,presidential
14267,32,GERS,68313,60615,2736,57879,2007,t2,presidential
14268,33,GIRONDE,81750,69458,2666,66792,2007,t2,presidential
14269,33,GIRONDE,59375,49809,1766,48043,2007,t2,presidential
14270,33,GIRONDE,71695,61611,2561,59050,2007,t2,presidential
14271,33,GIRONDE,82368,69992,2857,67135,2007,t2,presidential
14272,33,GIRONDE,95249,82769,3625,79144,2007,t2,presidential
14273,33,GIRONDE,88649,78671,3245,75426,2007,t2,presidential
14274,33,GIRONDE,95984,84921,3650,81271,2007,t2,presidential
14275,33,GIRONDE,118827,103854,4211,99643,2007,t2,presidential
14276,33,GIRONDE,98581,86810,3926,82884,2007,t2,presidential
14277,33,GIRONDE,78387,67816,3069,64747,2007,t2,presidential
14278,33,GIRONDE,82784,71171,3390,67781,2007,t2,presidential
14279,34,HERAULT,75884,63775,2212,61563,2007,t2,presidential
14280,34,HERAULT,66246,55393,1867,53526,2007,t2,presidential
14281,34,HERAULT,125043,109156,4271,104885,2007,t2,presidential
14282,34,HERAULT,133607,116967,4619,112348,2007,t2,presidential
14283,34,HERAULT,95553,82631,3746,78885,2007,t2,presidential
14284,34,HERAULT,84024,70701,2799,67902,2007,t2,presidential
14285,34,HERAULT,119298,101564,4142,97422,2007,t2,presidential
14286,35,ILLE ET VILAINE,73836,63489,2397,61092,2007,t2,presidential
14287,35,ILLE ET VILAINE,97434,85970,3224,82746,2007,t2,presidential
14288,35,ILLE ET VILAINE,90801,80592,3132,77460,2007,t2,presidential
14289,35,ILLE ET VILAINE,109175,95690,4004,91686,2007,t2,presidential
14290,35,ILLE ET VILAINE,118160,104095,4567,99528,2007,t2,presidential
14291,35,ILLE ET VILAINE,77724,68151,3088,65063,2007,t2,presidential
14292,35,ILLE ET VILAINE,98547,84301,3341,80960,2007,t2,presidential
14293,36,INDRE,56103,47299,2539,44760,2007,t2,presidential
14294,36,INDRE,64601,55365,2997,52368,2007,t2,presidential
14295,36,INDRE,56627,48695,2684,46011,2007,t2,presidential
14296,37,INDRE ET LOIRE,53985,45173,1636,43537,2007,t2,presidential
14297,37,INDRE ET LOIRE,91711,79677,3626,76051,2007,t2,presidential
14298,37,INDRE ET LOIRE,92162,79820,3452,76368,2007,t2,presidential
14299,37,INDRE ET LOIRE,86132,74023,3177,70846,2007,t2,presidential
14300,37,INDRE ET LOIRE,77758,67534,2916,64618,2007,t2,presidential
14301,38,ISERE,78173,67603,2507,65096,2007,t2,presidential
14302,38,ISERE,72546,62681,2358,60323,2007,t2,presidential
14303,38,ISERE,59660,50422,1683,48739,2007,t2,presidential
14304,38,ISERE,85031,73287,2748,70539,2007,t2,presidential
14305,38,ISERE,92610,80100,3268,76832,2007,t2,presidential
14306,38,ISERE,105696,89153,3994,85159,2007,t2,presidential
14307,38,ISERE,99759,85175,3846,81329,2007,t2,presidential
14308,38,ISERE,102167,86560,3938,82622,2007,t2,presidential
14309,38,ISERE,88546,76111,3364,72747,2007,t2,presidential
14310,39,JURA,64382,55389,2850,52539,2007,t2,presidential
14311,39,JURA,55251,47333,2382,44951,2007,t2,presidential
14312,39,JURA,67540,59070,2775,56295,2007,t2,presidential
14313,40,LANDES,92648,80442,3356,77086,2007,t2,presidential
14314,40,LANDES,107285,93606,3847,89759,2007,t2,presidential
14315,40,LANDES,83055,74105,3101,71004,2007,t2,presidential
14316,41,LOIR ET CHER,90134,76736,3709,73027,2007,t2,presidential
14317,41,LOIR ET CHER,79813,67839,3324,64515,2007,t2,presidential
14318,41,LOIR ET CHER,70637,60935,3144,57791,2007,t2,presidential
14319,42,LOIRE,68527,56988,2273,54715,2007,t2,presidential
14320,42,LOIRE,49819,40394,1535,38859,2007,t2,presidential
14321,42,LOIRE,78767,66831,3076,63755,2007,t2,presidential
14322,42,LOIRE,68977,57385,2699,54686,2007,t2,presidential
14323,42,LOIRE,68973,58623,2944,55679,2007,t2,presidential
14324,42,LOIRE,69283,59658,3019,56639,2007,t2,presidential
14325,42,LOIRE,101567,87009,4273,82736,2007,t2,presidential
14326,43,HAUTE LOIRE,92984,80733,4355,76378,2007,t2,presidential
14327,43,HAUTE LOIRE,80278,69152,3362,65790,2007,t2,presidential
14328,44,LOIRE ATLANTIQUE,72030,60840,2374,58466,2007,t2,presidential
14329,44,LOIRE ATLANTIQUE,81686,67699,2332,65367,2007,t2,presidential
14330,44,LOIRE ATLANTIQUE,86365,72807,2772,70035,2007,t2,presidential
14331,44,LOIRE ATLANTIQUE,79128,67864,2490,65374,2007,t2,presidential
14332,44,LOIRE ATLANTIQUE,114279,100736,4168,96568,2007,t2,presidential
14333,44,LOIRE ATLANTIQUE,77054,67375,2812,64563,2007,t2,presidential
14334,44,LOIRE ATLANTIQUE,105271,91959,3677,88282,2007,t2,presidential
14335,44,LOIRE ATLANTIQUE,78693,66976,2605,64371,2007,t2,presidential
14336,44,LOIRE ATLANTIQUE,99030,87085,3654,83431,2007,t2,presidential
14337,44,LOIRE ATLANTIQUE,98694,88522,3958,84564,2007,t2,presidential
14338,45,LOIRET,82066,70980,3052,67928,2007,t2,presidential
14339,45,LOIRET,81254,68900,3039,65861,2007,t2,presidential
14340,45,LOIRET,89380,76766,3389,73377,2007,t2,presidential
14341,45,LOIRET,93370,78391,3685,74706,2007,t2,presidential
14342,45,LOIRET,89505,76739,3590,73149,2007,t2,presidential
14343,46,LOT,68517,61018,2689,58329,2007,t2,presidential
14344,46,LOT,64368,57581,2575,55006,2007,t2,presidential
14345,47,LOT ET GARONNE,85528,74900,3466,71434,2007,t2,presidential
14346,47,LOT ET GARONNE,77433,67125,3113,64012,2007,t2,presidential
14347,47,LOT ET GARONNE,75991,66287,2956,63331,2007,t2,presidential
14348,48,LOZERE,32072,27935,1307,26628,2007,t2,presidential
14349,48,LOZERE,27918,24903,1126,23777,2007,t2,presidential
14350,49,MAINE ET LOIRE,79136,68487,2974,65513,2007,t2,presidential
14351,49,MAINE ET LOIRE,85081,74250,3467,70783,2007,t2,presidential
14352,49,MAINE ET LOIRE,67569,57991,2641,55350,2007,t2,presidential
14353,49,MAINE ET LOIRE,72003,61949,2872,59077,2007,t2,presidential
14354,49,MAINE ET LOIRE,73950,64412,3018,61394,2007,t2,presidential
14355,49,MAINE ET LOIRE,89734,79215,4156,75059,2007,t2,presidential
14356,49,MAINE ET LOIRE,72475,63161,2786,60375,2007,t2,presidential
14357,50,MANCHE,74295,63936,2848,61088,2007,t2,presidential
14358,50,MANCHE,75889,65901,2978,62923,2007,t2,presidential
14359,50,MANCHE,76733,65534,2721,62813,2007,t2,presidential
14360,50,MANCHE,73108,62763,2743,60020,2007,t2,presidential
14361,50,MANCHE,71765,60469,2793,57676,2007,t2,presidential
14362,51,MARNE,57288,45706,2041,43665,2007,t2,presidential
14363,51,MARNE,67065,55698,2652,53046,2007,t2,presidential
14364,51,MARNE,65361,53794,2396,51398,2007,t2,presidential
14365,51,MARNE,61012,49256,2270,46986,2007,t2,presidential
14366,51,MARNE,63721,53834,2563,51271,2007,t2,presidential
14367,51,MARNE,67846,55364,2714,52650,2007,t2,presidential
14368,52,HAUTE MARNE,76222,64417,3240,61177,2007,t2,presidential
14369,52,HAUTE MARNE,66123,54578,2847,51731,2007,t2,presidential
14370,53,MAYENNE,81338,70344,3207,67137,2007,t2,presidential
14371,53,MAYENNE,66819,57734,2510,55224,2007,t2,presidential
14372,53,MAYENNE,71794,62394,2898,59496,2007,t2,presidential
14373,54,MEURTHE ET MOSELLE,52447,43027,1643,41384,2007,t2,presidential
14374,54,MEURTHE ET MOSELLE,77910,65797,2869,62928,2007,t2,presidential
14375,54,MEURTHE ET MOSELLE,57968,47962,1923,46039,2007,t2,presidential
14376,54,MEURTHE ET MOSELLE,77708,64968,3189,61779,2007,t2,presidential
14377,54,MEURTHE ET MOSELLE,75132,63992,3032,60960,2007,t2,presidential
14378,54,MEURTHE ET MOSELLE,78139,64886,2977,61909,2007,t2,presidential
14379,54,MEURTHE ET MOSELLE,70872,57296,2127,55169,2007,t2,presidential
14380,55,MEUSE,79818,68206,3393,64813,2007,t2,presidential
14381,55,MEUSE,61409,51163,2324,48839,2007,t2,presidential
14382,56,MORBIHAN,104020,91563,3588,87975,2007,t2,presidential
14383,56,MORBIHAN,92848,81097,3571,77526,2007,t2,presidential
14384,56,MORBIHAN,83221,73232,3317,69915,2007,t2,presidential
14385,56,MORBIHAN,87080,76187,2998,73189,2007,t2,presidential
14386,56,MORBIHAN,80870,67784,3056,64728,2007,t2,presidential
14387,56,MORBIHAN,86865,76128,3323,72805,2007,t2,presidential
14388,57,MOSELLE,74012,59911,2481,57430,2007,t2,presidential
14389,57,MOSELLE,75092,61750,2553,59197,2007,t2,presidential
14390,57,MOSELLE,72365,58629,2471,56158,2007,t2,presidential
14391,57,MOSELLE,69711,58821,3083,55738,2007,t2,presidential
14392,57,MOSELLE,75202,61407,3492,57915,2007,t2,presidential
14393,57,MOSELLE,73096,57586,2522,55064,2007,t2,presidential
14394,57,MOSELLE,79660,65421,3128,62293,2007,t2,presidential
14395,57,MOSELLE,76200,63470,2907,60563,2007,t2,presidential
14396,57,MOSELLE,73231,59625,2547,57078,2007,t2,presidential
14397,57,MOSELLE,70354,56110,2316,53794,2007,t2,presidential
14398,58,NIEVRE,55428,46254,2189,44065,2007,t2,presidential
14399,58,NIEVRE,60488,51438,2386,49052,2007,t2,presidential
14400,58,NIEVRE,53425,45476,2027,43449,2007,t2,presidential
14401,59,NORD,58097,46026,1579,44447,2007,t2,presidential
14402,59,NORD,72921,60202,2280,57922,2007,t2,presidential
14403,59,NORD,63397,51321,1911,49410,2007,t2,presidential
14404,59,NORD,72343,60554,2439,58115,2007,t2,presidential
14405,59,NORD,87827,73043,3334,69709,2007,t2,presidential
14406,59,NORD,80704,70520,3027,67493,2007,t2,presidential
14407,59,NORD,70496,56125,2143,53982,2007,t2,presidential
14408,59,NORD,71343,55108,2066,53042,2007,t2,presidential
14409,59,NORD,69327,56184,1897,54287,2007,t2,presidential
14410,59,NORD,77870,61928,2323,59605,2007,t2,presidential
14411,59,NORD,86492,71992,3285,68707,2007,t2,presidential
14412,59,NORD,70101,56895,2786,54109,2007,t2,presidential
14413,59,NORD,64688,54677,2536,52141,2007,t2,presidential
14414,59,NORD,74009,63823,2894,60929,2007,t2,presidential
14415,59,NORD,73966,61744,2939,58805,2007,t2,presidential
14416,59,NORD,82095,67573,3144,64429,2007,t2,presidential
14417,59,NORD,74902,61139,2555,58584,2007,t2,presidential
14418,59,NORD,79294,65263,3006,62257,2007,t2,presidential
14419,59,NORD,80004,64610,3014,61596,2007,t2,presidential
14420,59,NORD,82413,65529,2860,62669,2007,t2,presidential
14421,59,NORD,78432,62778,2637,60141,2007,t2,presidential
14422,59,NORD,74956,63138,2972,60166,2007,t2,presidential
14423,59,NORD,66119,53539,2174,51365,2007,t2,presidential
14424,59,NORD,64809,52566,2291,50275,2007,t2,presidential
14425,60,OISE,79094,67455,3240,64215,2007,t2,presidential
14426,60,OISE,83721,71458,3213,68245,2007,t2,presidential
14427,60,OISE,69503,58295,2265,56030,2007,t2,presidential
14428,60,OISE,88152,74392,2874,71518,2007,t2,presidential
14429,60,OISE,69417,58454,2670,55784,2007,t2,presidential
14430,60,OISE,73352,61470,2753,58717,2007,t2,presidential
14431,60,OISE,73407,61783,2674,59109,2007,t2,presidential
14432,61,ORNE,72269,61766,2725,59041,2007,t2,presidential
14433,61,ORNE,70277,59503,2625,56878,2007,t2,presidential
14434,61,ORNE,73804,63203,2847,60356,2007,t2,presidential
14435,62,PAS DE CALAIS,79605,69265,3203,66062,2007,t2,presidential
14436,62,PAS DE CALAIS,76218,66378,3265,63113,2007,t2,presidential
14437,62,PAS DE CALAIS,75221,66904,3022,63882,2007,t2,presidential
14438,62,PAS DE CALAIS,78707,67046,2695,64351,2007,t2,presidential
14439,62,PAS DE CALAIS,64612,53668,2231,51437,2007,t2,presidential
14440,62,PAS DE CALAIS,73432,60933,2567,58366,2007,t2,presidential
14441,62,PAS DE CALAIS,85525,70112,3299,66813,2007,t2,presidential
14442,62,PAS DE CALAIS,68900,58448,2689,55759,2007,t2,presidential
14443,62,PAS DE CALAIS,80780,67515,3262,64253,2007,t2,presidential
14444,62,PAS DE CALAIS,72349,57692,2799,54893,2007,t2,presidential
14445,62,PAS DE CALAIS,96373,79779,4079,75700,2007,t2,presidential
14446,62,PAS DE CALAIS,78791,62341,3043,59298,2007,t2,presidential
14447,62,PAS DE CALAIS,72412,57089,2789,54300,2007,t2,presidential
14448,62,PAS DE CALAIS,75477,60091,2647,57444,2007,t2,presidential
14449,63,PUY DE DOME,61187,51633,2112,49521,2007,t2,presidential
14450,63,PUY DE DOME,76278,66465,2999,63466,2007,t2,presidential
14451,63,PUY DE DOME,73998,64001,2787,61214,2007,t2,presidential
14452,63,PUY DE DOME,77463,68002,3137,64865,2007,t2,presidential
14453,63,PUY DE DOME,66157,56798,3030,53768,2007,t2,presidential
14454,63,PUY DE DOME,88091,77573,3633,73940,2007,t2,presidential
14455,64,PYRENEES ATLANTIQUES,67896,59009,2888,56121,2007,t2,presidential
14456,64,PYRENEES ATLANTIQUES,73812,65202,3692,61510,2007,t2,presidential
14457,64,PYRENEES ATLANTIQUES,79816,70659,3618,67041,2007,t2,presidential
14458,64,PYRENEES ATLANTIQUES,80042,69808,3547,66261,2007,t2,presidential
14459,64,PYRENEES ATLANTIQUES,82511,70311,3064,67247,2007,t2,presidential
14460,64,PYRENEES ATLANTIQUES,90945,76934,3604,73330,2007,t2,presidential
14461,65,HAUTES PYRENEES,60035,52216,2358,49858,2007,t2,presidential
14462,65,HAUTES PYRENEES,62949,54755,2498,52257,2007,t2,presidential
14463,65,HAUTES PYRENEES,53264,45635,2027,43608,2007,t2,presidential
14464,66,PYRENEES ORIENTALES,65747,54912,2224,52688,2007,t2,presidential
14465,66,PYRENEES ORIENTALES,96336,83004,3387,79617,2007,t2,presidential
14466,66,PYRENEES ORIENTALES,65504,54870,2325,52545,2007,t2,presidential
14467,66,PYRENEES ORIENTALES,87218,75202,3225,71977,2007,t2,presidential
14468,67,BAS RHIN,51298,42673,1407,41266,2007,t2,presidential
14469,67,BAS RHIN,50782,41427,1505,39922,2007,t2,presidential
14470,67,BAS RHIN,66254,54325,1795,52530,2007,t2,presidential
14471,67,BAS RHIN,113576,96003,3695,92308,2007,t2,presidential
14472,67,BAS RHIN,98516,82647,3813,78834,2007,t2,presidential
14473,67,BAS RHIN,80460,68250,3065,65185,2007,t2,presidential
14474,67,BAS RHIN,82495,68790,3508,65282,2007,t2,presidential
14475,67,BAS RHIN,70254,58055,3006,55049,2007,t2,presidential
14476,67,BAS RHIN,103936,87507,3670,83837,2007,t2,presidential
14477,68,HAUT RHIN,71461,59107,2631,56476,2007,t2,presidential
14478,68,HAUT RHIN,74608,63461,3049,60412,2007,t2,presidential
14479,68,HAUT RHIN,82838,71150,3260,67890,2007,t2,presidential
14480,68,HAUT RHIN,72226,60704,2501,58203,2007,t2,presidential
14481,68,HAUT RHIN,54431,43397,1891,41506,2007,t2,presidential
14482,68,HAUT RHIN,74542,61258,2618,58640,2007,t2,presidential
14483,68,HAUT RHIN,76738,64958,3199,61759,2007,t2,presidential
14484,69,RHONE,63170,53189,1981,51208,2007,t2,presidential
14485,69,RHONE,70624,59975,2013,57962,2007,t2,presidential
14486,69,RHONE,66548,56009,2128,53881,2007,t2,presidential
14487,69,RHONE,74159,63322,2209,61113,2007,t2,presidential
14488,69,RHONE,83190,72618,2749,69869,2007,t2,presidential
14489,69,RHONE,73849,61525,2199,59326,2007,t2,presidential
14490,69,RHONE,60248,49769,1751,48018,2007,t2,presidential
14491,69,RHONE,81913,71092,3314,67778,2007,t2,presidential
14492,69,RHONE,80423,68327,3111,65216,2007,t2,presidential
14493,69,RHONE,89399,78623,3088,75535,2007,t2,presidential
14494,69,RHONE,79846,69458,2930,66528,2007,t2,presidential
14495,69,RHONE,73659,63137,2511,60626,2007,t2,presidential
14496,69,RHONE,90839,76897,2741,74156,2007,t2,presidential
14497,69,RHONE,50055,40974,1584,39390,2007,t2,presidential
14498,70,HAUTE SAONE,63838,55690,2721,52969,2007,t2,presidential
14499,70,HAUTE SAONE,63912,55218,3177,52041,2007,t2,presidential
14500,70,HAUTE SAONE,51677,44410,2603,41807,2007,t2,presidential
14501,71,SAONE ET LOIRE,67105,56737,2625,54112,2007,t2,presidential
14502,71,SAONE ET LOIRE,64327,54693,2591,52102,2007,t2,presidential
14503,71,SAONE ET LOIRE,66579,56684,2952,53732,2007,t2,presidential
14504,71,SAONE ET LOIRE,61717,51091,2411,48680,2007,t2,presidential
14505,71,SAONE ET LOIRE,64194,52964,2552,50412,2007,t2,presidential
14506,71,SAONE ET LOIRE,84922,72648,3636,69012,2007,t2,presidential
14507,72,SARTHE,71189,60311,2787,57524,2007,t2,presidential
14508,72,SARTHE,81952,67948,3225,64723,2007,t2,presidential
14509,72,SARTHE,83862,71079,3513,67566,2007,t2,presidential
14510,72,SARTHE,77745,65672,3128,62544,2007,t2,presidential
14511,72,SARTHE,86570,73314,3471,69843,2007,t2,presidential
14512,73,SAVOIE,108344,92434,4127,88307,2007,t2,presidential
14513,73,SAVOIE,84402,71119,3084,68035,2007,t2,presidential
14514,73,SAVOIE,95423,81641,3694,77947,2007,t2,presidential
14515,74,HAUTE SAVOIE,103361,89205,4148,85057,2007,t2,presidential
14516,74,HAUTE SAVOIE,86015,73298,3226,70072,2007,t2,presidential
14517,74,HAUTE SAVOIE,85974,71950,2829,69121,2007,t2,presidential
14518,74,HAUTE SAVOIE,91822,76892,3067,73825,2007,t2,presidential
14519,74,HAUTE SAVOIE,105686,88898,3927,84971,2007,t2,presidential
14520,75,PARIS,61448,52900,1966,50934,2007,t2,presidential
14521,75,PARIS,52074,45905,1888,44017,2007,t2,presidential
14522,75,PARIS,42425,37135,1292,35843,2007,t2,presidential
14523,75,PARIS,57944,50184,1694,48490,2007,t2,presidential
14524,75,PARIS,48582,41572,1328,40244,2007,t2,presidential
14525,75,PARIS,64970,56131,1668,54463,2007,t2,presidential
14526,75,PARIS,62752,54394,1857,52537,2007,t2,presidential
14527,75,PARIS,69757,60560,2187,58373,2007,t2,presidential
14528,75,PARIS,60959,52321,1847,50474,2007,t2,presidential
14529,75,PARIS,63946,56058,2184,53874,2007,t2,presidential
14530,75,PARIS,58937,51080,1933,49147,2007,t2,presidential
14531,75,PARIS,66041,57318,2005,55313,2007,t2,presidential
14532,75,PARIS,69464,59888,2264,57624,2007,t2,presidential
14533,75,PARIS,49205,43008,1236,41772,2007,t2,presidential
14534,75,PARIS,41965,36561,823,35738,2007,t2,presidential
14535,75,PARIS,54015,47110,1414,45696,2007,t2,presidential
14536,75,PARIS,55590,47278,1645,45633,2007,t2,presidential
14537,75,PARIS,55189,47162,1595,45567,2007,t2,presidential
14538,75,PARIS,47497,39959,1121,38838,2007,t2,presidential
14539,75,PARIS,65110,55460,1544,53916,2007,t2,presidential
14540,75,PARIS,74361,63548,2039,61509,2007,t2,presidential
14541,76,SEINE MARITIME,60564,50306,1854,48452,2007,t2,presidential
14542,76,SEINE MARITIME,87193,75453,3076,72377,2007,t2,presidential
14543,76,SEINE MARITIME,56751,48048,1963,46085,2007,t2,presidential
14544,76,SEINE MARITIME,72247,60978,2658,58320,2007,t2,presidential
14545,76,SEINE MARITIME,88817,75729,3074,72655,2007,t2,presidential
14546,76,SEINE MARITIME,78977,65239,2889,62350,2007,t2,presidential
14547,76,SEINE MARITIME,58583,48037,2196,45841,2007,t2,presidential
14548,76,SEINE MARITIME,52034,40292,1847,38445,2007,t2,presidential
14549,76,SEINE MARITIME,85233,73302,2957,70345,2007,t2,presidential
14550,76,SEINE MARITIME,84647,73810,3050,70760,2007,t2,presidential
14551,76,SEINE MARITIME,75383,64169,2650,61519,2007,t2,presidential
14552,76,SEINE MARITIME,73194,62908,2895,60013,2007,t2,presidential
14553,77,SEINE ET MARNE,87983,73940,2972,70968,2007,t2,presidential
14554,77,SEINE ET MARNE,76761,65341,2874,62467,2007,t2,presidential
14555,77,SEINE ET MARNE,76082,64891,2850,62041,2007,t2,presidential
14556,77,SEINE ET MARNE,81959,69639,3214,66425,2007,t2,presidential
14557,77,SEINE ET MARNE,92323,78107,3266,74841,2007,t2,presidential
14558,77,SEINE ET MARNE,81492,69363,2703,66660,2007,t2,presidential
14559,77,SEINE ET MARNE,88110,73909,2776,71133,2007,t2,presidential
14560,77,SEINE ET MARNE,110448,94238,3428,90810,2007,t2,presidential
14561,77,SEINE ET MARNE,106737,90931,3704,87227,2007,t2,presidential
14562,78,YVELINES,90056,78217,3087,75130,2007,t2,presidential
14563,78,YVELINES,75884,65873,2667,63206,2007,t2,presidential
14564,78,YVELINES,68262,59344,1954,57390,2007,t2,presidential
14565,78,YVELINES,74231,64215,2614,61601,2007,t2,presidential
14566,78,YVELINES,69278,58857,2070,56787,2007,t2,presidential
14567,78,YVELINES,59298,50293,1943,48350,2007,t2,presidential
14568,78,YVELINES,74833,64271,2556,61715,2007,t2,presidential
14569,78,YVELINES,66993,56858,2053,54805,2007,t2,presidential
14570,78,YVELINES,86082,74361,2937,71424,2007,t2,presidential
14571,78,YVELINES,100321,88324,3537,84787,2007,t2,presidential
14572,78,YVELINES,57588,48867,1685,47182,2007,t2,presidential
14573,78,YVELINES,70875,60665,2119,58546,2007,t2,presidential
14574,79,DEUX SEVRES,64023,55655,2060,53595,2007,t2,presidential
14575,79,DEUX SEVRES,73474,65117,2554,62563,2007,t2,presidential
14576,79,DEUX SEVRES,61656,53928,2297,51631,2007,t2,presidential
14577,79,DEUX SEVRES,69946,61330,2443,58887,2007,t2,presidential
14578,80,SOMME,59953,49286,1947,47339,2007,t2,presidential
14579,80,SOMME,64070,53975,2263,51712,2007,t2,presidential
14580,80,SOMME,68450,59589,2810,56779,2007,t2,presidential
14581,80,SOMME,72965,61975,2771,59204,2007,t2,presidential
14582,80,SOMME,65973,56085,2569,53516,2007,t2,presidential
14583,80,SOMME,78775,68156,3109,65047,2007,t2,presidential
14584,81,TARN,57328,50568,2388,48180,2007,t2,presidential
14585,81,TARN,79760,70029,3221,66808,2007,t2,presidential
14586,81,TARN,59420,52553,2601,49952,2007,t2,presidential
14587,81,TARN,79827,70665,3251,67414,2007,t2,presidential
14588,82,TARN ET GARONNE,81636,71956,3025,68931,2007,t2,presidential
14589,82,TARN ET GARONNE,84159,73752,3211,70541,2007,t2,presidential
14590,83,VAR,50950,41526,1485,40041,2007,t2,presidential
14591,83,VAR,56502,46435,1778,44657,2007,t2,presidential
14592,83,VAR,111183,95003,3623,91380,2007,t2,presidential
14593,83,VAR,120683,103024,3648,99376,2007,t2,presidential
14594,83,VAR,107445,91468,3005,88463,2007,t2,presidential
14595,83,VAR,162539,139394,5752,133642,2007,t2,presidential
14596,83,VAR,107508,89208,3354,85854,2007,t2,presidential
14597,84,VAUCLUSE,71036,60094,2283,57811,2007,t2,presidential
14598,84,VAUCLUSE,120251,103855,4600,99255,2007,t2,presidential
14599,84,VAUCLUSE,96937,83264,3690,79574,2007,t2,presidential
14600,84,VAUCLUSE,82475,71010,3435,67575,2007,t2,presidential
14601,85,VENDEE,95086,83162,3884,79278,2007,t2,presidential
14602,85,VENDEE,91351,80292,3689,76603,2007,t2,presidential
14603,85,VENDEE,108128,92648,3681,88967,2007,t2,presidential
14604,85,VENDEE,90592,80317,4431,75886,2007,t2,presidential
14605,85,VENDEE,79071,68918,2912,66006,2007,t2,presidential
14606,86,VIENNE,82616,72173,3228,68945,2007,t2,presidential
14607,86,VIENNE,73314,63750,2747,61003,2007,t2,presidential
14608,86,VIENNE,67621,58642,2496,56146,2007,t2,presidential
14609,86,VIENNE,75688,64210,3196,61014,2007,t2,presidential
14610,87,HAUTE VIENNE,54026,46467,2360,44107,2007,t2,presidential
14611,87,HAUTE VIENNE,73879,65205,3509,61696,2007,t2,presidential
14612,87,HAUTE VIENNE,66084,57617,3055,54562,2007,t2,presidential
14613,87,HAUTE VIENNE,71892,62783,3335,59448,2007,t2,presidential
14614,88,VOSGES,76619,64473,3282,61191,2007,t2,presidential
14615,88,VOSGES,75511,62282,3710,58572,2007,t2,presidential
14616,88,VOSGES,67227,57557,3315,54242,2007,t2,presidential
14617,88,VOSGES,69297,58852,3100,55752,2007,t2,presidential
14618,89,YONNE,78959,66644,3170,63474,2007,t2,presidential
14619,89,YONNE,73643,62152,3121,59031,2007,t2,presidential
14620,89,YONNE,92899,77771,3564,74207,2007,t2,presidential
14621,90,TERRITOIRE DE BELFORT,46463,39626,2083,37543,2007,t2,presidential
14622,90,TERRITOIRE DE BELFORT,47400,40540,2116,38424,2007,t2,presidential
14623,91,ESSONNE,67012,56562,2044,54518,2007,t2,presidential
14624,91,ESSONNE,83541,72124,3120,69004,2007,t2,presidential
14625,91,ESSONNE,93096,80469,3433,77036,2007,t2,presidential
14626,91,ESSONNE,84063,73152,3072,70080,2007,t2,presidential
14627,91,ESSONNE,64797,57163,2233,54930,2007,t2,presidential
14628,91,ESSONNE,72264,62567,2440,60127,2007,t2,presidential
14629,91,ESSONNE,71563,60133,2432,57701,2007,t2,presidential
14630,91,ESSONNE,72824,62051,2580,59471,2007,t2,presidential
14631,91,ESSONNE,73596,63636,2455,61181,2007,t2,presidential
14632,91,ESSONNE,60339,50576,1802,48774,2007,t2,presidential
14633,92,HAUTS DE SEINE,58741,47474,1517,45957,2007,t2,presidential
14634,92,HAUTS DE SEINE,61652,52881,1904,50977,2007,t2,presidential
14635,92,HAUTS DE SEINE,80842,69060,2715,66345,2007,t2,presidential
14636,92,HAUTS DE SEINE,66352,56553,2207,54346,2007,t2,presidential
14637,92,HAUTS DE SEINE,67297,57121,1957,55164,2007,t2,presidential
14638,92,HAUTS DE SEINE,64466,56363,1625,54738,2007,t2,presidential
14639,92,HAUTS DE SEINE,80987,70594,2567,68027,2007,t2,presidential
14640,92,HAUTS DE SEINE,66089,56938,2296,54642,2007,t2,presidential
14641,92,HAUTS DE SEINE,59349,51806,1848,49958,2007,t2,presidential
14642,92,HAUTS DE SEINE,65530,56467,2256,54211,2007,t2,presidential
14643,92,HAUTS DE SEINE,65040,55512,1941,53571,2007,t2,presidential
14644,92,HAUTS DE SEINE,84841,73659,2845,70814,2007,t2,presidential
14645,92,HAUTS DE SEINE,83872,73044,3032,70012,2007,t2,presidential
14646,93,SEINE SAINT-DENIS,50011,40002,1192,38810,2007,t2,presidential
14647,93,SEINE SAINT-DENIS,49655,40177,1221,38956,2007,t2,presidential
14648,93,SEINE SAINT-DENIS,44629,36128,1075,35053,2007,t2,presidential
14649,93,SEINE SAINT-DENIS,45001,36325,1197,35128,2007,t2,presidential
14650,93,SEINE SAINT-DENIS,53032,42202,1387,40815,2007,t2,presidential
14651,93,SEINE SAINT-DENIS,60515,50353,1659,48694,2007,t2,presidential
14652,93,SEINE SAINT-DENIS,49358,40462,1204,39258,2007,t2,presidential
14653,93,SEINE SAINT-DENIS,60244,50624,1916,48708,2007,t2,presidential
14654,93,SEINE SAINT-DENIS,54873,45375,1435,43940,2007,t2,presidential
14655,93,SEINE SAINT-DENIS,51964,42760,1510,41250,2007,t2,presidential
14656,93,SEINE SAINT-DENIS,58476,48730,1632,47098,2007,t2,presidential
14657,93,SEINE SAINT-DENIS,61448,51751,1782,49969,2007,t2,presidential
14658,93,SEINE SAINT-DENIS,68957,59020,2157,56863,2007,t2,presidential
14659,94,VAL DE MARNE,54324,47172,1792,45380,2007,t2,presidential
14660,94,VAL DE MARNE,63841,53879,1784,52095,2007,t2,presidential
14661,94,VAL DE MARNE,68139,57524,2147,55377,2007,t2,presidential
14662,94,VAL DE MARNE,69729,59710,2379,57331,2007,t2,presidential
14663,94,VAL DE MARNE,61358,51640,1851,49789,2007,t2,presidential
14664,94,VAL DE MARNE,76757,65106,2482,62624,2007,t2,presidential
14665,94,VAL DE MARNE,58096,49381,1608,47773,2007,t2,presidential
14666,94,VAL DE MARNE,60963,52055,2006,50049,2007,t2,presidential
14667,94,VAL DE MARNE,51345,42764,1457,41307,2007,t2,presidential
14668,94,VAL DE MARNE,60438,49902,1812,48090,2007,t2,presidential
14669,94,VAL DE MARNE,57155,47415,1774,45641,2007,t2,presidential
14670,94,VAL DE MARNE,63936,53992,1958,52034,2007,t2,presidential
14671,95,VAL D'OISE,76567,66238,2726,63512,2007,t2,presidential
14672,95,VAL D'OISE,114048,98706,3751,94955,2007,t2,presidential
14673,95,VAL D'OISE,83411,70674,2923,67751,2007,t2,presidential
14674,95,VAL D'OISE,71438,60443,2346,58097,2007,t2,presidential
14675,95,VAL D'OISE,64042,52358,1727,50631,2007,t2,presidential
14676,95,VAL D'OISE,71881,60589,2167,58422,2007,t2,presidential
14677,95,VAL D'OISE,80156,68432,2544,65888,2007,t2,presidential
14678,95,VAL D'OISE,48549,40175,1154,39021,2007,t2,presidential
14679,95,VAL D'OISE,65182,54571,2093,52478,2007,t2,presidential
14680,971,GUADELOUPE,62293,39333,2458,36875,2007,t2,presidential
14681,971,GUADELOUPE,88414,57396,2829,54567,2007,t2,presidential
14682,971,GUADELOUPE,81828,56093,3032,53061,2007,t2,presidential
14683,971,GUADELOUPE,70687,45683,2315,43368,2007,t2,presidential
14684,972,MARTINIQUE,60680,42114,2253,39861,2007,t2,presidential
14685,972,MARTINIQUE,61477,39321,1754,37567,2007,t2,presidential
14686,972,MARTINIQUE,61912,39294,2277,37017,2007,t2,presidential
14687,972,MARTINIQUE,103449,68396,3523,64873,2007,t2,presidential
14688,973,GUYANE,22155,14171,647,13524,2007,t2,presidential
14689,973,GUYANE,40572,25639,898,24741,2007,t2,presidential
14690,974,LA REUNION,83306,62367,2052,60315,2007,t2,presidential
14691,974,LA REUNION,107565,82502,3115,79387,2007,t2,presidential
14692,974,LA REUNION,126601,101011,3280,97731,2007,t2,presidential
14693,974,LA REUNION,93589,73087,2256,70831,2007,t2,presidential
14694,974,LA REUNION,99972,75515,2067,73448,2007,t2,presidential
14695,975,MAYOTTE,64171,30659,1056,29603,2007,t2,presidential
14696,985,NOUVELLE CALEDONIE,146037,99484,1946,97538,2007,t2,presidential
14697,986,POLYNESIE FRANCAISE,167274,125137,1709,123428,2007,t2,presidential
14698,987,SAINT PIERRE ET MIQUELON,4923,3683,162,3521,2007,t2,presidential
14699,988,WALLIS-ET-FUTUNA ,11163,7758,52,7706,2007,t2,presidential
14700,99,FRANCAIS DE L'ETRANGER,821919,346310,6217,340093,2007,t2,presidential
14701,1,AIN,80484,65134,3532,61602,2002,t2,presidential
14702,1,AIN,82970,66761,3737,63024,2002,t2,presidential
14703,1,AIN,76758,61342,3224,58118,2002,t2,presidential
14704,1,AIN,97984,80566,4319,76247,2002,t2,presidential
14705,2,AISNE,69968,56392,3926,52466,2002,t2,presidential
14706,2,AISNE,72860,60076,3800,56276,2002,t2,presidential
14707,2,AISNE,72590,57789,4022,53767,2002,t2,presidential
14708,2,AISNE,76085,59609,3883,55726,2002,t2,presidential
14709,2,AISNE,75389,61231,3829,57402,2002,t2,presidential
14710,3,ALLIER,57771,46473,3099,43374,2002,t2,presidential
14711,3,ALLIER,65554,51870,3560,48310,2002,t2,presidential
14712,3,ALLIER,70074,57869,4052,53817,2002,t2,presidential
14713,3,ALLIER,62686,50879,3199,47680,2002,t2,presidential
14714,4,ALPES-DE-HAUTE-PROVENCE,53616,44257,2903,41354,2002,t2,presidential
14715,4,ALPES-DE-HAUTE-PROVENCE,55285,45831,2882,42949,2002,t2,presidential
14716,5,HAUTES-ALPES,52731,43901,2833,41068,2002,t2,presidential
14717,5,HAUTES-ALPES,42344,34641,2001,32640,2002,t2,presidential
14718,6,ALPES-MARITIMES,60985,42456,1925,40531,2002,t2,presidential
14719,6,ALPES-MARITIMES,66541,46085,1756,44329,2002,t2,presidential
14720,6,ALPES-MARITIMES,71908,50752,2214,48538,2002,t2,presidential
14721,6,ALPES-MARITIMES,69836,53543,2767,50776,2002,t2,presidential
14722,6,ALPES-MARITIMES,82945,63522,3593,59929,2002,t2,presidential
14723,6,ALPES-MARITIMES,94466,76104,3543,72561,2002,t2,presidential
14724,6,ALPES-MARITIMES,88792,69833,2874,66959,2002,t2,presidential
14725,6,ALPES-MARITIMES,60547,48001,1990,46011,2002,t2,presidential
14726,6,ALPES-MARITIMES,94111,74699,3542,71157,2002,t2,presidential
14727,7,ARDECHE,68851,56986,3829,53157,2002,t2,presidential
14728,7,ARDECHE,82913,68764,3881,64883,2002,t2,presidential
14729,7,ARDECHE,68039,56639,3940,52699,2002,t2,presidential
14730,8,ARDENNES,70286,55553,3814,51739,2002,t2,presidential
14731,8,ARDENNES,64062,49126,3192,45934,2002,t2,presidential
14732,8,ARDENNES,58061,46261,3276,42985,2002,t2,presidential
14733,9,ARIEGE,53927,44189,3647,40542,2002,t2,presidential
14734,9,ARIEGE,55059,45970,3769,42201,2002,t2,presidential
14735,10,AUBE,55478,44864,2696,42168,2002,t2,presidential
14736,10,AUBE,68671,55432,3259,52173,2002,t2,presidential
14737,10,AUBE,69612,55311,3364,51947,2002,t2,presidential
14738,11,AUDE,65679,54860,4010,50850,2002,t2,presidential
14739,11,AUDE,99543,80381,6352,74029,2002,t2,presidential
14740,11,AUDE,71591,59445,4868,54577,2002,t2,presidential
14741,12,AVEYRON,72574,61816,3290,58526,2002,t2,presidential
14742,12,AVEYRON,71934,60095,4092,56003,2002,t2,presidential
14743,12,AVEYRON,70285,60098,4118,55980,2002,t2,presidential
14744,13,BOUCHES-DU-RHONE,54987,43712,1804,41908,2002,t2,presidential
14745,13,BOUCHES-DU-RHONE,58104,47217,1636,45581,2002,t2,presidential
14746,13,BOUCHES-DU-RHONE,42878,33233,1182,32051,2002,t2,presidential
14747,13,BOUCHES-DU-RHONE,42755,31720,1222,30498,2002,t2,presidential
14748,13,BOUCHES-DU-RHONE,47671,37496,1461,36035,2002,t2,presidential
14749,13,BOUCHES-DU-RHONE,63258,50722,2023,48699,2002,t2,presidential
14750,13,BOUCHES-DU-RHONE,46567,35417,1384,34033,2002,t2,presidential
14751,13,BOUCHES-DU-RHONE,64168,51408,2450,48958,2002,t2,presidential
14752,13,BOUCHES-DU-RHONE,83154,67728,3425,64303,2002,t2,presidential
14753,13,BOUCHES-DU-RHONE,111660,91276,5177,86099,2002,t2,presidential
14754,13,BOUCHES-DU-RHONE,88009,72682,3567,69115,2002,t2,presidential
14755,13,BOUCHES-DU-RHONE,99619,81720,4423,77297,2002,t2,presidential
14756,13,BOUCHES-DU-RHONE,83008,67124,4136,62988,2002,t2,presidential
14757,13,BOUCHES-DU-RHONE,90352,75090,3111,71979,2002,t2,presidential
14758,13,BOUCHES-DU-RHONE,89691,74882,4536,70346,2002,t2,presidential
14759,13,BOUCHES-DU-RHONE,79139,64675,4063,60612,2002,t2,presidential
14760,14,CALVADOS,69107,55008,2352,52656,2002,t2,presidential
14761,14,CALVADOS,64506,51098,2640,48458,2002,t2,presidential
14762,14,CALVADOS,71450,57501,3207,54294,2002,t2,presidential
14763,14,CALVADOS,75438,61534,3015,58519,2002,t2,presidential
14764,14,CALVADOS,94135,76549,3556,72993,2002,t2,presidential
14765,14,CALVADOS,83443,69385,3852,65533,2002,t2,presidential
14766,15,CANTAL,63995,53628,2959,50669,2002,t2,presidential
14767,15,CANTAL,59820,48991,2414,46577,2002,t2,presidential
14768,16,CHARENTE,62466,50066,2928,47138,2002,t2,presidential
14769,16,CHARENTE,60708,49046,3002,46044,2002,t2,presidential
14770,16,CHARENTE,69322,57441,4287,53154,2002,t2,presidential
14771,16,CHARENTE,62601,50649,3271,47378,2002,t2,presidential
14772,17,CHARENTE-MARITIME,87210,71193,3376,67817,2002,t2,presidential
14773,17,CHARENTE-MARITIME,83062,67043,3718,63325,2002,t2,presidential
14774,17,CHARENTE-MARITIME,76327,62369,3809,58560,2002,t2,presidential
14775,17,CHARENTE-MARITIME,81754,66079,4154,61925,2002,t2,presidential
14776,17,CHARENTE-MARITIME,89455,72766,3920,68846,2002,t2,presidential
14777,18,CHER,73998,59709,3451,56258,2002,t2,presidential
14778,18,CHER,68621,53898,3400,50498,2002,t2,presidential
14779,18,CHER,85421,69114,4433,64681,2002,t2,presidential
14780,19,CORREZE,65455,57009,3656,53353,2002,t2,presidential
14781,19,CORREZE,66172,55861,3304,52557,2002,t2,presidential
14782,19,CORREZE,52535,45582,2970,42612,2002,t2,presidential
14783,2A,CORSE-DU-SUD,41170,28782,1705,27077,2002,t2,presidential
14784,2A,CORSE-DU-SUD,45260,30954,1972,28982,2002,t2,presidential
14785,2B,HAUTE-CORSE,47636,33302,2064,31238,2002,t2,presidential
14786,2B,HAUTE-CORSE,57206,36599,2674,33925,2002,t2,presidential
14787,21,COTE-D'OR,63080,52611,2444,50167,2002,t2,presidential
14788,21,COTE-D'OR,58357,47888,2671,45217,2002,t2,presidential
14789,21,COTE-D'OR,63112,51031,3047,47984,2002,t2,presidential
14790,21,COTE-D'OR,68364,55741,3698,52043,2002,t2,presidential
14791,21,COTE-D'OR,77384,63134,4045,59089,2002,t2,presidential
14792,22,COTES-D'ARMOR,83546,69396,3518,65878,2002,t2,presidential
14793,22,COTES-D'ARMOR,85822,72838,4480,68358,2002,t2,presidential
14794,22,COTES-D'ARMOR,83147,71089,4286,66803,2002,t2,presidential
14795,22,COTES-D'ARMOR,78977,66679,4597,62082,2002,t2,presidential
14796,22,COTES-D'ARMOR,97229,80720,4067,76653,2002,t2,presidential
14797,23,CREUSE,51297,41237,2478,38759,2002,t2,presidential
14798,23,CREUSE,50505,41215,2646,38569,2002,t2,presidential
14799,24,DORDOGNE,72731,60705,4345,56360,2002,t2,presidential
14800,24,DORDOGNE,77234,64610,4486,60124,2002,t2,presidential
14801,24,DORDOGNE,71024,60972,4350,56622,2002,t2,presidential
14802,24,DORDOGNE,82859,71109,5007,66102,2002,t2,presidential
14803,25,DOUBS,65256,54049,3014,51035,2002,t2,presidential
14804,25,DOUBS,69608,58029,3250,54779,2002,t2,presidential
14805,25,DOUBS,64159,53052,3646,49406,2002,t2,presidential
14806,25,DOUBS,65381,52582,3901,48681,2002,t2,presidential
14807,25,DOUBS,70225,59671,3550,56121,2002,t2,presidential
14808,26,DROME,68021,54443,2566,51877,2002,t2,presidential
14809,26,DROME,74041,60601,3646,56955,2002,t2,presidential
14810,26,DROME,90100,75794,4702,71092,2002,t2,presidential
14811,26,DROME,77373,63163,3389,59774,2002,t2,presidential
14812,27,EURE,78253,62521,3157,59364,2002,t2,presidential
14813,27,EURE,70179,57183,2966,54217,2002,t2,presidential
14814,27,EURE,73176,60247,3348,56899,2002,t2,presidential
14815,27,EURE,77095,61598,3422,58176,2002,t2,presidential
14816,27,EURE,79538,63844,3490,60354,2002,t2,presidential
14817,28,EURE-ET-LOIR,78661,64327,3236,61091,2002,t2,presidential
14818,28,EURE-ET-LOIR,64580,51088,2574,48514,2002,t2,presidential
14819,28,EURE-ET-LOIR,69202,55171,2959,52212,2002,t2,presidential
14820,28,EURE-ET-LOIR,65530,53683,3286,50397,2002,t2,presidential
14821,29,FINISTERE,79022,67147,3222,63925,2002,t2,presidential
14822,29,FINISTERE,67775,54027,2330,51697,2002,t2,presidential
14823,29,FINISTERE,86389,71011,3174,67837,2002,t2,presidential
14824,29,FINISTERE,78416,65133,3456,61677,2002,t2,presidential
14825,29,FINISTERE,84260,70730,2897,67833,2002,t2,presidential
14826,29,FINISTERE,85492,71435,3992,67443,2002,t2,presidential
14827,29,FINISTERE,76484,62437,3232,59205,2002,t2,presidential
14828,29,FINISTERE,77594,63259,3495,59764,2002,t2,presidential
14829,30,GARD,76806,59884,3194,56690,2002,t2,presidential
14830,30,GARD,101988,83377,5311,78066,2002,t2,presidential
14831,30,GARD,102903,85516,5838,79678,2002,t2,presidential
14832,30,GARD,79600,65178,4888,60290,2002,t2,presidential
14833,30,GARD,84203,69805,5135,64670,2002,t2,presidential
14834,31,HAUTE-GARONNE,63324,49183,2082,47101,2002,t2,presidential
14835,31,HAUTE-GARONNE,99385,82288,4534,77754,2002,t2,presidential
14836,31,HAUTE-GARONNE,78586,65877,3138,62739,2002,t2,presidential
14837,31,HAUTE-GARONNE,49857,38790,1631,37159,2002,t2,presidential
14838,31,HAUTE-GARONNE,119648,100181,6138,94043,2002,t2,presidential
14839,31,HAUTE-GARONNE,112517,93468,5324,88144,2002,t2,presidential
14840,31,HAUTE-GARONNE,107834,91697,6507,85190,2002,t2,presidential
14841,31,HAUTE-GARONNE,79384,64559,5157,59402,2002,t2,presidential
14842,32,GERS,70053,59389,4134,55255,2002,t2,presidential
14843,32,GERS,65292,55464,3841,51623,2002,t2,presidential
14844,33,GIRONDE,72345,58470,2473,55997,2002,t2,presidential
14845,33,GIRONDE,51615,40663,1530,39133,2002,t2,presidential
14846,33,GIRONDE,64564,52608,2779,49829,2002,t2,presidential
14847,33,GIRONDE,76772,61289,3583,57706,2002,t2,presidential
14848,33,GIRONDE,86013,70643,4778,65865,2002,t2,presidential
14849,33,GIRONDE,79689,67060,3538,63522,2002,t2,presidential
14850,33,GIRONDE,90223,74519,4066,70453,2002,t2,presidential
14851,33,GIRONDE,105299,86749,5269,81480,2002,t2,presidential
14852,33,GIRONDE,90916,76386,5295,71091,2002,t2,presidential
14853,33,GIRONDE,74116,60694,4008,56686,2002,t2,presidential
14854,33,GIRONDE,76000,62223,4306,57917,2002,t2,presidential
14855,34,HERAULT,67066,54020,2689,51331,2002,t2,presidential
14856,34,HERAULT,57214,46041,2314,43727,2002,t2,presidential
14857,34,HERAULT,114124,94900,5722,89178,2002,t2,presidential
14858,34,HERAULT,118572,99318,6613,92705,2002,t2,presidential
14859,34,HERAULT,88148,71933,6399,65534,2002,t2,presidential
14860,34,HERAULT,79995,62888,4613,58275,2002,t2,presidential
14861,34,HERAULT,107127,85856,5957,79899,2002,t2,presidential
14862,35,ILLE-ET-VILAINE,71507,56823,2610,54213,2002,t2,presidential
14863,35,ILLE-ET-VILAINE,89609,74857,3340,71517,2002,t2,presidential
14864,35,ILLE-ET-VILAINE,83110,69311,3014,66297,2002,t2,presidential
14865,35,ILLE-ET-VILAINE,98622,82491,3874,78617,2002,t2,presidential
14866,35,ILLE-ET-VILAINE,108582,91496,3643,87853,2002,t2,presidential
14867,35,ILLE-ET-VILAINE,73938,62006,3165,58841,2002,t2,presidential
14868,35,ILLE-ET-VILAINE,92887,75969,3858,72111,2002,t2,presidential
14869,36,INDRE,55249,44812,2706,42106,2002,t2,presidential
14870,36,INDRE,64229,52985,3748,49237,2002,t2,presidential
14871,36,INDRE,57178,47450,3245,44205,2002,t2,presidential
14872,37,INDRE-ET-LOIRE,53448,40589,1525,39064,2002,t2,presidential
14873,37,INDRE-ET-LOIRE,84878,70013,3715,66298,2002,t2,presidential
14874,37,INDRE-ET-LOIRE,87549,72416,4062,68354,2002,t2,presidential
14875,37,INDRE-ET-LOIRE,81896,66444,3392,63052,2002,t2,presidential
14876,37,INDRE-ET-LOIRE,73372,60346,3080,57266,2002,t2,presidential
14877,38,ISERE,74162,61183,1776,59407,2002,t2,presidential
14878,38,ISERE,65579,53938,2355,51583,2002,t2,presidential
14879,38,ISERE,53997,43570,1647,41923,2002,t2,presidential
14880,38,ISERE,77567,63587,3031,60556,2002,t2,presidential
14881,38,ISERE,82829,68771,3307,65464,2002,t2,presidential
14882,38,ISERE,92298,73491,4113,69378,2002,t2,presidential
14883,38,ISERE,88239,71378,4127,67251,2002,t2,presidential
14884,38,ISERE,93721,75190,4351,70839,2002,t2,presidential
14885,38,ISERE,80084,66481,3338,63143,2002,t2,presidential
14886,39,JURA,62552,51494,3430,48064,2002,t2,presidential
14887,39,JURA,53563,43456,3012,40444,2002,t2,presidential
14888,39,JURA,65198,54493,3882,50611,2002,t2,presidential
14889,40,LANDES,84074,69666,4587,65079,2002,t2,presidential
14890,40,LANDES,95564,78763,5068,73695,2002,t2,presidential
14891,40,LANDES,79176,67148,5008,62140,2002,t2,presidential
14892,41,LOIR-ET-CHER,86602,70079,3877,66202,2002,t2,presidential
14893,41,LOIR-ET-CHER,76762,62903,3647,59256,2002,t2,presidential
14894,41,LOIR-ET-CHER,69292,57092,3370,53722,2002,t2,presidential
14895,42,LOIRE,66156,51239,2476,48763,2002,t2,presidential
14896,42,LOIRE,50189,37983,1651,36332,2002,t2,presidential
14897,42,LOIRE,74821,60290,3299,56991,2002,t2,presidential
14898,42,LOIRE,66877,52827,2994,49833,2002,t2,presidential
14899,42,LOIRE,68239,54273,3217,51056,2002,t2,presidential
14900,42,LOIRE,65384,53491,3071,50420,2002,t2,presidential
14901,42,LOIRE,92328,75393,4169,71224,2002,t2,presidential
14902,43,HAUTE-LOIRE,87532,73009,4523,68486,2002,t2,presidential
14903,43,HAUTE-LOIRE,78774,64508,4510,59998,2002,t2,presidential
14904,44,LOIRE-ATLANTIQUE,68645,54077,1947,52130,2002,t2,presidential
14905,44,LOIRE-ATLANTIQUE,75928,58494,2183,56311,2002,t2,presidential
14906,44,LOIRE-ATLANTIQUE,80799,63317,3271,60046,2002,t2,presidential
14907,44,LOIRE-ATLANTIQUE,73830,59532,2971,56561,2002,t2,presidential
14908,44,LOIRE-ATLANTIQUE,103861,86998,3839,83159,2002,t2,presidential
14909,44,LOIRE-ATLANTIQUE,70855,59275,2903,56372,2002,t2,presidential
14910,44,LOIRE-ATLANTIQUE,94356,77767,4033,73734,2002,t2,presidential
14911,44,LOIRE-ATLANTIQUE,71975,57540,3357,54183,2002,t2,presidential
14912,44,LOIRE-ATLANTIQUE,85933,71855,3687,68168,2002,t2,presidential
14913,44,LOIRE-ATLANTIQUE,88398,75083,3493,71590,2002,t2,presidential
14914,45,LOIRET,77320,64009,2919,61090,2002,t2,presidential
14915,45,LOIRET,77107,62192,3086,59106,2002,t2,presidential
14916,45,LOIRET,82971,68247,3287,64960,2002,t2,presidential
14917,45,LOIRET,88391,70569,3644,66925,2002,t2,presidential
14918,45,LOIRET,83436,68744,3780,64964,2002,t2,presidential
14919,46,LOT,65545,55841,3680,52161,2002,t2,presidential
14920,46,LOT,62616,53786,3921,49865,2002,t2,presidential
14921,47,LOT-ET-GARONNE,80044,67105,4468,62637,2002,t2,presidential
14922,47,LOT-ET-GARONNE,75476,62669,4855,57814,2002,t2,presidential
14923,47,LOT-ET-GARONNE,73462,61260,4203,57057,2002,t2,presidential
14924,48,LOZERE,31335,26072,1818,24254,2002,t2,presidential
14925,48,LOZERE,27479,23421,1264,22157,2002,t2,presidential
14926,49,MAINE-ET-LOIRE,74959,61308,2689,58619,2002,t2,presidential
14927,49,MAINE-ET-LOIRE,79783,66238,3434,62804,2002,t2,presidential
14928,49,MAINE-ET-LOIRE,64125,52014,2629,49385,2002,t2,presidential
14929,49,MAINE-ET-LOIRE,68481,56265,2699,53566,2002,t2,presidential
14930,49,MAINE-ET-LOIRE,70309,58085,2963,55122,2002,t2,presidential
14931,49,MAINE-ET-LOIRE,84255,70970,3346,67624,2002,t2,presidential
14932,49,MAINE-ET-LOIRE,68016,57027,2541,54486,2002,t2,presidential
14933,50,MANCHE,72142,59133,2791,56342,2002,t2,presidential
14934,50,MANCHE,75057,62682,2896,59786,2002,t2,presidential
14935,50,MANCHE,73369,59106,2765,56341,2002,t2,presidential
14936,50,MANCHE,69373,56718,2727,53991,2002,t2,presidential
14937,50,MANCHE,68939,54395,2930,51465,2002,t2,presidential
14938,51,MARNE,56111,42053,1693,40360,2002,t2,presidential
14939,51,MARNE,64665,50629,2483,48146,2002,t2,presidential
14940,51,MARNE,62652,48083,2416,45667,2002,t2,presidential
14941,51,MARNE,59207,45759,2431,43328,2002,t2,presidential
14942,51,MARNE,62135,50259,3015,47244,2002,t2,presidential
14943,51,MARNE,67253,52156,3038,49118,2002,t2,presidential
14944,52,HAUTE-MARNE,76914,61546,4284,57262,2002,t2,presidential
14945,52,HAUTE-MARNE,66694,51974,3344,48630,2002,t2,presidential
14946,53,MAYENNE,78845,64827,3294,61533,2002,t2,presidential
14947,53,MAYENNE,64960,53510,2300,51210,2002,t2,presidential
14948,53,MAYENNE,70247,58415,2985,55430,2002,t2,presidential
14949,54,MEURTHE-ET-MOSELLE,48301,37813,1567,36246,2002,t2,presidential
14950,54,MEURTHE-ET-MOSELLE,74593,60014,2863,57151,2002,t2,presidential
14951,54,MEURTHE-ET-MOSELLE,56374,44484,1947,42537,2002,t2,presidential
14952,54,MEURTHE-ET-MOSELLE,74695,59385,3774,55611,2002,t2,presidential
14953,54,MEURTHE-ET-MOSELLE,70827,58162,3280,54882,2002,t2,presidential
14954,54,MEURTHE-ET-MOSELLE,75008,58991,3812,55179,2002,t2,presidential
14955,54,MEURTHE-ET-MOSELLE,69626,52845,3059,49786,2002,t2,presidential
14956,55,MEUSE,78462,63704,4210,59494,2002,t2,presidential
14957,55,MEUSE,60425,48039,2819,45220,2002,t2,presidential
14958,56,MORBIHAN,93059,78271,3281,74990,2002,t2,presidential
14959,56,MORBIHAN,83422,68799,3647,65152,2002,t2,presidential
14960,56,MORBIHAN,77258,65042,3560,61482,2002,t2,presidential
14961,56,MORBIHAN,82258,69194,3217,65977,2002,t2,presidential
14962,56,MORBIHAN,79748,61889,3073,58816,2002,t2,presidential
14963,56,MORBIHAN,83310,69233,4154,65079,2002,t2,presidential
14964,57,MOSELLE,70418,54266,2688,51578,2002,t2,presidential
14965,57,MOSELLE,71436,56155,2827,53328,2002,t2,presidential
14966,57,MOSELLE,69173,53594,2455,51139,2002,t2,presidential
14967,57,MOSELLE,67794,54664,3239,51425,2002,t2,presidential
14968,57,MOSELLE,73615,57689,3428,54261,2002,t2,presidential
14969,57,MOSELLE,72052,53758,2739,51019,2002,t2,presidential
14970,57,MOSELLE,76631,60067,3372,56695,2002,t2,presidential
14971,57,MOSELLE,71950,56813,3264,53549,2002,t2,presidential
14972,57,MOSELLE,70460,54257,2602,51655,2002,t2,presidential
14973,57,MOSELLE,68672,51660,2921,48739,2002,t2,presidential
14974,58,NIEVRE,55231,42977,2899,40078,2002,t2,presidential
14975,58,NIEVRE,59754,47614,3362,44252,2002,t2,presidential
14976,58,NIEVRE,55348,43987,3474,40513,2002,t2,presidential
14977,59,NORD,58052,40658,1436,39222,2002,t2,presidential
14978,59,NORD,70644,54256,2492,51764,2002,t2,presidential
14979,59,NORD,59669,44545,1543,43002,2002,t2,presidential
14980,59,NORD,69453,54309,2367,51942,2002,t2,presidential
14981,59,NORD,83280,65944,3673,62271,2002,t2,presidential
14982,59,NORD,76775,63973,3564,60409,2002,t2,presidential
14983,59,NORD,68052,51007,2295,48712,2002,t2,presidential
14984,59,NORD,67670,49210,2120,47090,2002,t2,presidential
14985,59,NORD,64937,50453,1749,48704,2002,t2,presidential
14986,59,NORD,73716,55673,2547,53126,2002,t2,presidential
14987,59,NORD,84058,65644,3662,61982,2002,t2,presidential
14988,59,NORD,69510,54146,3465,50681,2002,t2,presidential
14989,59,NORD,64670,50995,2983,48012,2002,t2,presidential
14990,59,NORD,71287,59123,3705,55418,2002,t2,presidential
14991,59,NORD,71122,57596,3550,54046,2002,t2,presidential
14992,59,NORD,79682,62640,4092,58548,2002,t2,presidential
14993,59,NORD,72988,56719,3482,53237,2002,t2,presidential
14994,59,NORD,77505,61916,4274,57642,2002,t2,presidential
14995,59,NORD,77833,59643,3969,55674,2002,t2,presidential
14996,59,NORD,80037,60718,3426,57292,2002,t2,presidential
14997,59,NORD,74876,57769,3187,54582,2002,t2,presidential
14998,59,NORD,74078,59607,4399,55208,2002,t2,presidential
14999,59,NORD,66879,50544,2489,48055,2002,t2,presidential
15000,59,NORD,64371,49990,3173,46817,2002,t2,presidential
15001,60,OISE,74702,60767,3756,57011,2002,t2,presidential
15002,60,OISE,79588,65104,3552,61552,2002,t2,presidential
15003,60,OISE,64332,51114,3109,48005,2002,t2,presidential
15004,60,OISE,83314,66509,3283,63226,2002,t2,presidential
15005,60,OISE,65762,52590,3110,49480,2002,t2,presidential
15006,60,OISE,69342,55564,3565,51999,2002,t2,presidential
15007,60,OISE,69752,55210,3366,51844,2002,t2,presidential
15008,61,ORNE,71273,58905,2793,56112,2002,t2,presidential
15009,61,ORNE,69396,56578,2691,53887,2002,t2,presidential
15010,61,ORNE,73518,60407,3248,57159,2002,t2,presidential
15011,62,PAS-DE-CALAIS,77653,65247,4441,60806,2002,t2,presidential
15012,62,PAS-DE-CALAIS,73580,61327,4159,57168,2002,t2,presidential
15013,62,PAS-DE-CALAIS,72910,62905,4823,58082,2002,t2,presidential
15014,62,PAS-DE-CALAIS,76636,61864,4096,57768,2002,t2,presidential
15015,62,PAS-DE-CALAIS,62861,48471,2856,45615,2002,t2,presidential
15016,62,PAS-DE-CALAIS,70391,54487,3055,51432,2002,t2,presidential
15017,62,PAS-DE-CALAIS,80990,62517,4164,58353,2002,t2,presidential
15018,62,PAS-DE-CALAIS,67094,54498,3802,50696,2002,t2,presidential
15019,62,PAS-DE-CALAIS,79491,63496,4727,58769,2002,t2,presidential
15020,62,PAS-DE-CALAIS,71935,54269,3743,50526,2002,t2,presidential
15021,62,PAS-DE-CALAIS,91661,71830,4997,66833,2002,t2,presidential
15022,62,PAS-DE-CALAIS,77479,57526,3844,53682,2002,t2,presidential
15023,62,PAS-DE-CALAIS,71447,53009,3241,49768,2002,t2,presidential
15024,62,PAS-DE-CALAIS,73907,55569,3239,52330,2002,t2,presidential
15025,63,PUY-DE-DOME,58433,46925,2548,44377,2002,t2,presidential
15026,63,PUY-DE-DOME,72445,60113,3527,56586,2002,t2,presidential
15027,63,PUY-DE-DOME,71440,59264,2776,56488,2002,t2,presidential
15028,63,PUY-DE-DOME,73510,61343,4006,57337,2002,t2,presidential
15029,63,PUY-DE-DOME,64850,52541,3943,48598,2002,t2,presidential
15030,63,PUY-DE-DOME,84683,70829,4587,66242,2002,t2,presidential
15031,64,PYRENEES-ATLANTIQUES,64739,53364,2900,50464,2002,t2,presidential
15032,64,PYRENEES-ATLANTIQUES,69180,58757,3840,54917,2002,t2,presidential
15033,64,PYRENEES-ATLANTIQUES,76443,64553,4658,59895,2002,t2,presidential
15034,64,PYRENEES-ATLANTIQUES,78754,65631,4608,61023,2002,t2,presidential
15035,64,PYRENEES-ATLANTIQUES,76398,61388,3674,57714,2002,t2,presidential
15036,64,PYRENEES-ATLANTIQUES,84875,68100,4227,63873,2002,t2,presidential
15037,65,HAUTES-PYRENEES,59077,48515,3799,44716,2002,t2,presidential
15038,65,HAUTES-PYRENEES,59918,50059,3232,46827,2002,t2,presidential
15039,65,HAUTES-PYRENEES,50128,41363,2925,38438,2002,t2,presidential
15040,66,PYRENEES-ORIENTALES,58656,46739,2749,43990,2002,t2,presidential
15041,66,PYRENEES-ORIENTALES,85388,69411,4822,64589,2002,t2,presidential
15042,66,PYRENEES-ORIENTALES,61540,48655,3555,45100,2002,t2,presidential
15043,66,PYRENEES-ORIENTALES,80358,65730,4970,60760,2002,t2,presidential
15044,67,BAS-RHIN,48354,38459,1067,37392,2002,t2,presidential
15045,67,BAS-RHIN,47884,37132,1320,35812,2002,t2,presidential
15046,67,BAS-RHIN,60985,47293,1814,45479,2002,t2,presidential
15047,67,BAS-RHIN,106261,85540,4004,81536,2002,t2,presidential
15048,67,BAS-RHIN,92679,74112,4171,69941,2002,t2,presidential
15049,67,BAS-RHIN,75154,61162,3550,57612,2002,t2,presidential
15050,67,BAS-RHIN,78461,63379,3939,59440,2002,t2,presidential
15051,67,BAS-RHIN,67818,53972,3448,50524,2002,t2,presidential
15052,67,BAS-RHIN,97418,78287,4080,74207,2002,t2,presidential
15053,68,HAUT-RHIN,67870,53467,2664,50803,2002,t2,presidential
15054,68,HAUT-RHIN,71382,58582,3406,55176,2002,t2,presidential
15055,68,HAUT-RHIN,78216,64430,3978,60452,2002,t2,presidential
15056,68,HAUT-RHIN,68563,54604,2742,51862,2002,t2,presidential
15057,68,HAUT-RHIN,51184,39531,1780,37751,2002,t2,presidential
15058,68,HAUT-RHIN,70370,54860,2947,51913,2002,t2,presidential
15059,68,HAUT-RHIN,70891,57197,3678,53519,2002,t2,presidential
15060,69,RHONE,54273,43873,1704,42169,2002,t2,presidential
15061,69,RHONE,62233,50834,1680,49154,2002,t2,presidential
15062,69,RHONE,56759,45972,1655,44317,2002,t2,presidential
15063,69,RHONE,63237,51947,1664,50283,2002,t2,presidential
15064,69,RHONE,78547,64693,2276,62417,2002,t2,presidential
15065,69,RHONE,63610,49420,2148,47272,2002,t2,presidential
15066,69,RHONE,53170,41740,1678,40062,2002,t2,presidential
15067,69,RHONE,76284,62729,3156,59573,2002,t2,presidential
15068,69,RHONE,72408,58553,2842,55711,2002,t2,presidential
15069,69,RHONE,81387,68199,2765,65434,2002,t2,presidential
15070,69,RHONE,73000,59920,3203,56717,2002,t2,presidential
15071,69,RHONE,68457,55735,2196,53539,2002,t2,presidential
15072,69,RHONE,82837,66423,3195,63228,2002,t2,presidential
15073,69,RHONE,46413,35136,1767,33369,2002,t2,presidential
15074,70,HAUTE-SAONE,61876,51233,3618,47615,2002,t2,presidential
15075,70,HAUTE-SAONE,61123,49809,4354,45455,2002,t2,presidential
15076,70,HAUTE-SAONE,51460,41754,3962,37792,2002,t2,presidential
15077,71,SAONE-ET-LOIRE,62991,50656,2819,47837,2002,t2,presidential
15078,71,SAONE-ET-LOIRE,64433,51706,3450,48256,2002,t2,presidential
15079,71,SAONE-ET-LOIRE,67421,53441,4270,49171,2002,t2,presidential
15080,71,SAONE-ET-LOIRE,61186,47394,3400,43994,2002,t2,presidential
15081,71,SAONE-ET-LOIRE,62044,48536,2986,45550,2002,t2,presidential
15082,71,SAONE-ET-LOIRE,80322,64981,4648,60333,2002,t2,presidential
15083,72,SARTHE,67928,55327,3119,52208,2002,t2,presidential
15084,72,SARTHE,79212,62290,4256,58034,2002,t2,presidential
15085,72,SARTHE,80758,65393,4101,61292,2002,t2,presidential
15086,72,SARTHE,73636,59490,3332,56158,2002,t2,presidential
15087,72,SARTHE,83811,67968,3875,64093,2002,t2,presidential
15088,73,SAVOIE,97512,79379,4132,75247,2002,t2,presidential
15089,73,SAVOIE,78840,62304,3485,58819,2002,t2,presidential
15090,73,SAVOIE,88610,71406,4148,67258,2002,t2,presidential
15091,74,HAUTE-SAVOIE,91746,75343,3762,71581,2002,t2,presidential
15092,74,HAUTE-SAVOIE,77065,62427,2909,59518,2002,t2,presidential
15093,74,HAUTE-SAVOIE,77535,60833,2869,57964,2002,t2,presidential
15094,74,HAUTE-SAVOIE,80253,63604,2970,60634,2002,t2,presidential
15095,74,HAUTE-SAVOIE,94567,75195,3908,71287,2002,t2,presidential
15096,75,PARIS,54137,45272,1161,44111,2002,t2,presidential
15097,75,PARIS,49659,42609,1033,41576,2002,t2,presidential
15098,75,PARIS,40305,34002,747,33255,2002,t2,presidential
15099,75,PARIS,50188,41738,959,40779,2002,t2,presidential
15100,75,PARIS,40448,33075,881,32194,2002,t2,presidential
15101,75,PARIS,54804,45385,1315,44070,2002,t2,presidential
15102,75,PARIS,55239,46058,1253,44805,2002,t2,presidential
15103,75,PARIS,63575,53085,1588,51497,2002,t2,presidential
15104,75,PARIS,53190,43830,1419,42411,2002,t2,presidential
15105,75,PARIS,57645,48654,1350,47304,2002,t2,presidential
15106,75,PARIS,53280,44492,1335,43157,2002,t2,presidential
15107,75,PARIS,60342,50403,1337,49066,2002,t2,presidential
15108,75,PARIS,63166,52615,1401,51214,2002,t2,presidential
15109,75,PARIS,45013,37744,765,36979,2002,t2,presidential
15110,75,PARIS,37468,30927,572,30355,2002,t2,presidential
15111,75,PARIS,48847,40776,866,39910,2002,t2,presidential
15112,75,PARIS,47924,38669,1132,37537,2002,t2,presidential
15113,75,PARIS,48358,39686,1159,38527,2002,t2,presidential
15114,75,PARIS,39821,31717,1132,30585,2002,t2,presidential
15115,75,PARIS,54505,44269,1422,42847,2002,t2,presidential
15116,75,PARIS,63399,51805,1742,50063,2002,t2,presidential
15117,76,SEINE-MARITIME,55000,44206,1627,42579,2002,t2,presidential
15118,76,SEINE-MARITIME,82813,67988,2958,65030,2002,t2,presidential
15119,76,SEINE-MARITIME,54167,42566,2435,40131,2002,t2,presidential
15120,76,SEINE-MARITIME,69637,54827,3197,51630,2002,t2,presidential
15121,76,SEINE-MARITIME,85175,68973,3842,65131,2002,t2,presidential
15122,76,SEINE-MARITIME,75595,59522,3426,56096,2002,t2,presidential
15123,76,SEINE-MARITIME,57925,45388,1774,43614,2002,t2,presidential
15124,76,SEINE-MARITIME,52461,38634,1950,36684,2002,t2,presidential
15125,76,SEINE-MARITIME,80831,66753,3752,63001,2002,t2,presidential
15126,76,SEINE-MARITIME,80600,66991,3652,63339,2002,t2,presidential
15127,76,SEINE-MARITIME,73037,59060,3484,55576,2002,t2,presidential
15128,76,SEINE-MARITIME,70251,58090,3141,54949,2002,t2,presidential
15129,77,SEINE-ET-MARNE,80857,64217,2818,61399,2002,t2,presidential
15130,77,SEINE-ET-MARNE,71715,58501,2750,55751,2002,t2,presidential
15131,77,SEINE-ET-MARNE,70739,56888,2933,53955,2002,t2,presidential
15132,77,SEINE-ET-MARNE,76380,61778,3317,58461,2002,t2,presidential
15133,77,SEINE-ET-MARNE,81029,64708,3269,61439,2002,t2,presidential
15134,77,SEINE-ET-MARNE,74128,59334,3037,56297,2002,t2,presidential
15135,77,SEINE-ET-MARNE,81097,63220,2822,60398,2002,t2,presidential
15136,77,SEINE-ET-MARNE,92015,74488,2884,71604,2002,t2,presidential
15137,77,SEINE-ET-MARNE,93851,75899,3551,72348,2002,t2,presidential
15138,78,YVELINES,82458,69177,2309,66868,2002,t2,presidential
15139,78,YVELINES,73108,60450,2060,58390,2002,t2,presidential
15140,78,YVELINES,64570,53636,1497,52139,2002,t2,presidential
15141,78,YVELINES,69017,56632,1848,54784,2002,t2,presidential
15142,78,YVELINES,63398,51763,1795,49968,2002,t2,presidential
15143,78,YVELINES,55438,44940,1547,43393,2002,t2,presidential
15144,78,YVELINES,68356,55672,2432,53240,2002,t2,presidential
15145,78,YVELINES,59152,47650,2337,45313,2002,t2,presidential
15146,78,YVELINES,78140,64231,3087,61144,2002,t2,presidential
15147,78,YVELINES,94559,78118,3295,74823,2002,t2,presidential
15148,78,YVELINES,51980,41113,1685,39428,2002,t2,presidential
15149,78,YVELINES,65140,53085,2018,51067,2002,t2,presidential
15150,79,DEUX-SEVRES,59890,50047,2197,47850,2002,t2,presidential
15151,79,DEUX-SEVRES,70192,58876,3048,55828,2002,t2,presidential
15152,79,DEUX-SEVRES,61338,51544,2469,49075,2002,t2,presidential
15153,79,DEUX-SEVRES,69496,57792,2573,55219,2002,t2,presidential
15154,80,SOMME,57406,44877,2630,42247,2002,t2,presidential
15155,80,SOMME,61758,49522,2593,46929,2002,t2,presidential
15156,80,SOMME,67740,56340,4908,51432,2002,t2,presidential
15157,80,SOMME,71914,58661,3910,54751,2002,t2,presidential
15158,80,SOMME,65003,52825,3661,49164,2002,t2,presidential
15159,80,SOMME,76037,63073,4294,58779,2002,t2,presidential
15160,81,TARN,55984,47330,4067,43263,2002,t2,presidential
15161,81,TARN,73846,62383,4094,58289,2002,t2,presidential
15162,81,TARN,58112,48926,3290,45636,2002,t2,presidential
15163,81,TARN,73465,62807,4337,58470,2002,t2,presidential
15164,82,TARN-ET-GARONNE,75852,64306,4116,60190,2002,t2,presidential
15165,82,TARN-ET-GARONNE,77828,65301,4856,60445,2002,t2,presidential
15166,83,VAR,49553,37488,1571,35917,2002,t2,presidential
15167,83,VAR,53129,40837,2065,38772,2002,t2,presidential
15168,83,VAR,102950,82414,4366,78048,2002,t2,presidential
15169,83,VAR,105847,85630,4677,80953,2002,t2,presidential
15170,83,VAR,94705,75592,3742,71850,2002,t2,presidential
15171,83,VAR,138374,112862,6725,106137,2002,t2,presidential
15172,83,VAR,100752,77858,3976,73882,2002,t2,presidential
15173,84,VAUCLUSE,67977,54126,2863,51263,2002,t2,presidential
15174,84,VAUCLUSE,109917,90728,5184,85544,2002,t2,presidential
15175,84,VAUCLUSE,88862,73003,4465,68538,2002,t2,presidential
15176,84,VAUCLUSE,76058,63489,3687,59802,2002,t2,presidential
15177,85,VENDEE,86654,72184,3316,68868,2002,t2,presidential
15178,85,VENDEE,83073,69780,3440,66340,2002,t2,presidential
15179,85,VENDEE,96412,77649,4223,73426,2002,t2,presidential
15180,85,VENDEE,85268,73538,2857,70681,2002,t2,presidential
15181,85,VENDEE,76447,63381,3503,59878,2002,t2,presidential
15182,86,VIENNE,76166,63660,3063,60597,2002,t2,presidential
15183,86,VIENNE,68857,57766,2505,55261,2002,t2,presidential
15184,86,VIENNE,67770,56704,3181,53523,2002,t2,presidential
15185,86,VIENNE,74164,59971,3369,56602,2002,t2,presidential
15186,87,HAUTE-VIENNE,52015,43171,2275,40896,2002,t2,presidential
15187,87,HAUTE-VIENNE,72571,61826,4015,57811,2002,t2,presidential
15188,87,HAUTE-VIENNE,66354,55272,3554,51718,2002,t2,presidential
15189,87,HAUTE-VIENNE,69979,58615,3915,54700,2002,t2,presidential
15190,88,VOSGES,75212,60089,3586,56503,2002,t2,presidential
15191,88,VOSGES,73240,58039,3986,54053,2002,t2,presidential
15192,88,VOSGES,65974,54412,3259,51153,2002,t2,presidential
15193,88,VOSGES,68736,56139,3982,52157,2002,t2,presidential
15194,89,YONNE,75738,61743,3397,58346,2002,t2,presidential
15195,89,YONNE,72403,58161,3576,54585,2002,t2,presidential
15196,89,YONNE,87417,70342,3805,66537,2002,t2,presidential
15197,90,TERRITOIRE DE BELFORT,43770,35726,2517,33209,2002,t2,presidential
15198,90,TERRITOIRE DE BELFORT,45862,37401,2810,34591,2002,t2,presidential
15199,91,ESSONNE,59920,47179,2095,45084,2002,t2,presidential
15200,91,ESSONNE,75536,61839,3010,58829,2002,t2,presidential
15201,91,ESSONNE,86375,71139,3367,67772,2002,t2,presidential
15202,91,ESSONNE,76314,62871,2707,60164,2002,t2,presidential
15203,91,ESSONNE,60568,50758,1750,49008,2002,t2,presidential
15204,91,ESSONNE,67311,54674,2165,52509,2002,t2,presidential
15205,91,ESSONNE,65211,52481,2279,50202,2002,t2,presidential
15206,91,ESSONNE,67957,54054,2308,51746,2002,t2,presidential
15207,91,ESSONNE,68283,54773,2351,52422,2002,t2,presidential
15208,91,ESSONNE,54323,42535,1880,40655,2002,t2,presidential
15209,92,HAUTS-DE-SEINE,52897,39400,1594,37806,2002,t2,presidential
15210,92,HAUTS-DE-SEINE,52031,42516,1355,41161,2002,t2,presidential
15211,92,HAUTS-DE-SEINE,69052,56234,1764,54470,2002,t2,presidential
15212,92,HAUTS-DE-SEINE,59691,46766,1683,45083,2002,t2,presidential
15213,92,HAUTS-DE-SEINE,58114,47131,1542,45589,2002,t2,presidential
15214,92,HAUTS-DE-SEINE,58032,48462,1238,47224,2002,t2,presidential
15215,92,HAUTS-DE-SEINE,77815,61957,1770,60187,2002,t2,presidential
15216,92,HAUTS-DE-SEINE,62364,51127,1473,49654,2002,t2,presidential
15217,92,HAUTS-DE-SEINE,52692,43153,953,42200,2002,t2,presidential
15218,92,HAUTS-DE-SEINE,56298,46641,1556,45085,2002,t2,presidential
15219,92,HAUTS-DE-SEINE,59143,46178,1769,44409,2002,t2,presidential
15220,92,HAUTS-DE-SEINE,77857,62493,2183,60310,2002,t2,presidential
15221,92,HAUTS-DE-SEINE,77996,65938,2170,63768,2002,t2,presidential
15222,93,SEINE-SAINT-DENIS,42494,31409,1189,30220,2002,t2,presidential
15223,93,SEINE-SAINT-DENIS,44274,32443,1282,31161,2002,t2,presidential
15224,93,SEINE-SAINT-DENIS,40075,29896,1132,28764,2002,t2,presidential
15225,93,SEINE-SAINT-DENIS,41418,30180,1284,28896,2002,t2,presidential
15226,93,SEINE-SAINT-DENIS,47604,35339,1509,33830,2002,t2,presidential
15227,93,SEINE-SAINT-DENIS,52658,41012,1599,39413,2002,t2,presidential
15228,93,SEINE-SAINT-DENIS,43876,32708,1292,31416,2002,t2,presidential
15229,93,SEINE-SAINT-DENIS,55648,43876,1909,41967,2002,t2,presidential
15230,93,SEINE-SAINT-DENIS,48366,37522,1675,35847,2002,t2,presidential
15231,93,SEINE-SAINT-DENIS,47129,36400,1445,34955,2002,t2,presidential
15232,93,SEINE-SAINT-DENIS,51305,39863,1794,38069,2002,t2,presidential
15233,93,SEINE-SAINT-DENIS,55820,44118,1815,42303,2002,t2,presidential
15234,93,SEINE-SAINT-DENIS,60190,48303,1955,46348,2002,t2,presidential
15235,94,VAL-DE-MARNE,50183,41707,1416,40291,2002,t2,presidential
15236,94,VAL-DE-MARNE,57860,45864,1764,44100,2002,t2,presidential
15237,94,VAL-DE-MARNE,62476,49841,2160,47681,2002,t2,presidential
15238,94,VAL-DE-MARNE,63871,52157,1971,50186,2002,t2,presidential
15239,94,VAL-DE-MARNE,56651,44393,1642,42751,2002,t2,presidential
15240,94,VAL-DE-MARNE,68809,55311,1760,53551,2002,t2,presidential
15241,94,VAL-DE-MARNE,52680,42917,1397,41520,2002,t2,presidential
15242,94,VAL-DE-MARNE,54376,44361,1584,42777,2002,t2,presidential
15243,94,VAL-DE-MARNE,46316,35558,1439,34119,2002,t2,presidential
15244,94,VAL-DE-MARNE,53793,41815,1675,40140,2002,t2,presidential
15245,94,VAL-DE-MARNE,51187,39665,1617,38048,2002,t2,presidential
15246,94,VAL-DE-MARNE,58870,46567,1724,44843,2002,t2,presidential
15247,95,VAL-D'OISE,69682,57405,2700,54705,2002,t2,presidential
15248,95,VAL-D'OISE,98209,80458,3346,77112,2002,t2,presidential
15249,95,VAL-D'OISE,75574,60411,2629,57782,2002,t2,presidential
15250,95,VAL-D'OISE,68572,53900,2304,51596,2002,t2,presidential
15251,95,VAL-D'OISE,55459,42571,1933,40638,2002,t2,presidential
15252,95,VAL-D'OISE,63276,50566,1855,48711,2002,t2,presidential
15253,95,VAL-D'OISE,72742,59141,2253,56888,2002,t2,presidential
15254,95,VAL-D'OISE,42902,32906,1245,31661,2002,t2,presidential
15255,95,VAL-D'OISE,57785,45921,2119,43802,2002,t2,presidential
15256,971,GUADELOUPE,61403,22086,1778,20308,2002,t2,presidential
15257,971,GUADELOUPE,80215,28914,1985,26929,2002,t2,presidential
15258,971,GUADELOUPE,73314,29382,2207,27175,2002,t2,presidential
15259,971,GUADELOUPE,66610,29055,1540,27515,2002,t2,presidential
15260,972,MARTINIQUE,57277,27432,1618,25814,2002,t2,presidential
15261,972,MARTINIQUE,58878,27271,1657,25614,2002,t2,presidential
15262,972,MARTINIQUE,55671,25349,1673,23676,2002,t2,presidential
15263,972,MARTINIQUE,94703,40321,2510,37811,2002,t2,presidential
15264,973,GUYANE,19558,8282,462,7820,2002,t2,presidential
15265,973,GUYANE,32232,15057,735,14322,2002,t2,presidential
15266,974,LA REUNION,71249,49896,2009,47887,2002,t2,presidential
15267,974,LA REUNION,91719,66884,2577,64307,2002,t2,presidential
15268,974,LA REUNION,106603,81562,3943,77619,2002,t2,presidential
15269,974,LA REUNION,80170,57511,2823,54688,2002,t2,presidential
15270,974,LA REUNION,86965,60678,2675,58003,2002,t2,presidential
15271,975,SAINT-PIERRE-ET-MIQUELON,4813,3324,125,3199,2002,t2,presidential
15272,985,MAYOTTE,52189,21386,1171,20215,2002,t2,presidential
15273,986,WALLIS ET FUTUNA,9348,6350,81,6269,2002,t2,presidential
15274,987,POLYNESIE FRANCAISE,149782,83095,2885,80210,2002,t2,presidential
15275,988,NOUVELLE-CALEDONIE,126969,64204,2263,61941,2002,t2,presidential
15276,1,AIN,79024,65819,4142,61677,2012,t2,presidential
15277,1,AIN,86845,73070,4075,68995,2012,t2,presidential
15278,1,AIN,69858,56868,3145,53723,2012,t2,presidential
15279,1,AIN,84501,70893,4253,66640,2012,t2,presidential
15280,1,AIN,73638,59937,3898,56039,2012,t2,presidential
15281,2,AISNE,72627,58568,3893,54675,2012,t2,presidential
15282,2,AISNE,73203,59401,3964,55437,2012,t2,presidential
15283,2,AISNE,70334,56747,4048,52699,2012,t2,presidential
15284,2,AISNE,78930,61692,4174,57518,2012,t2,presidential
15285,2,AISNE,80979,65668,4977,60691,2012,t2,presidential
15286,3,ALLIER,90368,75013,5129,69884,2012,t2,presidential
15287,3,ALLIER,86773,70671,5051,65620,2012,t2,presidential
15288,3,ALLIER,79070,65448,4744,60704,2012,t2,presidential
15289,4,ALPES-DE-HAUTE-PROVENCE,60587,50916,3477,47439,2012,t2,presidential
15290,4,ALPES-DE-HAUTE-PROVENCE,63308,52665,3162,49503,2012,t2,presidential
15291,5,HAUTES-ALPES,56096,46868,3258,43610,2012,t2,presidential
15292,5,HAUTES-ALPES,50779,42537,2767,39770,2012,t2,presidential
15293,6,ALPES-MARITIMES,82281,64260,3067,61193,2012,t2,presidential
15294,6,ALPES-MARITIMES,82291,67186,3802,63384,2012,t2,presidential
15295,6,ALPES-MARITIMES,87345,69339,3539,65800,2012,t2,presidential
15296,6,ALPES-MARITIMES,84818,67991,3728,64263,2012,t2,presidential
15297,6,ALPES-MARITIMES,85309,69361,3601,65760,2012,t2,presidential
15298,6,ALPES-MARITIMES,76080,61226,3187,58039,2012,t2,presidential
15299,6,ALPES-MARITIMES,89528,73206,3415,69791,2012,t2,presidential
15300,6,ALPES-MARITIMES,80643,64382,2875,61507,2012,t2,presidential
15301,6,ALPES-MARITIMES,77198,62288,2853,59435,2012,t2,presidential
15302,7,ARDECHE,76605,63540,4533,59007,2012,t2,presidential
15303,7,ARDECHE,90753,76481,5219,71262,2012,t2,presidential
15304,7,ARDECHE,75993,63909,4223,59686,2012,t2,presidential
15305,8,ARDENNES,73133,58614,4026,54588,2012,t2,presidential
15306,8,ARDENNES,64916,50376,3180,47196,2012,t2,presidential
15307,8,ARDENNES,58554,47071,3102,43969,2012,t2,presidential
15308,9,ARIEGE,56626,47889,3020,44869,2012,t2,presidential
15309,9,ARIEGE,59731,50444,3395,47049,2012,t2,presidential
15310,10,AUBE,64632,52943,3893,49050,2012,t2,presidential
15311,10,AUBE,72858,59774,3943,55831,2012,t2,presidential
15312,10,AUBE,66095,52458,3577,48881,2012,t2,presidential
15313,11,AUDE,92766,78042,5444,72598,2012,t2,presidential
15314,11,AUDE,83594,68385,4880,63505,2012,t2,presidential
15315,11,AUDE,87638,74271,5223,69048,2012,t2,presidential
15316,12,AVEYRON,75552,65006,3915,61091,2012,t2,presidential
15317,12,AVEYRON,70767,60355,3805,56550,2012,t2,presidential
15318,12,AVEYRON,71970,61819,4352,57467,2012,t2,presidential
15319,13,BOUCHES-DU-RHONE,73789,59895,3182,56713,2012,t2,presidential
15320,13,BOUCHES-DU-RHONE,77339,63700,2499,61201,2012,t2,presidential
15321,13,BOUCHES-DU-RHONE,70248,55257,2893,52364,2012,t2,presidential
15322,13,BOUCHES-DU-RHONE,58646,44470,1639,42831,2012,t2,presidential
15323,13,BOUCHES-DU-RHONE,68657,54808,2493,52315,2012,t2,presidential
15324,13,BOUCHES-DU-RHONE,72477,58336,2886,55450,2012,t2,presidential
15325,13,BOUCHES-DU-RHONE,62965,46509,2116,44393,2012,t2,presidential
15326,13,BOUCHES-DU-RHONE,92872,76097,4665,71432,2012,t2,presidential
15327,13,BOUCHES-DU-RHONE,92577,76008,4201,71807,2012,t2,presidential
15328,13,BOUCHES-DU-RHONE,100122,83371,4818,78553,2012,t2,presidential
15329,13,BOUCHES-DU-RHONE,85249,68777,3368,65409,2012,t2,presidential
15330,13,BOUCHES-DU-RHONE,88788,72043,4472,67571,2012,t2,presidential
15331,13,BOUCHES-DU-RHONE,90480,73634,4952,68682,2012,t2,presidential
15332,13,BOUCHES-DU-RHONE,93842,77277,3684,73593,2012,t2,presidential
15333,13,BOUCHES-DU-RHONE,98178,81854,4970,76884,2012,t2,presidential
15334,13,BOUCHES-DU-RHONE,88526,71941,4783,67158,2012,t2,presidential
15335,14,CALVADOS,70213,58558,2829,55729,2012,t2,presidential
15336,14,CALVADOS,67015,55191,2870,52321,2012,t2,presidential
15337,14,CALVADOS,78403,64346,3938,60408,2012,t2,presidential
15338,14,CALVADOS,97736,81113,4124,76989,2012,t2,presidential
15339,14,CALVADOS,86339,72756,3897,68859,2012,t2,presidential
15340,14,CALVADOS,90974,77519,4877,72642,2012,t2,presidential
15341,15,CANTAL,64461,54535,3289,51246,2012,t2,presidential
15342,15,CANTAL,56470,47318,2924,44394,2012,t2,presidential
15343,16,CHARENTE,84013,67572,4013,63559,2012,t2,presidential
15344,16,CHARENTE,84808,69679,4566,65113,2012,t2,presidential
15345,16,CHARENTE,91907,77346,5270,72076,2012,t2,presidential
15346,17,CHARENTE-MARITIME,98830,81136,3844,77292,2012,t2,presidential
15347,17,CHARENTE-MARITIME,97505,80434,4734,75700,2012,t2,presidential
15348,17,CHARENTE-MARITIME,81936,66746,4262,62484,2012,t2,presidential
15349,17,CHARENTE-MARITIME,87771,72529,4981,67548,2012,t2,presidential
15350,17,CHARENTE-MARITIME,105982,87863,5556,82307,2012,t2,presidential
15351,18,CHER,73758,59092,4071,55021,2012,t2,presidential
15352,18,CHER,70156,55447,3978,51469,2012,t2,presidential
15353,18,CHER,87101,70691,5365,65326,2012,t2,presidential
15354,19,CORREZE,94668,82893,4561,78332,2012,t2,presidential
15355,19,CORREZE,91953,78259,4325,73934,2012,t2,presidential
15356,2A,CORSE-DU-SUD,47907,36145,2049,34096,2012,t2,presidential
15357,2A,CORSE-DU-SUD,53767,40854,2324,38530,2012,t2,presidential
15358,2B,HAUTE-CORSE,54660,42534,2370,40164,2012,t2,presidential
15359,2B,HAUTE-CORSE,63981,48636,2478,46158,2012,t2,presidential
15360,21,COTE-D'OR,67615,57155,2671,54484,2012,t2,presidential
15361,21,COTE-D'OR,66120,54935,3173,51762,2012,t2,presidential
15362,21,COTE-D'OR,69112,57013,3377,53636,2012,t2,presidential
15363,21,COTE-D'OR,69032,57816,3862,53954,2012,t2,presidential
15364,21,COTE-D'OR,82926,69026,4369,64657,2012,t2,presidential
15365,22,COTES-D'ARMOR,89051,75041,4035,71006,2012,t2,presidential
15366,22,COTES-D'ARMOR,93736,81416,4393,77023,2012,t2,presidential
15367,22,COTES-D'ARMOR,86313,75371,4293,71078,2012,t2,presidential
15368,22,COTES-D'ARMOR,79581,68822,3793,65029,2012,t2,presidential
15369,22,COTES-D'ARMOR,102333,87824,4321,83503,2012,t2,presidential
15370,23,CREUSE,96857,80716,5540,75176,2012,t2,presidential
15371,24,DORDOGNE,74944,63829,4010,59819,2012,t2,presidential
15372,24,DORDOGNE,81096,68434,4891,63543,2012,t2,presidential
15373,24,DORDOGNE,69042,60014,4050,55964,2012,t2,presidential
15374,24,DORDOGNE,86701,75578,4613,70965,2012,t2,presidential
15375,25,DOUBS,72906,60127,3482,56645,2012,t2,presidential
15376,25,DOUBS,76233,63717,3607,60110,2012,t2,presidential
15377,25,DOUBS,65433,54220,3985,50235,2012,t2,presidential
15378,25,DOUBS,67346,54838,4301,50537,2012,t2,presidential
15379,25,DOUBS,77266,66154,3827,62327,2012,t2,presidential
15380,26,DROME,72823,59366,3254,56112,2012,t2,presidential
15381,26,DROME,87743,72006,4890,67116,2012,t2,presidential
15382,26,DROME,102570,87334,5595,81739,2012,t2,presidential
15383,26,DROME,89978,74278,4850,69428,2012,t2,presidential
15384,27,EURE,85314,68389,4286,64103,2012,t2,presidential
15385,27,EURE,76963,63543,4243,59300,2012,t2,presidential
15386,27,EURE,81678,67561,4306,63255,2012,t2,presidential
15387,27,EURE,86662,70108,4542,65566,2012,t2,presidential
15388,27,EURE,87188,70671,4619,66052,2012,t2,presidential
15389,28,EURE-ET-LOIR,87335,71445,4068,67377,2012,t2,presidential
15390,28,EURE-ET-LOIR,71954,57193,3306,53887,2012,t2,presidential
15391,28,EURE-ET-LOIR,71238,57719,3681,54038,2012,t2,presidential
15392,28,EURE-ET-LOIR,67235,55654,3828,51826,2012,t2,presidential
15393,29,FINISTERE,85821,74066,3757,70309,2012,t2,presidential
15394,29,FINISTERE,77981,62372,3020,59352,2012,t2,presidential
15395,29,FINISTERE,86191,73332,3630,69702,2012,t2,presidential
15396,29,FINISTERE,82111,70255,3254,67001,2012,t2,presidential
15397,29,FINISTERE,91053,78201,3778,74423,2012,t2,presidential
15398,29,FINISTERE,89302,76182,3985,72197,2012,t2,presidential
15399,29,FINISTERE,79740,67453,3721,63732,2012,t2,presidential
15400,29,FINISTERE,84304,70765,4210,66555,2012,t2,presidential
15401,30,GARD,83308,67281,3935,63346,2012,t2,presidential
15402,30,GARD,82313,69031,4640,64391,2012,t2,presidential
15403,30,GARD,88777,74216,5001,69215,2012,t2,presidential
15404,30,GARD,87655,73083,5503,67580,2012,t2,presidential
15405,30,GARD,93381,78085,5420,72665,2012,t2,presidential
15406,30,GARD,77573,63115,3830,59285,2012,t2,presidential
15407,31,HAUTE-GARONNE,76411,60904,2816,58088,2012,t2,presidential
15408,31,HAUTE-GARONNE,94400,76911,3922,72989,2012,t2,presidential
15409,31,HAUTE-GARONNE,73090,60368,2693,57675,2012,t2,presidential
15410,31,HAUTE-GARONNE,66118,50903,2153,48750,2012,t2,presidential
15411,31,HAUTE-GARONNE,90241,76784,4831,71953,2012,t2,presidential
15412,31,HAUTE-GARONNE,103085,87065,4988,82077,2012,t2,presidential
15413,31,HAUTE-GARONNE,92460,78243,4990,73253,2012,t2,presidential
15414,31,HAUTE-GARONNE,84928,70872,4990,65882,2012,t2,presidential
15415,31,HAUTE-GARONNE,76394,60798,3071,57727,2012,t2,presidential
15416,31,HAUTE-GARONNE,88317,77468,4401,73067,2012,t2,presidential
15417,32,GERS,73631,63408,4118,59290,2012,t2,presidential
15418,32,GERS,70144,60464,3926,56538,2012,t2,presidential
15419,33,GIRONDE,85985,70597,3195,67402,2012,t2,presidential
15420,33,GIRONDE,62199,49905,1965,47940,2012,t2,presidential
15421,33,GIRONDE,74202,60566,3068,57498,2012,t2,presidential
15422,33,GIRONDE,86608,69768,4065,65703,2012,t2,presidential
15423,33,GIRONDE,102425,85891,5467,80424,2012,t2,presidential
15424,33,GIRONDE,95142,80863,4326,76537,2012,t2,presidential
15425,33,GIRONDE,72630,61523,3172,58351,2012,t2,presidential
15426,33,GIRONDE,97836,82284,4539,77745,2012,t2,presidential
15427,33,GIRONDE,85602,73600,4696,68904,2012,t2,presidential
15428,33,GIRONDE,78491,65794,4383,61411,2012,t2,presidential
15429,33,GIRONDE,88103,73003,5432,67571,2012,t2,presidential
15430,33,GIRONDE,78577,67345,4331,63014,2012,t2,presidential
15431,34,HERAULT,79066,64652,3709,60943,2012,t2,presidential
15432,34,HERAULT,58298,44991,1769,43222,2012,t2,presidential
15433,34,HERAULT,77209,65298,3593,61705,2012,t2,presidential
15434,34,HERAULT,103151,86646,5571,81075,2012,t2,presidential
15435,34,HERAULT,90857,75457,5205,70252,2012,t2,presidential
15436,34,HERAULT,86125,69835,4486,65349,2012,t2,presidential
15437,34,HERAULT,95953,79376,4905,74471,2012,t2,presidential
15438,34,HERAULT,80625,66301,4112,62189,2012,t2,presidential
15439,34,HERAULT,75525,62157,3701,58456,2012,t2,presidential
15440,35,ILLE-ET-VILAINE,87058,72106,3320,68786,2012,t2,presidential
15441,35,ILLE-ET-VILAINE,86864,74634,3353,71281,2012,t2,presidential
15442,35,ILLE-ET-VILAINE,81381,69994,3715,66279,2012,t2,presidential
15443,35,ILLE-ET-VILAINE,85025,72266,4156,68110,2012,t2,presidential
15444,35,ILLE-ET-VILAINE,97365,83181,4866,78315,2012,t2,presidential
15445,35,ILLE-ET-VILAINE,85283,72498,4336,68162,2012,t2,presidential
15446,35,ILLE-ET-VILAINE,95244,78266,4128,74138,2012,t2,presidential
15447,35,ILLE-ET-VILAINE,78874,65629,2668,62961,2012,t2,presidential
15448,36,INDRE,82219,66159,4560,61599,2012,t2,presidential
15449,36,INDRE,91553,76543,5883,70660,2012,t2,presidential
15450,37,INDRE-ET-LOIRE,65517,51630,2410,49220,2012,t2,presidential
15451,37,INDRE-ET-LOIRE,84336,71013,4408,66605,2012,t2,presidential
15452,37,INDRE-ET-LOIRE,94454,79279,4637,74642,2012,t2,presidential
15453,37,INDRE-ET-LOIRE,88201,73073,4361,68712,2012,t2,presidential
15454,37,INDRE-ET-LOIRE,80427,67344,3856,63488,2012,t2,presidential
15455,38,ISERE,80612,66545,2570,63975,2012,t2,presidential
15456,38,ISERE,75032,61440,3048,58392,2012,t2,presidential
15457,38,ISERE,59928,47505,2090,45415,2012,t2,presidential
15458,38,ISERE,87774,72695,3887,68808,2012,t2,presidential
15459,38,ISERE,97773,81708,4577,77131,2012,t2,presidential
15460,38,ISERE,77117,62384,3700,58684,2012,t2,presidential
15461,38,ISERE,87551,72428,4956,67472,2012,t2,presidential
15462,38,ISERE,74929,61737,3816,57921,2012,t2,presidential
15463,38,ISERE,93246,76988,4873,72115,2012,t2,presidential
15464,38,ISERE,87592,70333,4369,65964,2012,t2,presidential
15465,39,JURA,65029,54095,3873,50222,2012,t2,presidential
15466,39,JURA,54923,45916,3235,42681,2012,t2,presidential
15467,39,JURA,68264,57451,4029,53422,2012,t2,presidential
15468,40,LANDES,97620,81285,5090,76195,2012,t2,presidential
15469,40,LANDES,104572,88495,4902,83593,2012,t2,presidential
15470,40,LANDES,94527,81999,5123,76876,2012,t2,presidential
15471,41,LOIR-ET-CHER,80456,65527,4057,61470,2012,t2,presidential
15472,41,LOIR-ET-CHER,80272,66206,4602,61604,2012,t2,presidential
15473,41,LOIR-ET-CHER,82391,69233,4850,64383,2012,t2,presidential
15474,42,LOIRE,67953,53891,2872,51019,2012,t2,presidential
15475,42,LOIRE,57313,44075,2258,41817,2012,t2,presidential
15476,42,LOIRE,80382,65625,4259,61366,2012,t2,presidential
15477,42,LOIRE,99050,81412,5817,75595,2012,t2,presidential
15478,42,LOIRE,101165,84558,5906,78652,2012,t2,presidential
15479,42,LOIRE,103869,86576,5882,80694,2012,t2,presidential
15480,43,HAUTE-LOIRE,95721,81062,6433,74629,2012,t2,presidential
15481,43,HAUTE-LOIRE,80307,67510,4948,62562,2012,t2,presidential
15482,44,LOIRE-ATLANTIQUE,72726,59794,2585,57209,2012,t2,presidential
15483,44,LOIRE-ATLANTIQUE,81582,66399,2626,63773,2012,t2,presidential
15484,44,LOIRE-ATLANTIQUE,89008,71714,3577,68137,2012,t2,presidential
15485,44,LOIRE-ATLANTIQUE,82729,69453,3311,66142,2012,t2,presidential
15486,44,LOIRE-ATLANTIQUE,105463,90091,4707,85384,2012,t2,presidential
15487,44,LOIRE-ATLANTIQUE,106786,90246,5397,84849,2012,t2,presidential
15488,44,LOIRE-ATLANTIQUE,102174,86245,4592,81653,2012,t2,presidential
15489,44,LOIRE-ATLANTIQUE,81006,66414,3716,62698,2012,t2,presidential
15490,44,LOIRE-ATLANTIQUE,107593,91982,5221,86761,2012,t2,presidential
15491,44,LOIRE-ATLANTIQUE,106553,92885,5114,87771,2012,t2,presidential
15492,45,LOIRET,73176,60973,3347,57626,2012,t2,presidential
15493,45,LOIRET,81907,66899,3969,62930,2012,t2,presidential
15494,45,LOIRET,71061,58917,4131,54786,2012,t2,presidential
15495,45,LOIRET,74996,59872,4203,55669,2012,t2,presidential
15496,45,LOIRET,72668,59255,4144,55111,2012,t2,presidential
15497,45,LOIRET,69162,57192,3354,53838,2012,t2,presidential
15498,46,LOT,70165,60549,3723,56826,2012,t2,presidential
15499,46,LOT,65046,56571,3554,53017,2012,t2,presidential
15500,47,LOT-ET-GARONNE,86656,73099,5042,68057,2012,t2,presidential
15501,47,LOT-ET-GARONNE,77676,65111,4829,60282,2012,t2,presidential
15502,47,LOT-ET-GARONNE,76366,64435,4345,60090,2012,t2,presidential
15503,48,LOZERE,59885,51507,3480,48027,2012,t2,presidential
15504,49,MAINE-ET-LOIRE,80852,67046,3532,63514,2012,t2,presidential
15505,49,MAINE-ET-LOIRE,87418,73413,4049,69364,2012,t2,presidential
15506,49,MAINE-ET-LOIRE,68443,57461,3608,53853,2012,t2,presidential
15507,49,MAINE-ET-LOIRE,73503,61425,3815,57610,2012,t2,presidential
15508,49,MAINE-ET-LOIRE,75267,62840,3712,59128,2012,t2,presidential
15509,49,MAINE-ET-LOIRE,92466,78826,5076,73750,2012,t2,presidential
15510,49,MAINE-ET-LOIRE,75242,63507,3471,60036,2012,t2,presidential
15511,50,MANCHE,86638,72338,4309,68029,2012,t2,presidential
15512,50,MANCHE,94633,79797,4824,74973,2012,t2,presidential
15513,50,MANCHE,105830,88802,5315,83487,2012,t2,presidential
15514,50,MANCHE,88675,71960,3852,68108,2012,t2,presidential
15515,51,MARNE,69216,53193,2996,50197,2012,t2,presidential
15516,51,MARNE,72577,56849,3071,53778,2012,t2,presidential
15517,51,MARNE,81305,64052,4294,59758,2012,t2,presidential
15518,51,MARNE,80847,63265,4040,59225,2012,t2,presidential
15519,51,MARNE,78188,63966,4608,59358,2012,t2,presidential
15520,52,HAUTE-MARNE,74479,60511,4294,56217,2012,t2,presidential
15521,52,HAUTE-MARNE,64302,50839,4006,46833,2012,t2,presidential
15522,53,MAYENNE,72580,60480,3748,56732,2012,t2,presidential
15523,53,MAYENNE,76644,64651,3826,60825,2012,t2,presidential
15524,53,MAYENNE,72270,60932,3920,57012,2012,t2,presidential
15525,54,MEURTHE-ET-MOSELLE,80616,63544,3225,60319,2012,t2,presidential
15526,54,MEURTHE-ET-MOSELLE,70864,56424,2833,53591,2012,t2,presidential
15527,54,MEURTHE-ET-MOSELLE,82993,64188,3808,60380,2012,t2,presidential
15528,54,MEURTHE-ET-MOSELLE,97160,78445,5632,72813,2012,t2,presidential
15529,54,MEURTHE-ET-MOSELLE,76585,63063,4393,58670,2012,t2,presidential
15530,54,MEURTHE-ET-MOSELLE,87234,69341,4557,64784,2012,t2,presidential
15531,55,MEUSE,78875,65136,5169,59967,2012,t2,presidential
15532,55,MEUSE,61238,49153,3362,45791,2012,t2,presidential
15533,56,MORBIHAN,98724,84170,4161,80009,2012,t2,presidential
15534,56,MORBIHAN,98534,83665,4790,78875,2012,t2,presidential
15535,56,MORBIHAN,86756,74415,4842,69573,2012,t2,presidential
15536,56,MORBIHAN,102128,87479,5073,82406,2012,t2,presidential
15537,56,MORBIHAN,80376,64889,3481,61408,2012,t2,presidential
15538,56,MORBIHAN,89137,75618,4748,70870,2012,t2,presidential
15539,57,MOSELLE,88148,69156,4226,64930,2012,t2,presidential
15540,57,MOSELLE,76155,59962,3425,56537,2012,t2,presidential
15541,57,MOSELLE,74036,57697,3418,54279,2012,t2,presidential
15542,57,MOSELLE,81107,66219,4831,61388,2012,t2,presidential
15543,57,MOSELLE,74554,59105,4390,54715,2012,t2,presidential
15544,57,MOSELLE,72291,54230,3394,50836,2012,t2,presidential
15545,57,MOSELLE,91536,71567,5053,66514,2012,t2,presidential
15546,57,MOSELLE,90881,68260,4260,64000,2012,t2,presidential
15547,57,MOSELLE,97053,76274,4824,71450,2012,t2,presidential
15548,58,NIEVRE,78212,62515,4150,58365,2012,t2,presidential
15549,58,NIEVRE,86703,71310,4830,66480,2012,t2,presidential
15550,59,NORD,60435,44874,2154,42720,2012,t2,presidential
15551,59,NORD,87219,67622,3584,64038,2012,t2,presidential
15552,59,NORD,97160,73499,4863,68636,2012,t2,presidential
15553,59,NORD,97112,76064,3883,72181,2012,t2,presidential
15554,59,NORD,96417,77866,5143,72723,2012,t2,presidential
15555,59,NORD,84620,71312,4051,67261,2012,t2,presidential
15556,59,NORD,72079,55699,2930,52769,2012,t2,presidential
15557,59,NORD,68964,49154,2542,46612,2012,t2,presidential
15558,59,NORD,89185,68567,2953,65614,2012,t2,presidential
15559,59,NORD,80289,59460,3288,56172,2012,t2,presidential
15560,59,NORD,90349,69371,4062,65309,2012,t2,presidential
15561,59,NORD,93071,74271,5149,69122,2012,t2,presidential
15562,59,NORD,90508,70481,5443,65038,2012,t2,presidential
15563,59,NORD,98708,81248,5783,75465,2012,t2,presidential
15564,59,NORD,95158,77950,5134,72816,2012,t2,presidential
15565,59,NORD,83555,64831,4551,60280,2012,t2,presidential
15566,59,NORD,75013,58637,3884,54753,2012,t2,presidential
15567,59,NORD,91928,72091,4978,67113,2012,t2,presidential
15568,59,NORD,79014,60815,4566,56249,2012,t2,presidential
15569,59,NORD,80785,60033,4139,55894,2012,t2,presidential
15570,59,NORD,81041,62353,3963,58390,2012,t2,presidential
15571,60,OISE,80713,65642,4872,60770,2012,t2,presidential
15572,60,OISE,85960,70142,4860,65282,2012,t2,presidential
15573,60,OISE,71225,56777,3456,53321,2012,t2,presidential
15574,60,OISE,90210,73123,4128,68995,2012,t2,presidential
15575,60,OISE,71301,57019,3942,53077,2012,t2,presidential
15576,60,OISE,74658,59886,4150,55736,2012,t2,presidential
15577,60,OISE,75030,60424,4172,56252,2012,t2,presidential
15578,61,ORNE,71162,58807,3963,54844,2012,t2,presidential
15579,61,ORNE,68815,56867,3734,53133,2012,t2,presidential
15580,61,ORNE,72528,60771,4082,56689,2012,t2,presidential
15581,62,PAS-DE-CALAIS,103026,87314,6394,80920,2012,t2,presidential
15582,62,PAS-DE-CALAIS,84245,69572,4527,65045,2012,t2,presidential
15583,62,PAS-DE-CALAIS,87301,65043,5110,59933,2012,t2,presidential
15584,62,PAS-DE-CALAIS,87419,73030,4343,68687,2012,t2,presidential
15585,62,PAS-DE-CALAIS,89821,71238,4330,66908,2012,t2,presidential
15586,62,PAS-DE-CALAIS,88970,75907,5353,70554,2012,t2,presidential
15587,62,PAS-DE-CALAIS,92216,71040,4887,66153,2012,t2,presidential
15588,62,PAS-DE-CALAIS,93138,74991,5432,69559,2012,t2,presidential
15589,62,PAS-DE-CALAIS,79264,63747,4489,59258,2012,t2,presidential
15590,62,PAS-DE-CALAIS,89733,68185,5233,62952,2012,t2,presidential
15591,62,PAS-DE-CALAIS,94031,70671,5880,64791,2012,t2,presidential
15592,62,PAS-DE-CALAIS,94502,72316,5958,66358,2012,t2,presidential
15593,63,PUY-DE-DOME,80460,65499,3687,61812,2012,t2,presidential
15594,63,PUY-DE-DOME,86245,73261,5396,67865,2012,t2,presidential
15595,63,PUY-DE-DOME,86750,72835,4138,68697,2012,t2,presidential
15596,63,PUY-DE-DOME,95475,80644,5108,75536,2012,t2,presidential
15597,63,PUY-DE-DOME,100351,84089,6407,77682,2012,t2,presidential
15598,64,PYRENEES-ATLANTIQUES,68781,56502,3356,53146,2012,t2,presidential
15599,64,PYRENEES-ATLANTIQUES,77659,65853,4459,61394,2012,t2,presidential
15600,64,PYRENEES-ATLANTIQUES,81905,69817,4657,65160,2012,t2,presidential
15601,64,PYRENEES-ATLANTIQUES,80341,68569,4715,63854,2012,t2,presidential
15602,64,PYRENEES-ATLANTIQUES,85463,70259,3903,66356,2012,t2,presidential
15603,64,PYRENEES-ATLANTIQUES,94833,78114,4686,73428,2012,t2,presidential
15604,65,HAUTES-PYRENEES,88404,73365,4626,68739,2012,t2,presidential
15605,65,HAUTES-PYRENEES,89035,74919,4687,70232,2012,t2,presidential
15606,66,PYRENEES-ORIENTALES,67593,54515,3407,51108,2012,t2,presidential
15607,66,PYRENEES-ORIENTALES,89165,74064,5324,68740,2012,t2,presidential
15608,66,PYRENEES-ORIENTALES,80169,65537,4446,61091,2012,t2,presidential
15609,66,PYRENEES-ORIENTALES,92366,76563,5209,71354,2012,t2,presidential
15610,67,BAS-RHIN,63888,49449,1705,47744,2012,t2,presidential
15611,67,BAS-RHIN,71135,54114,2403,51711,2012,t2,presidential
15612,67,BAS-RHIN,68314,52812,2454,50358,2012,t2,presidential
15613,67,BAS-RHIN,89836,74169,3838,70331,2012,t2,presidential
15614,67,BAS-RHIN,98395,79988,5034,74954,2012,t2,presidential
15615,67,BAS-RHIN,91117,74405,4581,69824,2012,t2,presidential
15616,67,BAS-RHIN,84560,68987,4683,64304,2012,t2,presidential
15617,67,BAS-RHIN,92690,74491,5130,69361,2012,t2,presidential
15618,67,BAS-RHIN,88193,71313,3998,67315,2012,t2,presidential
15619,68,HAUT-RHIN,74587,58610,3620,54990,2012,t2,presidential
15620,68,HAUT-RHIN,91097,74346,5167,69179,2012,t2,presidential
15621,68,HAUT-RHIN,83493,68629,3904,64725,2012,t2,presidential
15622,68,HAUT-RHIN,99180,80738,5701,75037,2012,t2,presidential
15623,68,HAUT-RHIN,78793,60840,3638,57202,2012,t2,presidential
15624,68,HAUT-RHIN,92425,72774,4648,68126,2012,t2,presidential
15625,69,RHONE,68071,53205,2327,50878,2012,t2,presidential
15626,69,RHONE,74893,59461,2067,57394,2012,t2,presidential
15627,69,RHONE,70308,55259,2275,52984,2012,t2,presidential
15628,69,RHONE,79447,63419,2365,61054,2012,t2,presidential
15629,69,RHONE,80488,68124,2841,65283,2012,t2,presidential
15630,69,RHONE,78330,61815,2664,59151,2012,t2,presidential
15631,69,RHONE,64668,49689,2158,47531,2012,t2,presidential
15632,69,RHONE,98458,82479,4287,78192,2012,t2,presidential
15633,69,RHONE,85806,70964,3913,67051,2012,t2,presidential
15634,69,RHONE,89618,75567,3705,71862,2012,t2,presidential
15635,69,RHONE,85359,71516,3949,67567,2012,t2,presidential
15636,69,RHONE,76140,63168,2852,60316,2012,t2,presidential
15637,69,RHONE,79379,64959,3286,61673,2012,t2,presidential
15638,69,RHONE,70011,54213,2880,51333,2012,t2,presidential
15639,70,HAUTE-SAONE,88777,74906,5817,69089,2012,t2,presidential
15640,70,HAUTE-SAONE,91821,75934,6708,69226,2012,t2,presidential
15641,71,SAONE-ET-LOIRE,72491,58820,3512,55308,2012,t2,presidential
15642,71,SAONE-ET-LOIRE,81290,66842,4683,62159,2012,t2,presidential
15643,71,SAONE-ET-LOIRE,83706,68692,4951,63741,2012,t2,presidential
15644,71,SAONE-ET-LOIRE,81201,66636,5012,61624,2012,t2,presidential
15645,71,SAONE-ET-LOIRE,91158,72265,5103,67162,2012,t2,presidential
15646,72,SARTHE,72536,59279,3744,55535,2012,t2,presidential
15647,72,SARTHE,83329,66270,4594,61676,2012,t2,presidential
15648,72,SARTHE,84783,70104,5059,65045,2012,t2,presidential
15649,72,SARTHE,78833,64674,4402,60272,2012,t2,presidential
15650,72,SARTHE,87415,71861,4960,66901,2012,t2,presidential
15651,73,SAVOIE,82089,68048,4162,63886,2012,t2,presidential
15652,73,SAVOIE,74878,60519,3743,56776,2012,t2,presidential
15653,73,SAVOIE,70313,58632,4037,54595,2012,t2,presidential
15654,73,SAVOIE,71607,59109,3447,55662,2012,t2,presidential
15655,74,HAUTE-SAVOIE,93038,77787,4527,73260,2012,t2,presidential
15656,74,HAUTE-SAVOIE,90336,74425,4121,70304,2012,t2,presidential
15657,74,HAUTE-SAVOIE,75139,62518,3890,58628,2012,t2,presidential
15658,74,HAUTE-SAVOIE,80417,62902,3242,59660,2012,t2,presidential
15659,74,HAUTE-SAVOIE,89880,72165,3946,68219,2012,t2,presidential
15660,74,HAUTE-SAVOIE,75743,60756,3277,57479,2012,t2,presidential
15661,75,PARIS,76654,63988,1794,62194,2012,t2,presidential
15662,75,PARIS,71232,60505,1831,58674,2012,t2,presidential
15663,75,PARIS,65035,52989,1815,51174,2012,t2,presidential
15664,75,PARIS,67298,56997,1339,55658,2012,t2,presidential
15665,75,PARIS,70936,58893,1722,57171,2012,t2,presidential
15666,75,PARIS,73261,60786,1798,58988,2012,t2,presidential
15667,75,PARIS,72495,60518,1911,58607,2012,t2,presidential
15668,75,PARIS,80103,66513,2465,64048,2012,t2,presidential
15669,75,PARIS,66565,54993,2170,52823,2012,t2,presidential
15670,75,PARIS,66671,54780,2073,52707,2012,t2,presidential
15671,75,PARIS,69633,58855,1869,56986,2012,t2,presidential
15672,75,PARIS,71329,60266,1862,58404,2012,t2,presidential
15673,75,PARIS,72637,60620,2064,58556,2012,t2,presidential
15674,75,PARIS,69995,59387,1372,58015,2012,t2,presidential
15675,75,PARIS,73920,60413,2092,58321,2012,t2,presidential
15676,75,PARIS,66167,53666,1684,51982,2012,t2,presidential
15677,75,PARIS,54987,43507,1422,42085,2012,t2,presidential
15678,75,PARIS,65001,53373,1805,51568,2012,t2,presidential
15679,76,SEINE-MARITIME,64740,51833,2334,49499,2012,t2,presidential
15680,76,SEINE-MARITIME,91257,76407,4371,72036,2012,t2,presidential
15681,76,SEINE-MARITIME,69206,55400,3243,52157,2012,t2,presidential
15682,76,SEINE-MARITIME,88876,70949,4574,66375,2012,t2,presidential
15683,76,SEINE-MARITIME,94057,77184,4912,72272,2012,t2,presidential
15684,76,SEINE-MARITIME,110245,90267,5792,84475,2012,t2,presidential
15685,76,SEINE-MARITIME,89175,70503,4383,66120,2012,t2,presidential
15686,76,SEINE-MARITIME,70472,51765,3476,48289,2012,t2,presidential
15687,76,SEINE-MARITIME,92291,76643,4871,71772,2012,t2,presidential
15688,76,SEINE-MARITIME,105810,89679,5401,84278,2012,t2,presidential
15689,77,SEINE-ET-MARNE,67693,53907,2927,50980,2012,t2,presidential
15690,77,SEINE-ET-MARNE,78756,64022,3541,60481,2012,t2,presidential
15691,77,SEINE-ET-MARNE,72366,59442,3820,55622,2012,t2,presidential
15692,77,SEINE-ET-MARNE,85026,69090,4872,64218,2012,t2,presidential
15693,77,SEINE-ET-MARNE,78791,63649,3803,59846,2012,t2,presidential
15694,77,SEINE-ET-MARNE,73970,59707,3504,56203,2012,t2,presidential
15695,77,SEINE-ET-MARNE,81813,65966,3740,62226,2012,t2,presidential
15696,77,SEINE-ET-MARNE,82720,67065,3337,63728,2012,t2,presidential
15697,77,SEINE-ET-MARNE,81986,65602,3430,62172,2012,t2,presidential
15698,77,SEINE-ET-MARNE,78394,61799,3010,58789,2012,t2,presidential
15699,77,SEINE-ET-MARNE,62477,49490,3032,46458,2012,t2,presidential
15700,78,YVELINES,82054,67901,2704,65197,2012,t2,presidential
15701,78,YVELINES,83080,69856,3020,66836,2012,t2,presidential
15702,78,YVELINES,81416,68048,2349,65699,2012,t2,presidential
15703,78,YVELINES,76846,63718,2566,61152,2012,t2,presidential
15704,78,YVELINES,72077,58552,2370,56182,2012,t2,presidential
15705,78,YVELINES,74120,59332,2360,56972,2012,t2,presidential
15706,78,YVELINES,78236,64037,3097,60940,2012,t2,presidential
15707,78,YVELINES,71079,56131,2984,53147,2012,t2,presidential
15708,78,YVELINES,89203,73191,3875,69316,2012,t2,presidential
15709,78,YVELINES,86616,73652,3533,70119,2012,t2,presidential
15710,78,YVELINES,65606,52772,2365,50407,2012,t2,presidential
15711,78,YVELINES,66300,55215,2420,52795,2012,t2,presidential
15712,79,DEUX-SEVRES,88384,73486,4025,69461,2012,t2,presidential
15713,79,DEUX-SEVRES,97190,82578,5020,77558,2012,t2,presidential
15714,79,DEUX-SEVRES,85067,71805,4439,67366,2012,t2,presidential
15715,80,SOMME,85066,67674,4444,63230,2012,t2,presidential
15716,80,SOMME,74999,59833,3420,56413,2012,t2,presidential
15717,80,SOMME,84636,71710,5009,66701,2012,t2,presidential
15718,80,SOMME,82750,69603,5051,64552,2012,t2,presidential
15719,80,SOMME,81915,67357,4830,62527,2012,t2,presidential
15720,81,TARN,83056,70957,4932,66025,2012,t2,presidential
15721,81,TARN,102414,87118,5969,81149,2012,t2,presidential
15722,81,TARN,98400,84035,5965,78070,2012,t2,presidential
15723,82,TARN-ET-GARONNE,86100,72963,4667,68296,2012,t2,presidential
15724,82,TARN-ET-GARONNE,89237,75713,5116,70597,2012,t2,presidential
15725,83,VAR,73596,57895,3031,54864,2012,t2,presidential
15726,83,VAR,86859,70204,4173,66031,2012,t2,presidential
15727,83,VAR,97701,79995,4231,75764,2012,t2,presidential
15728,83,VAR,99220,81892,4252,77640,2012,t2,presidential
15729,83,VAR,91030,74390,3753,70637,2012,t2,presidential
15730,83,VAR,108011,89009,5428,83581,2012,t2,presidential
15731,83,VAR,101232,80872,4321,76551,2012,t2,presidential
15732,83,VAR,99661,81570,4788,76782,2012,t2,presidential
15733,84,VAUCLUSE,72367,57537,3123,54414,2012,t2,presidential
15734,84,VAUCLUSE,80339,66792,4137,62655,2012,t2,presidential
15735,84,VAUCLUSE,70877,58578,4061,54517,2012,t2,presidential
15736,84,VAUCLUSE,86026,71261,4781,66480,2012,t2,presidential
15737,84,VAUCLUSE,78449,64957,3984,60973,2012,t2,presidential
15738,85,VENDEE,102065,86485,5139,81346,2012,t2,presidential
15739,85,VENDEE,97821,83580,4801,78779,2012,t2,presidential
15740,85,VENDEE,113873,95553,5157,90396,2012,t2,presidential
15741,85,VENDEE,94436,81922,5303,76619,2012,t2,presidential
15742,85,VENDEE,80593,68129,4099,64030,2012,t2,presidential
15743,86,VIENNE,77165,64002,3719,60283,2012,t2,presidential
15744,86,VIENNE,75473,62874,3369,59505,2012,t2,presidential
15745,86,VIENNE,74860,63000,3914,59086,2012,t2,presidential
15746,86,VIENNE,76115,61265,4408,56857,2012,t2,presidential
15747,87,HAUTE-VIENNE,84653,71120,4743,66377,2012,t2,presidential
15748,87,HAUTE-VIENNE,96655,82629,5702,76927,2012,t2,presidential
15749,87,HAUTE-VIENNE,83551,70267,5009,65258,2012,t2,presidential
15750,88,VOSGES,76567,62275,4635,57640,2012,t2,presidential
15751,88,VOSGES,74258,60110,5315,54795,2012,t2,presidential
15752,88,VOSGES,66684,55074,4697,50377,2012,t2,presidential
15753,88,VOSGES,67898,56395,4432,51963,2012,t2,presidential
15754,89,YONNE,78376,64178,4165,60013,2012,t2,presidential
15755,89,YONNE,77731,63357,4585,58772,2012,t2,presidential
15756,89,YONNE,89134,70814,4867,65947,2012,t2,presidential
15757,90,TERRITOIRE DE BELFORT,47143,38335,2835,35500,2012,t2,presidential
15758,90,TERRITOIRE DE BELFORT,47715,38528,3039,35489,2012,t2,presidential
15759,91,ESSONNE,70321,54325,2688,51637,2012,t2,presidential
15760,91,ESSONNE,87168,71929,4301,67628,2012,t2,presidential
15761,91,ESSONNE,91976,76184,4314,71870,2012,t2,presidential
15762,91,ESSONNE,92032,77495,3847,73648,2012,t2,presidential
15763,91,ESSONNE,66570,56491,2343,54148,2012,t2,presidential
15764,91,ESSONNE,76078,62463,3009,59454,2012,t2,presidential
15765,91,ESSONNE,71630,57650,3023,54627,2012,t2,presidential
15766,91,ESSONNE,75241,60736,3524,57212,2012,t2,presidential
15767,91,ESSONNE,75958,62123,3259,58864,2012,t2,presidential
15768,91,ESSONNE,60594,48056,2622,45434,2012,t2,presidential
15769,92,HAUTS-DE-SEINE,59623,46317,2113,44204,2012,t2,presidential
15770,92,HAUTS-DE-SEINE,63523,52585,1993,50592,2012,t2,presidential
15771,92,HAUTS-DE-SEINE,76516,62646,2645,60001,2012,t2,presidential
15772,92,HAUTS-DE-SEINE,70809,57469,2552,54917,2012,t2,presidential
15773,92,HAUTS-DE-SEINE,68764,56472,2112,54360,2012,t2,presidential
15774,92,HAUTS-DE-SEINE,73415,62425,1970,60455,2012,t2,presidential
15775,92,HAUTS-DE-SEINE,83781,70745,2659,68086,2012,t2,presidential
15776,92,HAUTS-DE-SEINE,67007,56342,2155,54187,2012,t2,presidential
15777,92,HAUTS-DE-SEINE,61044,51167,1790,49377,2012,t2,presidential
15778,92,HAUTS-DE-SEINE,71670,58862,2515,56347,2012,t2,presidential
15779,92,HAUTS-DE-SEINE,67321,54573,2186,52387,2012,t2,presidential
15780,92,HAUTS-DE-SEINE,89831,74846,3257,71589,2012,t2,presidential
15781,92,HAUTS-DE-SEINE,85817,72621,3179,69442,2012,t2,presidential
15782,93,SEINE-SAINT-DENIS,55129,41111,1708,39403,2012,t2,presidential
15783,93,SEINE-SAINT-DENIS,51710,37669,1504,36165,2012,t2,presidential
15784,93,SEINE-SAINT-DENIS,70647,56641,2663,53978,2012,t2,presidential
15785,93,SEINE-SAINT-DENIS,60088,44516,2174,42342,2012,t2,presidential
15786,93,SEINE-SAINT-DENIS,62186,45747,2182,43565,2012,t2,presidential
15787,93,SEINE-SAINT-DENIS,49888,37448,1516,35932,2012,t2,presidential
15788,93,SEINE-SAINT-DENIS,71259,53945,2078,51867,2012,t2,presidential
15789,93,SEINE-SAINT-DENIS,60088,48096,2430,45666,2012,t2,presidential
15790,93,SEINE-SAINT-DENIS,66479,51802,2178,49624,2012,t2,presidential
15791,93,SEINE-SAINT-DENIS,66958,51749,2328,49421,2012,t2,presidential
15792,93,SEINE-SAINT-DENIS,62138,47156,2343,44813,2012,t2,presidential
15793,93,SEINE-SAINT-DENIS,64355,50504,2458,48046,2012,t2,presidential
15794,94,VAL-DE-MARNE,82579,68626,2957,65669,2012,t2,presidential
15795,94,VAL-DE-MARNE,64987,51903,2308,49595,2012,t2,presidential
15796,94,VAL-DE-MARNE,70708,56239,2907,53332,2012,t2,presidential
15797,94,VAL-DE-MARNE,71755,58879,2859,56020,2012,t2,presidential
15798,94,VAL-DE-MARNE,85988,68504,2842,65662,2012,t2,presidential
15799,94,VAL-DE-MARNE,77938,64120,2506,61614,2012,t2,presidential
15800,94,VAL-DE-MARNE,63743,51613,2382,49231,2012,t2,presidential
15801,94,VAL-DE-MARNE,73752,60344,2786,57558,2012,t2,presidential
15802,94,VAL-DE-MARNE,53295,41568,1836,39732,2012,t2,presidential
15803,94,VAL-DE-MARNE,63300,49462,2107,47355,2012,t2,presidential
15804,94,VAL-DE-MARNE,59920,46678,2199,44479,2012,t2,presidential
15805,95,VAL-D'OISE,78603,64957,3480,61477,2012,t2,presidential
15806,95,VAL-D'OISE,73370,60603,3072,57531,2012,t2,presidential
15807,95,VAL-D'OISE,87905,70863,3592,67271,2012,t2,presidential
15808,95,VAL-D'OISE,72547,58738,2907,55831,2012,t2,presidential
15809,95,VAL-D'OISE,68000,52009,2419,49590,2012,t2,presidential
15810,95,VAL-D'OISE,74570,59520,2648,56872,2012,t2,presidential
15811,95,VAL-D'OISE,67672,54850,2284,52566,2012,t2,presidential
15812,95,VAL-D'OISE,51984,39677,1621,38056,2012,t2,presidential
15813,95,VAL-D'OISE,67572,53065,2918,50147,2012,t2,presidential
15814,95,VAL-D'OISE,62727,50268,2548,47720,2012,t2,presidential
15815,971,GUADELOUPE,73099,44596,3442,41154,2012,t2,presidential
15816,971,GUADELOUPE,81278,49850,3439,46411,2012,t2,presidential
15817,971,GUADELOUPE,76821,47958,3204,44754,2012,t2,presidential
15818,971,GUADELOUPE,66971,42898,3209,39689,2012,t2,presidential
15819,972,MARTINIQUE,76352,47006,3713,43293,2012,t2,presidential
15820,972,MARTINIQUE,81657,50486,3581,46905,2012,t2,presidential
15821,972,MARTINIQUE,65769,36707,3023,33684,2012,t2,presidential
15822,972,MARTINIQUE,78934,46749,3275,43474,2012,t2,presidential
15823,973,GUYANE,46297,27184,1585,25599,2012,t2,presidential
15824,973,GUYANE,30792,16917,806,16111,2012,t2,presidential
15825,974,LA REUNION,73763,52494,2496,49998,2012,t2,presidential
15826,974,LA REUNION,83906,61061,3050,58011,2012,t2,presidential
15827,974,LA REUNION,83657,61683,3564,58119,2012,t2,presidential
15828,974,LA REUNION,94760,71172,3631,67541,2012,t2,presidential
15829,974,LA REUNION,75636,53071,2502,50569,2012,t2,presidential
15830,974,LA REUNION,67697,47969,2150,45819,2012,t2,presidential
15831,974,LA REUNION,98936,73944,3772,70172,2012,t2,presidential
15832,975,SAINT-PIERRE-ET-MIQUELON,4922,3391,206,3185,2012,t2,presidential
15833,979,SAINT-BARTHELEMY et SAINT-MARTIN,22686,9907,415,9492,2012,t2,presidential
15834,985,MAYOTTE,35579,17471,779,16692,2012,t2,presidential
15835,985,MAYOTTE,41965,22811,881,21930,2012,t2,presidential
15836,986,WALLIS ET FUTUNA,8942,6838,69,6769,2012,t2,presidential
15837,987,POLYNESIE FRANCAISE,67433,40299,8702,31597,2012,t2,presidential
15838,987,POLYNESIE FRANCAISE,59401,33268,922,32346,2012,t2,presidential
15839,987,POLYNESIE FRANCAISE,60104,36615,1000,35615,2012,t2,presidential
15840,988,NOUVELLE-CALEDONIE,76238,45181,1453,43728,2012,t2,presidential
15841,988,NOUVELLE-CALEDONIE,89100,55989,1706,54283,2012,t2,presidential
15842,99,FRANCAIS DE L'ETRANGER,157958,60849,1377,59472,2012,t2,presidential
15843,99,FRANCAIS DE L'ETRANGER,73812,23738,439,23299,2012,t2,presidential
15844,99,FRANCAIS DE L'ETRANGER,89534,32173,601,31572,2012,t2,presidential
15845,99,FRANCAIS DE L'ETRANGER,97710,50763,1116,49647,2012,t2,presidential
15846,99,FRANCAIS DE L'ETRANGER,80802,31640,715,30925,2012,t2,presidential
15847,99,FRANCAIS DE L'ETRANGER,107077,54310,1337,52973,2012,t2,presidential
15848,99,FRANCAIS DE L'ETRANGER,89769,37450,817,36633,2012,t2,presidential
15849,99,FRANCAIS DE L'ETRANGER,109896,31549,411,31138,2012,t2,presidential
15850,99,FRANCAIS DE L'ETRANGER,98811,43775,677,43098,2012,t2,presidential
15851,99,FRANCAIS DE L'ETRANGER,93085,48952,1122,47830,2012,t2,presidential
15852,99,FRANCAIS DE L'ETRANGER,80125,39711,1136,38575,2012,t2,presidential
15853,1,AIN,80486,58825,2137,56688,2002,t1,presidential
15854,1,AIN,82984,61231,1960,59271,2002,t1,presidential
15855,1,AIN,76759,55344,1747,53597,2002,t1,presidential
15856,1,AIN,97991,73817,2721,71096,2002,t1,presidential
15857,2,AISNE,69958,51878,1598,50280,2002,t1,presidential
15858,2,AISNE,72792,55406,1711,53695,2002,t1,presidential
15859,2,AISNE,72588,53015,2071,50944,2002,t1,presidential
15860,2,AISNE,76117,54427,1622,52805,2002,t1,presidential
15861,2,AISNE,75479,55925,1846,54079,2002,t1,presidential
15862,3,ALLIER,57776,42329,2220,40109,2002,t1,presidential
15863,3,ALLIER,65563,47479,2384,45095,2002,t1,presidential
15864,3,ALLIER,70086,52993,2596,50397,2002,t1,presidential
15865,3,ALLIER,62688,46246,2079,44167,2002,t1,presidential
15866,4,ALPES-DE-HAUTE-PROVENCE,53649,40262,1515,38747,2002,t1,presidential
15867,4,ALPES-DE-HAUTE-PROVENCE,55294,42133,1450,40683,2002,t1,presidential
15868,5,HAUTES-ALPES,52747,40229,1487,38742,2002,t1,presidential
15869,5,HAUTES-ALPES,42353,31820,1160,30660,2002,t1,presidential
15870,6,ALPES-MARITIMES,61060,38627,831,37796,2002,t1,presidential
15871,6,ALPES-MARITIMES,66542,41784,804,40980,2002,t1,presidential
15872,6,ALPES-MARITIMES,72088,45900,1003,44897,2002,t1,presidential
15873,6,ALPES-MARITIMES,69793,48248,1326,46922,2002,t1,presidential
15874,6,ALPES-MARITIMES,82946,57729,1485,56244,2002,t1,presidential
15875,6,ALPES-MARITIMES,94464,69870,1646,68224,2002,t1,presidential
15876,6,ALPES-MARITIMES,88792,63515,1489,62026,2002,t1,presidential
15877,6,ALPES-MARITIMES,60545,43676,817,42859,2002,t1,presidential
15878,6,ALPES-MARITIMES,94118,68725,1633,67092,2002,t1,presidential
15879,7,ARDECHE,68864,52417,1813,50604,2002,t1,presidential
15880,7,ARDECHE,82938,63437,2812,60625,2002,t1,presidential
15881,7,ARDECHE,68095,51823,1607,50216,2002,t1,presidential
15882,8,ARDENNES,70296,51037,1596,49441,2002,t1,presidential
15883,8,ARDENNES,64053,45190,1175,44015,2002,t1,presidential
15884,8,ARDENNES,58073,42381,1339,41042,2002,t1,presidential
15885,9,ARIEGE,53949,40688,1569,39119,2002,t1,presidential
15886,9,ARIEGE,55078,42185,1698,40487,2002,t1,presidential
15887,10,AUBE,55430,41128,1543,39585,2002,t1,presidential
15888,10,AUBE,68663,50771,1604,49167,2002,t1,presidential
15889,10,AUBE,69608,51025,1637,49388,2002,t1,presidential
15890,11,AUDE,65692,50492,1765,48727,2002,t1,presidential
15891,11,AUDE,99562,74052,2567,71485,2002,t1,presidential
15892,11,AUDE,71598,55448,2226,53222,2002,t1,presidential
15893,12,AVEYRON,72511,56968,2485,54483,2002,t1,presidential
15894,12,AVEYRON,71859,55406,2848,52558,2002,t1,presidential
15895,12,AVEYRON,70225,55497,2740,52757,2002,t1,presidential
15896,13,BOUCHES-DU-RHONE,54981,39470,970,38500,2002,t1,presidential
15897,13,BOUCHES-DU-RHONE,58102,43042,906,42136,2002,t1,presidential
15898,13,BOUCHES-DU-RHONE,42872,29727,655,29072,2002,t1,presidential
15899,13,BOUCHES-DU-RHONE,42755,28135,654,27481,2002,t1,presidential
15900,13,BOUCHES-DU-RHONE,47669,33854,811,33043,2002,t1,presidential
15901,13,BOUCHES-DU-RHONE,63256,45824,1109,44715,2002,t1,presidential
15902,13,BOUCHES-DU-RHONE,46567,31630,795,30835,2002,t1,presidential
15903,13,BOUCHES-DU-RHONE,64165,46277,1239,45038,2002,t1,presidential
15904,13,BOUCHES-DU-RHONE,83123,60808,1698,59110,2002,t1,presidential
15905,13,BOUCHES-DU-RHONE,111642,83099,2331,80768,2002,t1,presidential
15906,13,BOUCHES-DU-RHONE,87997,65980,1721,64259,2002,t1,presidential
15907,13,BOUCHES-DU-RHONE,99637,73296,1968,71328,2002,t1,presidential
15908,13,BOUCHES-DU-RHONE,83017,61099,1902,59197,2002,t1,presidential
15909,13,BOUCHES-DU-RHONE,90330,68159,1587,66572,2002,t1,presidential
15910,13,BOUCHES-DU-RHONE,89712,69253,2121,67132,2002,t1,presidential
15911,13,BOUCHES-DU-RHONE,79144,58495,1791,56704,2002,t1,presidential
15912,14,CALVADOS,69121,49620,1359,48261,2002,t1,presidential
15913,14,CALVADOS,64499,45903,1472,44431,2002,t1,presidential
15914,14,CALVADOS,71443,52025,1838,50187,2002,t1,presidential
15915,14,CALVADOS,75432,56135,1561,54574,2002,t1,presidential
15916,14,CALVADOS,94126,69552,2107,67445,2002,t1,presidential
15917,14,CALVADOS,83450,63255,2581,60674,2002,t1,presidential
15918,15,CANTAL,63999,48324,2208,46116,2002,t1,presidential
15919,15,CANTAL,59828,44238,1759,42479,2002,t1,presidential
15920,16,CHARENTE,62478,45105,1705,43400,2002,t1,presidential
15921,16,CHARENTE,60712,44287,1647,42640,2002,t1,presidential
15922,16,CHARENTE,69323,52534,2437,50097,2002,t1,presidential
15923,16,CHARENTE,62597,45862,1823,44039,2002,t1,presidential
15924,17,CHARENTE-MARITIME,87203,63510,1847,61663,2002,t1,presidential
15925,17,CHARENTE-MARITIME,83067,60442,2123,58319,2002,t1,presidential
15926,17,CHARENTE-MARITIME,76317,56533,2327,54206,2002,t1,presidential
15927,17,CHARENTE-MARITIME,81816,59317,2547,56770,2002,t1,presidential
15928,17,CHARENTE-MARITIME,89453,65400,2356,63044,2002,t1,presidential
15929,18,CHER,74038,54567,2024,52543,2002,t1,presidential
15930,18,CHER,68635,49164,1777,47387,2002,t1,presidential
15931,18,CHER,85447,63579,2651,60928,2002,t1,presidential
15932,19,CORREZE,65503,52965,2365,50600,2002,t1,presidential
15933,19,CORREZE,66201,51323,2121,49202,2002,t1,presidential
15934,19,CORREZE,52563,42457,1523,40934,2002,t1,presidential
15935,2A,CORSE-DU-SUD,41203,25132,568,24564,2002,t1,presidential
15936,2A,CORSE-DU-SUD,45323,26318,621,25697,2002,t1,presidential
15937,2B,HAUTE-CORSE,47662,28296,771,27525,2002,t1,presidential
15938,2B,HAUTE-CORSE,57112,32391,715,31676,2002,t1,presidential
15939,21,COTE-D'OR,63078,48938,1222,47716,2002,t1,presidential
15940,21,COTE-D'OR,58355,44424,1335,43089,2002,t1,presidential
15941,21,COTE-D'OR,63103,47017,1406,45611,2002,t1,presidential
15942,21,COTE-D'OR,68376,51456,1808,49648,2002,t1,presidential
15943,21,COTE-D'OR,77406,57613,2142,55471,2002,t1,presidential
15944,22,COTES-D'ARMOR,83571,62177,1960,60217,2002,t1,presidential
15945,22,COTES-D'ARMOR,85855,66652,2365,64287,2002,t1,presidential
15946,22,COTES-D'ARMOR,83167,64904,2543,62361,2002,t1,presidential
15947,22,COTES-D'ARMOR,79029,61006,1972,59034,2002,t1,presidential
15948,22,COTES-D'ARMOR,97234,73216,2003,71213,2002,t1,presidential
15949,23,CREUSE,51306,36945,1939,35006,2002,t1,presidential
15950,23,CREUSE,50506,36926,1790,35136,2002,t1,presidential
15951,24,DORDOGNE,72746,53988,2388,51600,2002,t1,presidential
15952,24,DORDOGNE,77272,57910,2292,55618,2002,t1,presidential
15953,24,DORDOGNE,71069,55706,3242,52464,2002,t1,presidential
15954,24,DORDOGNE,82904,64242,2861,61381,2002,t1,presidential
15955,25,DOUBS,65257,49569,1694,47875,2002,t1,presidential
15956,25,DOUBS,69619,53303,1870,51433,2002,t1,presidential
15957,25,DOUBS,64196,49161,1874,47287,2002,t1,presidential
15958,25,DOUBS,65407,49202,1672,47530,2002,t1,presidential
15959,25,DOUBS,70239,55140,2381,52759,2002,t1,presidential
15960,26,DROME,68023,48987,1528,47459,2002,t1,presidential
15961,26,DROME,74048,55323,1767,53556,2002,t1,presidential
15962,26,DROME,90111,69719,2438,67281,2002,t1,presidential
15963,26,DROME,77375,57125,1912,55213,2002,t1,presidential
15964,27,EURE,78277,57273,1810,55463,2002,t1,presidential
15965,27,EURE,70198,52776,1867,50909,2002,t1,presidential
15966,27,EURE,73293,55552,2085,53467,2002,t1,presidential
15967,27,EURE,77105,56811,1925,54886,2002,t1,presidential
15968,27,EURE,79537,58463,1848,56615,2002,t1,presidential
15969,28,EURE-ET-LOIR,78646,58832,1798,57034,2002,t1,presidential
15970,28,EURE-ET-LOIR,64741,46074,1441,44633,2002,t1,presidential
15971,28,EURE-ET-LOIR,69187,50550,1679,48871,2002,t1,presidential
15972,28,EURE-ET-LOIR,65549,49850,1855,47995,2002,t1,presidential
15973,29,FINISTERE,79058,60783,1720,59063,2002,t1,presidential
15974,29,FINISTERE,67774,48131,1073,47058,2002,t1,presidential
15975,29,FINISTERE,86443,64458,1655,62803,2002,t1,presidential
15976,29,FINISTERE,78517,59272,1737,57535,2002,t1,presidential
15977,29,FINISTERE,84284,64819,1796,63023,2002,t1,presidential
15978,29,FINISTERE,85544,65630,1815,63815,2002,t1,presidential
15979,29,FINISTERE,76520,56595,1730,54865,2002,t1,presidential
15980,29,FINISTERE,77611,56866,1928,54938,2002,t1,presidential
15981,30,GARD,76829,53157,1386,51771,2002,t1,presidential
15982,30,GARD,102007,75432,2124,73308,2002,t1,presidential
15983,30,GARD,102913,78829,2385,76444,2002,t1,presidential
15984,30,GARD,79606,59789,2206,57583,2002,t1,presidential
15985,30,GARD,84205,63877,2128,61749,2002,t1,presidential
15986,31,HAUTE-GARONNE,63317,44925,1091,43834,2002,t1,presidential
15987,31,HAUTE-GARONNE,99386,75763,2432,73331,2002,t1,presidential
15988,31,HAUTE-GARONNE,78572,61040,1849,59191,2002,t1,presidential
15989,31,HAUTE-GARONNE,49853,35313,946,34367,2002,t1,presidential
15990,31,HAUTE-GARONNE,119332,92199,3354,88845,2002,t1,presidential
15991,31,HAUTE-GARONNE,112518,86625,3532,83093,2002,t1,presidential
15992,31,HAUTE-GARONNE,107718,85499,3484,82015,2002,t1,presidential
15993,31,HAUTE-GARONNE,79109,58457,2586,55871,2002,t1,presidential
15994,32,GERS,70109,53873,2431,51442,2002,t1,presidential
15995,32,GERS,65314,50810,2153,48657,2002,t1,presidential
15996,33,GIRONDE,72325,50300,1179,49121,2002,t1,presidential
15997,33,GIRONDE,51592,34512,718,33794,2002,t1,presidential
15998,33,GIRONDE,64552,45203,1207,43996,2002,t1,presidential
15999,33,GIRONDE,76681,53701,1627,52074,2002,t1,presidential
16000,33,GIRONDE,85992,62405,1744,60661,2002,t1,presidential
16001,33,GIRONDE,79685,57899,1587,56312,2002,t1,presidential
16002,33,GIRONDE,90237,63995,1919,62076,2002,t1,presidential
16003,33,GIRONDE,105306,77140,2120,75020,2002,t1,presidential
16004,33,GIRONDE,90934,67594,2492,65102,2002,t1,presidential
16005,33,GIRONDE,74155,53878,1993,51885,2002,t1,presidential
16006,33,GIRONDE,75993,55132,1917,53215,2002,t1,presidential
16007,34,HERAULT,67078,48944,1475,47469,2002,t1,presidential
16008,34,HERAULT,57229,41526,1041,40485,2002,t1,presidential
16009,34,HERAULT,114134,86383,2389,83994,2002,t1,presidential
16010,34,HERAULT,118608,91229,2667,88562,2002,t1,presidential
16011,34,HERAULT,88280,66823,2273,64550,2002,t1,presidential
16012,34,HERAULT,79999,57574,1608,55966,2002,t1,presidential
16013,34,HERAULT,107131,77693,2465,75228,2002,t1,presidential
16014,35,ILLE-ET-VILAINE,71509,50135,1399,48736,2002,t1,presidential
16015,35,ILLE-ET-VILAINE,89610,66441,1996,64445,2002,t1,presidential
16016,35,ILLE-ET-VILAINE,83128,62015,1978,60037,2002,t1,presidential
16017,35,ILLE-ET-VILAINE,98627,74656,2557,72099,2002,t1,presidential
16018,35,ILLE-ET-VILAINE,108582,82528,3332,79196,2002,t1,presidential
16019,35,ILLE-ET-VILAINE,73954,55958,2388,53570,2002,t1,presidential
16020,35,ILLE-ET-VILAINE,92919,68332,2158,66174,2002,t1,presidential
16021,36,INDRE,55247,40540,1865,38675,2002,t1,presidential
16022,36,INDRE,64244,48356,2559,45797,2002,t1,presidential
16023,36,INDRE,57187,43812,2186,41626,2002,t1,presidential
16024,37,INDRE-ET-LOIRE,53448,36206,974,35232,2002,t1,presidential
16025,37,INDRE-ET-LOIRE,84893,63991,2250,61741,2002,t1,presidential
16026,37,INDRE-ET-LOIRE,87546,66325,2672,63653,2002,t1,presidential
16027,37,INDRE-ET-LOIRE,81887,60143,2279,57864,2002,t1,presidential
16028,37,INDRE-ET-LOIRE,73356,55021,1975,53046,2002,t1,presidential
16029,38,ISERE,74137,55381,1129,54252,2002,t1,presidential
16030,38,ISERE,65573,48628,1475,47153,2002,t1,presidential
16031,38,ISERE,53980,39338,1026,38312,2002,t1,presidential
16032,38,ISERE,77560,57931,1755,56176,2002,t1,presidential
16033,38,ISERE,82863,62033,1907,60126,2002,t1,presidential
16034,38,ISERE,92294,66555,2314,64241,2002,t1,presidential
16035,38,ISERE,88209,64878,2439,62439,2002,t1,presidential
16036,38,ISERE,93566,68453,2392,66061,2002,t1,presidential
16037,38,ISERE,80083,59453,2163,57290,2002,t1,presidential
16038,39,JURA,62561,47186,2011,45175,2002,t1,presidential
16039,39,JURA,53567,39888,1626,38262,2002,t1,presidential
16040,39,JURA,65219,50501,1884,48617,2002,t1,presidential
16041,40,LANDES,84114,62280,2331,59949,2002,t1,presidential
16042,40,LANDES,95595,70618,2526,68092,2002,t1,presidential
16043,40,LANDES,79227,61000,2705,58295,2002,t1,presidential
16044,41,LOIR-ET-CHER,86602,64060,2230,61830,2002,t1,presidential
16045,41,LOIR-ET-CHER,76762,57701,2224,55477,2002,t1,presidential
16046,41,LOIR-ET-CHER,69292,52862,2283,50579,2002,t1,presidential
16047,42,LOIRE,66150,46560,1273,45287,2002,t1,presidential
16048,42,LOIRE,50185,34170,792,33378,2002,t1,presidential
16049,42,LOIRE,74809,54768,1784,52984,2002,t1,presidential
16050,42,LOIRE,66877,48351,1589,46762,2002,t1,presidential
16051,42,LOIRE,68234,49324,2084,47240,2002,t1,presidential
16052,42,LOIRE,65385,49482,2275,47207,2002,t1,presidential
16053,42,LOIRE,92336,69674,2787,66887,2002,t1,presidential
16054,43,HAUTE-LOIRE,87549,67520,3118,64402,2002,t1,presidential
16055,43,HAUTE-LOIRE,78798,58960,2883,56077,2002,t1,presidential
16056,44,LOIRE-ATLANTIQUE,68651,48610,1223,47387,2002,t1,presidential
16057,44,LOIRE-ATLANTIQUE,75939,52339,1228,51111,2002,t1,presidential
16058,44,LOIRE-ATLANTIQUE,80839,57418,1782,55636,2002,t1,presidential
16059,44,LOIRE-ATLANTIQUE,73829,53794,1762,52032,2002,t1,presidential
16060,44,LOIRE-ATLANTIQUE,103867,79257,3077,76180,2002,t1,presidential
16061,44,LOIRE-ATLANTIQUE,70878,54365,2363,52002,2002,t1,presidential
16062,44,LOIRE-ATLANTIQUE,94368,71223,2242,68981,2002,t1,presidential
16063,44,LOIRE-ATLANTIQUE,71971,51580,1707,49873,2002,t1,presidential
16064,44,LOIRE-ATLANTIQUE,85937,65938,2405,63533,2002,t1,presidential
16065,44,LOIRE-ATLANTIQUE,88306,68499,3068,65431,2002,t1,presidential
16066,45,LOIRET,77344,58476,1800,56676,2002,t1,presidential
16067,45,LOIRET,77104,57301,1801,55500,2002,t1,presidential
16068,45,LOIRET,82986,62685,1975,60710,2002,t1,presidential
16069,45,LOIRET,88428,64900,2121,62779,2002,t1,presidential
16070,45,LOIRET,83447,63350,2199,61151,2002,t1,presidential
16071,46,LOT,65545,51022,2051,48971,2002,t1,presidential
16072,46,LOT,62632,48939,2409,46530,2002,t1,presidential
16073,47,LOT-ET-GARONNE,80041,60116,2135,57981,2002,t1,presidential
16074,47,LOT-ET-GARONNE,75483,56348,2340,54008,2002,t1,presidential
16075,47,LOT-ET-GARONNE,73498,54887,1930,52957,2002,t1,presidential
16076,48,LOZERE,31336,23873,889,22984,2002,t1,presidential
16077,48,LOZERE,27528,21644,755,20889,2002,t1,presidential
16078,49,MAINE-ET-LOIRE,75012,55262,2099,53163,2002,t1,presidential
16079,49,MAINE-ET-LOIRE,79786,60085,2568,57517,2002,t1,presidential
16080,49,MAINE-ET-LOIRE,64138,47257,2401,44856,2002,t1,presidential
16081,49,MAINE-ET-LOIRE,68497,51000,2388,48612,2002,t1,presidential
16082,49,MAINE-ET-LOIRE,70313,52600,2548,50052,2002,t1,presidential
16083,49,MAINE-ET-LOIRE,84256,64944,3779,61165,2002,t1,presidential
16084,49,MAINE-ET-LOIRE,68017,51805,2417,49388,2002,t1,presidential
16085,50,MANCHE,72157,53459,2038,51421,2002,t1,presidential
16086,50,MANCHE,75088,57237,2504,54733,2002,t1,presidential
16087,50,MANCHE,73371,53800,1810,51990,2002,t1,presidential
16088,50,MANCHE,69401,51752,1568,50184,2002,t1,presidential
16089,50,MANCHE,68948,49153,1551,47602,2002,t1,presidential
16090,51,MARNE,56111,37859,891,36968,2002,t1,presidential
16091,51,MARNE,64668,46106,1283,44823,2002,t1,presidential
16092,51,MARNE,62665,43965,1240,42725,2002,t1,presidential
16093,51,MARNE,59207,41289,1323,39966,2002,t1,presidential
16094,51,MARNE,62176,46429,1550,44879,2002,t1,presidential
16095,51,MARNE,67250,47332,1562,45770,2002,t1,presidential
16096,52,HAUTE-MARNE,76967,56431,2165,54266,2002,t1,presidential
16097,52,HAUTE-MARNE,66668,47273,1818,45455,2002,t1,presidential
16098,53,MAYENNE,78834,58477,2672,55805,2002,t1,presidential
16099,53,MAYENNE,64973,48354,2642,45712,2002,t1,presidential
16100,53,MAYENNE,70209,53266,2983,50283,2002,t1,presidential
16101,54,MEURTHE-ET-MOSELLE,48280,33546,790,32756,2002,t1,presidential
16102,54,MEURTHE-ET-MOSELLE,74595,54186,1498,52688,2002,t1,presidential
16103,54,MEURTHE-ET-MOSELLE,56365,39685,954,38731,2002,t1,presidential
16104,54,MEURTHE-ET-MOSELLE,74720,54078,1906,52172,2002,t1,presidential
16105,54,MEURTHE-ET-MOSELLE,70847,52953,1749,51204,2002,t1,presidential
16106,54,MEURTHE-ET-MOSELLE,75042,52948,1820,51128,2002,t1,presidential
16107,54,MEURTHE-ET-MOSELLE,69613,45815,1350,44465,2002,t1,presidential
16108,55,MEUSE,78523,58406,2173,56233,2002,t1,presidential
16109,55,MEUSE,60449,43345,1553,41792,2002,t1,presidential
16110,56,MORBIHAN,93082,71296,1968,69328,2002,t1,presidential
16111,56,MORBIHAN,83335,62639,2040,60599,2002,t1,presidential
16112,56,MORBIHAN,77267,59717,2357,57360,2002,t1,presidential
16113,56,MORBIHAN,82188,63408,2224,61184,2002,t1,presidential
16114,56,MORBIHAN,79736,54220,1781,52439,2002,t1,presidential
16115,56,MORBIHAN,83330,62646,2256,60390,2002,t1,presidential
16116,57,MOSELLE,70425,48465,1545,46920,2002,t1,presidential
16117,57,MOSELLE,71459,50369,1550,48819,2002,t1,presidential
16118,57,MOSELLE,69178,47594,1417,46177,2002,t1,presidential
16119,57,MOSELLE,67820,49800,2091,47709,2002,t1,presidential
16120,57,MOSELLE,73627,50467,2365,48102,2002,t1,presidential
16121,57,MOSELLE,72059,47033,1544,45489,2002,t1,presidential
16122,57,MOSELLE,76638,54106,1888,52218,2002,t1,presidential
16123,57,MOSELLE,71957,50611,1744,48867,2002,t1,presidential
16124,57,MOSELLE,70465,47550,1558,45992,2002,t1,presidential
16125,57,MOSELLE,68671,45123,1910,43213,2002,t1,presidential
16126,58,NIEVRE,55242,39118,1497,37621,2002,t1,presidential
16127,58,NIEVRE,59778,43760,1689,42071,2002,t1,presidential
16128,58,NIEVRE,55376,40257,1757,38500,2002,t1,presidential
16129,59,NORD,58052,35665,1004,34661,2002,t1,presidential
16130,59,NORD,70640,48908,1385,47523,2002,t1,presidential
16131,59,NORD,59664,39860,940,38920,2002,t1,presidential
16132,59,NORD,69461,49797,1403,48394,2002,t1,presidential
16133,59,NORD,83291,60534,2047,58487,2002,t1,presidential
16134,59,NORD,76773,59996,1934,58062,2002,t1,presidential
16135,59,NORD,68051,45350,1498,43852,2002,t1,presidential
16136,59,NORD,67665,42938,1299,41639,2002,t1,presidential
16137,59,NORD,64901,45757,1166,44591,2002,t1,presidential
16138,59,NORD,73981,49630,1570,48060,2002,t1,presidential
16139,59,NORD,84058,61102,1971,59131,2002,t1,presidential
16140,59,NORD,69506,49998,1683,48315,2002,t1,presidential
16141,59,NORD,64664,47096,1553,45543,2002,t1,presidential
16142,59,NORD,71307,56163,2604,53559,2002,t1,presidential
16143,59,NORD,71122,53588,2232,51356,2002,t1,presidential
16144,59,NORD,79672,57535,2071,55464,2002,t1,presidential
16145,59,NORD,72984,52243,1611,50632,2002,t1,presidential
16146,59,NORD,77499,57367,2106,55261,2002,t1,presidential
16147,59,NORD,77833,55332,1747,53585,2002,t1,presidential
16148,59,NORD,80035,55525,1754,53771,2002,t1,presidential
16149,59,NORD,74870,53050,1534,51516,2002,t1,presidential
16150,59,NORD,73979,55820,2062,53758,2002,t1,presidential
16151,59,NORD,66881,45831,1228,44603,2002,t1,presidential
16152,59,NORD,64378,45116,1613,43503,2002,t1,presidential
16153,60,OISE,74714,56119,1871,54248,2002,t1,presidential
16154,60,OISE,79550,59786,2056,57730,2002,t1,presidential
16155,60,OISE,64620,46276,1301,44975,2002,t1,presidential
16156,60,OISE,83104,60727,1465,59262,2002,t1,presidential
16157,60,OISE,65759,48419,1429,46990,2002,t1,presidential
16158,60,OISE,69356,51586,1452,50134,2002,t1,presidential
16159,60,OISE,69741,51006,1497,49509,2002,t1,presidential
16160,61,ORNE,71278,53105,1882,51223,2002,t1,presidential
16161,61,ORNE,69412,51505,1592,49913,2002,t1,presidential
16162,61,ORNE,73525,54767,1993,52774,2002,t1,presidential
16163,62,PAS-DE-CALAIS,77656,60860,2321,58539,2002,t1,presidential
16164,62,PAS-DE-CALAIS,73499,57730,2140,55590,2002,t1,presidential
16165,62,PAS-DE-CALAIS,72908,59519,2654,56865,2002,t1,presidential
16166,62,PAS-DE-CALAIS,76579,57137,1961,55176,2002,t1,presidential
16167,62,PAS-DE-CALAIS,62776,44317,1518,42799,2002,t1,presidential
16168,62,PAS-DE-CALAIS,70390,49434,2066,47368,2002,t1,presidential
16169,62,PAS-DE-CALAIS,80990,56564,2297,54267,2002,t1,presidential
16170,62,PAS-DE-CALAIS,67105,51186,2308,48878,2002,t1,presidential
16171,62,PAS-DE-CALAIS,79494,58588,2548,56040,2002,t1,presidential
16172,62,PAS-DE-CALAIS,71949,50245,2385,47860,2002,t1,presidential
16173,62,PAS-DE-CALAIS,91685,66952,2848,64104,2002,t1,presidential
16174,62,PAS-DE-CALAIS,77471,53498,2422,51076,2002,t1,presidential
16175,62,PAS-DE-CALAIS,71441,49337,2109,47228,2002,t1,presidential
16176,62,PAS-DE-CALAIS,73902,51172,1818,49354,2002,t1,presidential
16177,63,PUY-DE-DOME,58427,42120,1600,40520,2002,t1,presidential
16178,63,PUY-DE-DOME,72483,54268,2303,51965,2002,t1,presidential
16179,63,PUY-DE-DOME,71434,53612,2032,51580,2002,t1,presidential
16180,63,PUY-DE-DOME,73539,55532,2638,52894,2002,t1,presidential
16181,63,PUY-DE-DOME,64886,47445,2475,44970,2002,t1,presidential
16182,63,PUY-DE-DOME,84733,64573,3019,61554,2002,t1,presidential
16183,64,PYRENEES-ATLANTIQUES,64754,46489,1580,44909,2002,t1,presidential
16184,64,PYRENEES-ATLANTIQUES,69234,52623,1790,50833,2002,t1,presidential
16185,64,PYRENEES-ATLANTIQUES,76502,57563,2309,55254,2002,t1,presidential
16186,64,PYRENEES-ATLANTIQUES,78788,58102,2448,55654,2002,t1,presidential
16187,64,PYRENEES-ATLANTIQUES,76319,53786,1957,51829,2002,t1,presidential
16188,64,PYRENEES-ATLANTIQUES,84907,59052,2280,56772,2002,t1,presidential
16189,65,HAUTES-PYRENEES,59082,43724,2061,41663,2002,t1,presidential
16190,65,HAUTES-PYRENEES,59940,45502,1739,43763,2002,t1,presidential
16191,65,HAUTES-PYRENEES,50113,37757,1550,36207,2002,t1,presidential
16192,66,PYRENEES-ORIENTALES,58655,42006,1273,40733,2002,t1,presidential
16193,66,PYRENEES-ORIENTALES,85412,63060,1992,61068,2002,t1,presidential
16194,66,PYRENEES-ORIENTALES,61544,43704,1572,42132,2002,t1,presidential
16195,66,PYRENEES-ORIENTALES,80369,59627,2087,57540,2002,t1,presidential
16196,67,BAS-RHIN,48337,35329,665,34664,2002,t1,presidential
16197,67,BAS-RHIN,47875,33916,695,33221,2002,t1,presidential
16198,67,BAS-RHIN,60975,42778,1018,41760,2002,t1,presidential
16199,67,BAS-RHIN,106148,79433,2263,77170,2002,t1,presidential
16200,67,BAS-RHIN,92710,68950,2828,66122,2002,t1,presidential
16201,67,BAS-RHIN,75073,57031,2088,54943,2002,t1,presidential
16202,67,BAS-RHIN,78472,58647,2563,56084,2002,t1,presidential
16203,67,BAS-RHIN,67810,49991,2444,47547,2002,t1,presidential
16204,67,BAS-RHIN,97412,72675,2847,69828,2002,t1,presidential
16205,68,HAUT-RHIN,67857,49294,1645,47649,2002,t1,presidential
16206,68,HAUT-RHIN,71388,54551,2252,52299,2002,t1,presidential
16207,68,HAUT-RHIN,78214,60309,2485,57824,2002,t1,presidential
16208,68,HAUT-RHIN,68554,49783,1913,47870,2002,t1,presidential
16209,68,HAUT-RHIN,51186,35604,1046,34558,2002,t1,presidential
16210,68,HAUT-RHIN,70361,50162,1688,48474,2002,t1,presidential
16211,68,HAUT-RHIN,70885,53565,2051,51514,2002,t1,presidential
16212,69,RHONE,54267,40726,910,39816,2002,t1,presidential
16213,69,RHONE,62217,46763,967,45796,2002,t1,presidential
16214,69,RHONE,56742,42835,845,41990,2002,t1,presidential
16215,69,RHONE,63210,48804,925,47879,2002,t1,presidential
16216,69,RHONE,78550,59002,1321,57681,2002,t1,presidential
16217,69,RHONE,63627,44729,1119,43610,2002,t1,presidential
16218,69,RHONE,53169,37157,969,36188,2002,t1,presidential
16219,69,RHONE,76305,58048,1992,56056,2002,t1,presidential
16220,69,RHONE,72401,53103,1794,51309,2002,t1,presidential
16221,69,RHONE,81215,63048,1858,61190,2002,t1,presidential
16222,69,RHONE,73008,54996,1694,53302,2002,t1,presidential
16223,69,RHONE,68450,50870,1193,49677,2002,t1,presidential
16224,69,RHONE,82832,60469,1757,58712,2002,t1,presidential
16225,69,RHONE,46413,31280,866,30414,2002,t1,presidential
16226,70,HAUTE-SAONE,61895,47853,1853,46000,2002,t1,presidential
16227,70,HAUTE-SAONE,61116,46695,2086,44609,2002,t1,presidential
16228,70,HAUTE-SAONE,51497,38615,1862,36753,2002,t1,presidential
16229,71,SAONE-ET-LOIRE,62997,46118,1760,44358,2002,t1,presidential
16230,71,SAONE-ET-LOIRE,64453,47551,2366,45185,2002,t1,presidential
16231,71,SAONE-ET-LOIRE,67664,49479,2246,47233,2002,t1,presidential
16232,71,SAONE-ET-LOIRE,61193,43771,1882,41889,2002,t1,presidential
16233,71,SAONE-ET-LOIRE,62066,44717,1618,43099,2002,t1,presidential
16234,71,SAONE-ET-LOIRE,80445,59407,2849,56558,2002,t1,presidential
16235,72,SARTHE,67938,49407,2096,47311,2002,t1,presidential
16236,72,SARTHE,79213,55667,2598,53069,2002,t1,presidential
16237,72,SARTHE,80765,58879,3274,55605,2002,t1,presidential
16238,72,SARTHE,73657,53797,2638,51159,2002,t1,presidential
16239,72,SARTHE,83824,60726,2924,57802,2002,t1,presidential
16240,73,SAVOIE,97521,72306,2361,69945,2002,t1,presidential
16241,73,SAVOIE,78907,57273,2038,55235,2002,t1,presidential
16242,73,SAVOIE,88633,65434,2035,63399,2002,t1,presidential
16243,74,HAUTE-SAVOIE,91951,68797,2434,66363,2002,t1,presidential
16244,74,HAUTE-SAVOIE,77101,57000,1885,55115,2002,t1,presidential
16245,74,HAUTE-SAVOIE,77536,55235,1761,53474,2002,t1,presidential
16246,74,HAUTE-SAVOIE,80258,56994,1802,55192,2002,t1,presidential
16247,74,HAUTE-SAVOIE,94603,68368,2460,65908,2002,t1,presidential
16248,75,PARIS,54151,38416,745,37671,2002,t1,presidential
16249,75,PARIS,49657,35332,576,34756,2002,t1,presidential
16250,75,PARIS,40310,28663,406,28257,2002,t1,presidential
16251,75,PARIS,50194,35068,606,34462,2002,t1,presidential
16252,75,PARIS,40458,28136,520,27616,2002,t1,presidential
16253,75,PARIS,54813,38523,878,37645,2002,t1,presidential
16254,75,PARIS,55247,39265,816,38449,2002,t1,presidential
16255,75,PARIS,63588,45022,919,44103,2002,t1,presidential
16256,75,PARIS,53111,36858,781,36077,2002,t1,presidential
16257,75,PARIS,57653,40776,823,39953,2002,t1,presidential
16258,75,PARIS,53298,37673,726,36947,2002,t1,presidential
16259,75,PARIS,60356,43103,734,42369,2002,t1,presidential
16260,75,PARIS,63165,45124,763,44361,2002,t1,presidential
16261,75,PARIS,45047,31853,411,31442,2002,t1,presidential
16262,75,PARIS,37431,25897,263,25634,2002,t1,presidential
16263,75,PARIS,48855,34480,523,33957,2002,t1,presidential
16264,75,PARIS,47915,32863,675,32188,2002,t1,presidential
16265,75,PARIS,48343,33677,658,33019,2002,t1,presidential
16266,75,PARIS,39865,26950,584,26366,2002,t1,presidential
16267,75,PARIS,54604,37619,764,36855,2002,t1,presidential
16268,75,PARIS,63359,43732,916,42816,2002,t1,presidential
16269,76,SEINE-MARITIME,54993,39697,979,38718,2002,t1,presidential
16270,76,SEINE-MARITIME,82844,62482,1704,60778,2002,t1,presidential
16271,76,SEINE-MARITIME,54174,38996,1404,37592,2002,t1,presidential
16272,76,SEINE-MARITIME,69702,50649,1829,48820,2002,t1,presidential
16273,76,SEINE-MARITIME,85184,63893,2255,61638,2002,t1,presidential
16274,76,SEINE-MARITIME,75596,54798,1690,53108,2002,t1,presidential
16275,76,SEINE-MARITIME,57928,40854,999,39855,2002,t1,presidential
16276,76,SEINE-MARITIME,52459,34165,945,33220,2002,t1,presidential
16277,76,SEINE-MARITIME,80882,61103,2088,59015,2002,t1,presidential
16278,76,SEINE-MARITIME,80612,61808,2266,59542,2002,t1,presidential
16279,76,SEINE-MARITIME,73006,54188,1885,52303,2002,t1,presidential
16280,76,SEINE-MARITIME,70279,53424,2159,51265,2002,t1,presidential
16281,77,SEINE-ET-MARNE,80889,53453,1348,52105,2002,t1,presidential
16282,77,SEINE-ET-MARNE,71724,50618,1352,49266,2002,t1,presidential
16283,77,SEINE-ET-MARNE,70731,48208,1398,46810,2002,t1,presidential
16284,77,SEINE-ET-MARNE,76396,54031,1570,52461,2002,t1,presidential
16285,77,SEINE-ET-MARNE,81049,54987,1522,53465,2002,t1,presidential
16286,77,SEINE-ET-MARNE,74109,50666,1381,49285,2002,t1,presidential
16287,77,SEINE-ET-MARNE,81093,52061,1342,50719,2002,t1,presidential
16288,77,SEINE-ET-MARNE,91989,61126,1566,59560,2002,t1,presidential
16289,77,SEINE-ET-MARNE,93838,63051,1763,61288,2002,t1,presidential
16290,78,YVELINES,82476,57550,1166,56384,2002,t1,presidential
16291,78,YVELINES,73140,50339,1064,49275,2002,t1,presidential
16292,78,YVELINES,64596,43976,716,43260,2002,t1,presidential
16293,78,YVELINES,69023,47067,1040,46027,2002,t1,presidential
16294,78,YVELINES,63393,42912,816,42096,2002,t1,presidential
16295,78,YVELINES,55449,37120,718,36402,2002,t1,presidential
16296,78,YVELINES,68350,46769,1079,45690,2002,t1,presidential
16297,78,YVELINES,59158,41300,1060,40240,2002,t1,presidential
16298,78,YVELINES,78167,55671,1452,54219,2002,t1,presidential
16299,78,YVELINES,94555,66684,1544,65140,2002,t1,presidential
16300,78,YVELINES,51938,33911,838,33073,2002,t1,presidential
16301,78,YVELINES,65152,44586,1014,43572,2002,t1,presidential
16302,79,DEUX-SEVRES,59898,44752,1685,43067,2002,t1,presidential
16303,79,DEUX-SEVRES,70199,53088,2467,50621,2002,t1,presidential
16304,79,DEUX-SEVRES,61344,46868,2728,44140,2002,t1,presidential
16305,79,DEUX-SEVRES,69496,52495,2994,49501,2002,t1,presidential
16306,80,SOMME,57427,40700,1198,39502,2002,t1,presidential
16307,80,SOMME,61775,44956,1218,43738,2002,t1,presidential
16308,80,SOMME,67755,53756,2014,51742,2002,t1,presidential
16309,80,SOMME,71933,55126,1898,53228,2002,t1,presidential
16310,80,SOMME,65019,49406,1673,47733,2002,t1,presidential
16311,80,SOMME,76103,58912,2220,56692,2002,t1,presidential
16312,81,TARN,56021,43483,2272,41211,2002,t1,presidential
16313,81,TARN,73968,56994,2591,54403,2002,t1,presidential
16314,81,TARN,58135,44826,2028,42798,2002,t1,presidential
16315,81,TARN,73481,58402,2622,55780,2002,t1,presidential
16316,82,TARN-ET-GARONNE,75939,59187,2143,57044,2002,t1,presidential
16317,82,TARN-ET-GARONNE,77887,60432,2369,58063,2002,t1,presidential
16318,83,VAR,49547,33636,709,32927,2002,t1,presidential
16319,83,VAR,53129,36558,879,35679,2002,t1,presidential
16320,83,VAR,102951,74389,1924,72465,2002,t1,presidential
16321,83,VAR,105837,78033,1873,76160,2002,t1,presidential
16322,83,VAR,94715,69231,1531,67700,2002,t1,presidential
16323,83,VAR,138380,103327,2875,100452,2002,t1,presidential
16324,83,VAR,100756,69566,1775,67791,2002,t1,presidential
16325,84,VAUCLUSE,67977,49375,1347,48028,2002,t1,presidential
16326,84,VAUCLUSE,109944,83194,2548,80646,2002,t1,presidential
16327,84,VAUCLUSE,88890,67490,2034,65456,2002,t1,presidential
16328,84,VAUCLUSE,76070,59018,1815,57203,2002,t1,presidential
16329,85,VENDEE,86663,65722,3311,62411,2002,t1,presidential
16330,85,VENDEE,83093,63681,2965,60716,2002,t1,presidential
16331,85,VENDEE,96411,70496,2650,67846,2002,t1,presidential
16332,85,VENDEE,85266,67802,3821,63981,2002,t1,presidential
16333,85,VENDEE,76456,57747,2642,55105,2002,t1,presidential
16334,86,VIENNE,76161,57824,2230,55594,2002,t1,presidential
16335,86,VIENNE,68846,52422,1889,50533,2002,t1,presidential
16336,86,VIENNE,67765,51713,2449,49264,2002,t1,presidential
16337,86,VIENNE,74161,54032,2456,51576,2002,t1,presidential
16338,87,HAUTE-VIENNE,52014,39422,1673,37749,2002,t1,presidential
16339,87,HAUTE-VIENNE,72594,57032,3187,53845,2002,t1,presidential
16340,87,HAUTE-VIENNE,66367,50674,2571,48103,2002,t1,presidential
16341,87,HAUTE-VIENNE,70277,54123,2851,51272,2002,t1,presidential
16342,88,VOSGES,75220,53937,2230,51707,2002,t1,presidential
16343,88,VOSGES,73238,52459,2688,49771,2002,t1,presidential
16344,88,VOSGES,65973,49650,2438,47212,2002,t1,presidential
16345,88,VOSGES,68744,51132,2258,48874,2002,t1,presidential
16346,89,YONNE,75811,56039,1872,54167,2002,t1,presidential
16347,89,YONNE,72421,53223,1929,51294,2002,t1,presidential
16348,89,YONNE,87455,64017,2169,61848,2002,t1,presidential
16349,90,TERRITOIRE DE BELFORT,43782,33318,1150,32168,2002,t1,presidential
16350,90,TERRITOIRE DE BELFORT,45862,35149,1270,33879,2002,t1,presidential
16351,91,ESSONNE,59939,39739,1113,38626,2002,t1,presidential
16352,91,ESSONNE,75545,53328,1498,51830,2002,t1,presidential
16353,91,ESSONNE,86388,60369,1672,58697,2002,t1,presidential
16354,91,ESSONNE,76203,52504,1383,51121,2002,t1,presidential
16355,91,ESSONNE,60534,42192,930,41262,2002,t1,presidential
16356,91,ESSONNE,67313,45794,1074,44720,2002,t1,presidential
16357,91,ESSONNE,65197,44223,1071,43152,2002,t1,presidential
16358,91,ESSONNE,67959,45261,1145,44116,2002,t1,presidential
16359,91,ESSONNE,68291,45842,1135,44707,2002,t1,presidential
16360,91,ESSONNE,54337,35602,912,34690,2002,t1,presidential
16361,92,HAUTS-DE-SEINE,52900,32857,838,32019,2002,t1,presidential
16362,92,HAUTS-DE-SEINE,52029,35455,718,34737,2002,t1,presidential
16363,92,HAUTS-DE-SEINE,69037,47740,1452,46288,2002,t1,presidential
16364,92,HAUTS-DE-SEINE,59689,39230,998,38232,2002,t1,presidential
16365,92,HAUTS-DE-SEINE,58109,39886,781,39105,2002,t1,presidential
16366,92,HAUTS-DE-SEINE,57927,41014,795,40219,2002,t1,presidential
16367,92,HAUTS-DE-SEINE,77828,50722,971,49751,2002,t1,presidential
16368,92,HAUTS-DE-SEINE,63484,42755,728,42027,2002,t1,presidential
16369,92,HAUTS-DE-SEINE,52677,36599,563,36036,2002,t1,presidential
16370,92,HAUTS-DE-SEINE,56253,39326,845,38481,2002,t1,presidential
16371,92,HAUTS-DE-SEINE,59139,38904,891,38013,2002,t1,presidential
16372,92,HAUTS-DE-SEINE,77848,52332,1149,51183,2002,t1,presidential
16373,92,HAUTS-DE-SEINE,77946,54969,1063,53906,2002,t1,presidential
16374,93,SEINE-SAINT-DENIS,42468,26589,622,25967,2002,t1,presidential
16375,93,SEINE-SAINT-DENIS,44256,27154,713,26441,2002,t1,presidential
16376,93,SEINE-SAINT-DENIS,40076,25109,575,24534,2002,t1,presidential
16377,93,SEINE-SAINT-DENIS,41415,25569,713,24856,2002,t1,presidential
16378,93,SEINE-SAINT-DENIS,47598,30159,750,29409,2002,t1,presidential
16379,93,SEINE-SAINT-DENIS,52628,34558,844,33714,2002,t1,presidential
16380,93,SEINE-SAINT-DENIS,43872,27241,570,26671,2002,t1,presidential
16381,93,SEINE-SAINT-DENIS,55661,36852,912,35940,2002,t1,presidential
16382,93,SEINE-SAINT-DENIS,48347,31838,752,31086,2002,t1,presidential
16383,93,SEINE-SAINT-DENIS,47141,30258,684,29574,2002,t1,presidential
16384,93,SEINE-SAINT-DENIS,51443,33492,947,32545,2002,t1,presidential
16385,93,SEINE-SAINT-DENIS,55806,37107,906,36201,2002,t1,presidential
16386,93,SEINE-SAINT-DENIS,60186,40539,1001,39538,2002,t1,presidential
16387,94,VAL-DE-MARNE,50181,34950,772,34178,2002,t1,presidential
16388,94,VAL-DE-MARNE,56939,38460,1014,37446,2002,t1,presidential
16389,94,VAL-DE-MARNE,62475,42068,1065,41003,2002,t1,presidential
16390,94,VAL-DE-MARNE,63864,44105,1069,43036,2002,t1,presidential
16391,94,VAL-DE-MARNE,56638,36978,902,36076,2002,t1,presidential
16392,94,VAL-DE-MARNE,68804,46274,952,45322,2002,t1,presidential
16393,94,VAL-DE-MARNE,52344,35818,756,35062,2002,t1,presidential
16394,94,VAL-DE-MARNE,54376,37430,832,36598,2002,t1,presidential
16395,94,VAL-DE-MARNE,46320,29768,818,28950,2002,t1,presidential
16396,94,VAL-DE-MARNE,53791,35431,871,34560,2002,t1,presidential
16397,94,VAL-DE-MARNE,51675,32849,775,32074,2002,t1,presidential
16398,94,VAL-DE-MARNE,58878,38779,1019,37760,2002,t1,presidential
16399,95,VAL-D'OISE,69667,49491,1312,48179,2002,t1,presidential
16400,95,VAL-D'OISE,98208,68178,1802,66376,2002,t1,presidential
16401,95,VAL-D'OISE,75572,50567,1331,49236,2002,t1,presidential
16402,95,VAL-D'OISE,68566,45113,1037,44076,2002,t1,presidential
16403,95,VAL-D'OISE,55459,36360,858,35502,2002,t1,presidential
16404,95,VAL-D'OISE,63271,42320,956,41364,2002,t1,presidential
16405,95,VAL-D'OISE,72870,49804,1095,48709,2002,t1,presidential
16406,95,VAL-D'OISE,42903,27848,692,27156,2002,t1,presidential
16407,95,VAL-D'OISE,57793,38977,1023,37954,2002,t1,presidential
16408,971,GUADELOUPE,58825,19959,1014,18945,2002,t1,presidential
16409,971,GUADELOUPE,79415,25141,1134,24007,2002,t1,presidential
16410,971,GUADELOUPE,73299,26735,979,25756,2002,t1,presidential
16411,971,GUADELOUPE,66534,23505,1034,22471,2002,t1,presidential
16412,972,MARTINIQUE,56883,21534,1272,20262,2002,t1,presidential
16413,972,MARTINIQUE,58883,22588,837,21751,2002,t1,presidential
16414,972,MARTINIQUE,55765,20211,1193,19018,2002,t1,presidential
16415,972,MARTINIQUE,94698,29919,1521,28398,2002,t1,presidential
16416,973,GUYANE,19564,9139,255,8884,2002,t1,presidential
16417,973,GUYANE,32223,15077,297,14780,2002,t1,presidential
16418,974,LA REUNION,71555,40118,1867,38251,2002,t1,presidential
16419,974,LA REUNION,91721,48803,2706,46097,2002,t1,presidential
16420,974,LA REUNION,106703,64610,3238,61372,2002,t1,presidential
16421,974,LA REUNION,80231,47802,2577,45225,2002,t1,presidential
16422,974,LA REUNION,86975,44721,1945,42776,2002,t1,presidential
16423,975,SAINT-PIERRE-ET-MIQUELON,4813,2020,78,1942,2002,t1,presidential
16424,985,MAYOTTE,52218,21525,336,21189,2002,t1,presidential
16425,986,WALLIS ET FUTUNA,9353,6027,37,5990,2002,t1,presidential
16426,987,POLYNESIE FRANCAISE,151505,78890,3331,75559,2002,t1,presidential
16427,988,NOUVELLE-CALEDONIE,126985,62551,1600,60951,2002,t1,presidential
16428,1,AIN,79016,66144,1392,64752,2012,t1,presidential
16429,1,AIN,86823,73697,1380,72317,2012,t1,presidential
16430,1,AIN,69832,56310,1030,55280,2012,t1,presidential
16431,1,AIN,84491,71331,1484,69847,2012,t1,presidential
16432,1,AIN,73646,60330,1167,59163,2012,t1,presidential
16433,2,AISNE,72609,58995,968,58027,2012,t1,presidential
16434,2,AISNE,73200,59518,957,58561,2012,t1,presidential
16435,2,AISNE,70339,56670,1027,55643,2012,t1,presidential
16436,2,AISNE,78925,61916,1048,60868,2012,t1,presidential
16437,2,AISNE,80995,66041,1196,64845,2012,t1,presidential
16438,3,ALLIER,90369,75073,1797,73276,2012,t1,presidential
16439,3,ALLIER,86813,70616,1719,68897,2012,t1,presidential
16440,3,ALLIER,79093,65320,1543,63777,2012,t1,presidential
16441,4,ALPES-DE-HAUTE-PROVENCE,60613,50678,1087,49591,2012,t1,presidential
16442,4,ALPES-DE-HAUTE-PROVENCE,63320,52221,1024,51197,2012,t1,presidential
16443,5,HAUTES-ALPES,56117,46571,946,45625,2012,t1,presidential
16444,5,HAUTES-ALPES,50748,42048,896,41152,2012,t1,presidential
16445,6,ALPES-MARITIMES,82234,63180,961,62219,2012,t1,presidential
16446,6,ALPES-MARITIMES,82299,66688,1067,65621,2012,t1,presidential
16447,6,ALPES-MARITIMES,87319,68757,1003,67754,2012,t1,presidential
16448,6,ALPES-MARITIMES,84775,66865,1087,65778,2012,t1,presidential
16449,6,ALPES-MARITIMES,85302,68686,1007,67679,2012,t1,presidential
16450,6,ALPES-MARITIMES,76051,60639,984,59655,2012,t1,presidential
16451,6,ALPES-MARITIMES,89503,72083,1139,70944,2012,t1,presidential
16452,6,ALPES-MARITIMES,80621,63330,913,62417,2012,t1,presidential
16453,6,ALPES-MARITIMES,77184,61677,902,60775,2012,t1,presidential
16454,7,ARDECHE,76468,63947,1287,62660,2012,t1,presidential
16455,7,ARDECHE,90863,77048,1557,75491,2012,t1,presidential
16456,7,ARDECHE,76020,63796,1229,62567,2012,t1,presidential
16457,8,ARDENNES,73103,58710,902,57808,2012,t1,presidential
16458,8,ARDENNES,64937,50285,828,49457,2012,t1,presidential
16459,8,ARDENNES,58539,47076,750,46326,2012,t1,presidential
16460,9,ARIEGE,56627,47531,827,46704,2012,t1,presidential
16461,9,ARIEGE,59743,50337,993,49344,2012,t1,presidential
16462,10,AUBE,64650,53154,1013,52141,2012,t1,presidential
16463,10,AUBE,74378,61124,1002,60122,2012,t1,presidential
16464,10,AUBE,64562,51373,1451,49922,2012,t1,presidential
16465,11,AUDE,92914,77933,1509,76424,2012,t1,presidential
16466,11,AUDE,83707,68513,1313,67200,2012,t1,presidential
16467,11,AUDE,87667,74201,1477,72724,2012,t1,presidential
16468,12,AVEYRON,75555,64915,1447,63468,2012,t1,presidential
16469,12,AVEYRON,70784,59962,1536,58426,2012,t1,presidential
16470,12,AVEYRON,72008,61375,1556,59819,2012,t1,presidential
16471,13,BOUCHES-DU-RHONE,73802,59395,863,58532,2012,t1,presidential
16472,13,BOUCHES-DU-RHONE,77359,62823,761,62062,2012,t1,presidential
16473,13,BOUCHES-DU-RHONE,70255,54895,796,54099,2012,t1,presidential
16474,13,BOUCHES-DU-RHONE,58642,43728,535,43193,2012,t1,presidential
16475,13,BOUCHES-DU-RHONE,68683,54305,755,53550,2012,t1,presidential
16476,13,BOUCHES-DU-RHONE,72502,57795,836,56959,2012,t1,presidential
16477,13,BOUCHES-DU-RHONE,62963,45964,655,45309,2012,t1,presidential
16478,13,BOUCHES-DU-RHONE,92844,75925,1254,74671,2012,t1,presidential
16479,13,BOUCHES-DU-RHONE,92567,75828,1229,74599,2012,t1,presidential
16480,13,BOUCHES-DU-RHONE,100091,83298,1428,81870,2012,t1,presidential
16481,13,BOUCHES-DU-RHONE,85219,68231,983,67248,2012,t1,presidential
16482,13,BOUCHES-DU-RHONE,88672,71815,1337,70478,2012,t1,presidential
16483,13,BOUCHES-DU-RHONE,90488,73648,1345,72303,2012,t1,presidential
16484,13,BOUCHES-DU-RHONE,93914,76228,1162,75066,2012,t1,presidential
16485,13,BOUCHES-DU-RHONE,98261,81727,1465,80262,2012,t1,presidential
16486,13,BOUCHES-DU-RHONE,88504,71729,1307,70422,2012,t1,presidential
16487,14,CALVADOS,70127,58176,873,57303,2012,t1,presidential
16488,14,CALVADOS,66999,55075,864,54211,2012,t1,presidential
16489,14,CALVADOS,78426,64083,1086,62997,2012,t1,presidential
16490,14,CALVADOS,97698,80572,1223,79349,2012,t1,presidential
16491,14,CALVADOS,86325,72472,1099,71373,2012,t1,presidential
16492,14,CALVADOS,90972,77671,1472,76199,2012,t1,presidential
16493,15,CANTAL,64476,53956,1183,52773,2012,t1,presidential
16494,15,CANTAL,56486,46640,1007,45633,2012,t1,presidential
16495,16,CHARENTE,84091,67435,1251,66184,2012,t1,presidential
16496,16,CHARENTE,84766,69596,1602,67994,2012,t1,presidential
16497,16,CHARENTE,91908,77093,1812,75281,2012,t1,presidential
16498,17,CHARENTE-MARITIME,98777,80273,1336,78937,2012,t1,presidential
16499,17,CHARENTE-MARITIME,97478,80254,1569,78685,2012,t1,presidential
16500,17,CHARENTE-MARITIME,81932,66619,1419,65200,2012,t1,presidential
16501,17,CHARENTE-MARITIME,87772,72102,1664,70438,2012,t1,presidential
16502,17,CHARENTE-MARITIME,105988,87221,1740,85481,2012,t1,presidential
16503,18,CHER,74882,60044,1407,58637,2012,t1,presidential
16504,18,CHER,70193,55917,1087,54830,2012,t1,presidential
16505,18,CHER,85842,69661,1513,68148,2012,t1,presidential
16506,19,CORREZE,94710,81926,1684,80242,2012,t1,presidential
16507,19,CORREZE,91991,77443,1590,75853,2012,t1,presidential
16508,21,COTE-D'OR,67618,56916,895,56021,2012,t1,presidential
16509,21,COTE-D'OR,66116,54691,972,53719,2012,t1,presidential
16510,21,COTE-D'OR,69129,56971,1076,55895,2012,t1,presidential
16511,21,COTE-D'OR,69026,57326,1129,56197,2012,t1,presidential
16512,21,COTE-D'OR,82900,68601,1362,67239,2012,t1,presidential
16513,22,COTES-D'ARMOR,89049,74729,1302,73427,2012,t1,presidential
16514,22,COTES-D'ARMOR,93735,81033,1539,79494,2012,t1,presidential
16515,22,COTES-D'ARMOR,86224,75062,1457,73605,2012,t1,presidential
16516,22,COTES-D'ARMOR,79616,68374,1189,67185,2012,t1,presidential
16517,22,COTES-D'ARMOR,102337,87310,1484,85826,2012,t1,presidential
16518,23,CREUSE,96875,79657,1907,77750,2012,t1,presidential
16519,24,DORDOGNE,75024,63108,1291,61817,2012,t1,presidential
16520,24,DORDOGNE,81118,67840,1385,66455,2012,t1,presidential
16521,24,DORDOGNE,69063,59122,1557,57565,2012,t1,presidential
16522,24,DORDOGNE,86728,74577,1600,72977,2012,t1,presidential
16523,25,DOUBS,72913,59539,1057,58482,2012,t1,presidential
16524,25,DOUBS,76234,63326,1165,62161,2012,t1,presidential
16525,25,DOUBS,65441,54153,1114,53039,2012,t1,presidential
16526,25,DOUBS,67347,54974,1110,53864,2012,t1,presidential
16527,25,DOUBS,77258,65424,1558,63866,2012,t1,presidential
16528,26,DROME,72800,59255,1057,58198,2012,t1,presidential
16529,26,DROME,87735,72272,1274,70998,2012,t1,presidential
16530,26,DROME,102551,87234,1565,85669,2012,t1,presidential
16531,26,DROME,89970,74740,1352,73388,2012,t1,presidential
16532,27,EURE,85312,68348,1171,67177,2012,t1,presidential
16533,27,EURE,76980,63688,1206,62482,2012,t1,presidential
16534,27,EURE,81704,67715,1224,66491,2012,t1,presidential
16535,27,EURE,86667,70416,1232,69184,2012,t1,presidential
16536,27,EURE,87167,70393,1252,69141,2012,t1,presidential
16537,28,EURE-ET-LOIR,87319,70689,1236,69453,2012,t1,presidential
16538,28,EURE-ET-LOIR,71974,57011,966,56045,2012,t1,presidential
16539,28,EURE-ET-LOIR,71254,57584,1104,56480,2012,t1,presidential
16540,28,EURE-ET-LOIR,67237,55911,1074,54837,2012,t1,presidential
16541,29,FINISTERE,85838,73290,1284,72006,2012,t1,presidential
16542,29,FINISTERE,77990,62188,1169,61019,2012,t1,presidential
16543,29,FINISTERE,86160,72958,1204,71754,2012,t1,presidential
16544,29,FINISTERE,82138,69929,1069,68860,2012,t1,presidential
16545,29,FINISTERE,91166,78121,1170,76951,2012,t1,presidential
16546,29,FINISTERE,89318,76021,1145,74876,2012,t1,presidential
16547,29,FINISTERE,79751,66890,1151,65739,2012,t1,presidential
16548,29,FINISTERE,84410,70198,1331,68867,2012,t1,presidential
16549,2A,CORSE-DU-SUD,47907,35759,575,35184,2012,t1,presidential
16550,2A,CORSE-DU-SUD,53775,39750,719,39031,2012,t1,presidential
16551,2B,HAUTE-CORSE,54684,41714,802,40912,2012,t1,presidential
16552,2B,HAUTE-CORSE,63983,46430,825,45605,2012,t1,presidential
16553,30,GARD,83350,67002,1068,65934,2012,t1,presidential
16554,30,GARD,82315,69381,1114,68267,2012,t1,presidential
16555,30,GARD,88772,74358,1233,73125,2012,t1,presidential
16556,30,GARD,87667,73467,1348,72119,2012,t1,presidential
16557,30,GARD,93398,78036,1379,76657,2012,t1,presidential
16558,30,GARD,77636,62904,980,61924,2012,t1,presidential
16559,31,HAUTE-GARONNE,76334,61494,872,60622,2012,t1,presidential
16560,31,HAUTE-GARONNE,94385,77513,1186,76327,2012,t1,presidential
16561,31,HAUTE-GARONNE,73042,60781,860,59921,2012,t1,presidential
16562,31,HAUTE-GARONNE,66065,50957,713,50244,2012,t1,presidential
16563,31,HAUTE-GARONNE,90084,77586,1359,76227,2012,t1,presidential
16564,31,HAUTE-GARONNE,103044,88130,1509,86621,2012,t1,presidential
16565,31,HAUTE-GARONNE,92441,79019,1443,77576,2012,t1,presidential
16566,31,HAUTE-GARONNE,84959,70762,1473,69289,2012,t1,presidential
16567,31,HAUTE-GARONNE,76370,61222,932,60290,2012,t1,presidential
16568,31,HAUTE-GARONNE,88311,77889,1413,76476,2012,t1,presidential
16569,32,GERS,73648,63062,1397,61665,2012,t1,presidential
16570,32,GERS,70150,60328,1327,59001,2012,t1,presidential
16571,33,GIRONDE,85925,69466,994,68472,2012,t1,presidential
16572,33,GIRONDE,62137,49178,608,48570,2012,t1,presidential
16573,33,GIRONDE,74178,59842,954,58888,2012,t1,presidential
16574,33,GIRONDE,86631,69237,1125,68112,2012,t1,presidential
16575,33,GIRONDE,102428,85579,1413,84166,2012,t1,presidential
16576,33,GIRONDE,95183,79801,1271,78530,2012,t1,presidential
16577,33,GIRONDE,72620,60679,1025,59654,2012,t1,presidential
16578,33,GIRONDE,97814,81015,1418,79597,2012,t1,presidential
16579,33,GIRONDE,85580,72986,1392,71594,2012,t1,presidential
16580,33,GIRONDE,78500,65463,1195,64268,2012,t1,presidential
16581,33,GIRONDE,88093,72957,1436,71521,2012,t1,presidential
16582,33,GIRONDE,78574,66743,1209,65534,2012,t1,presidential
16583,34,HERAULT,79031,63949,1095,62854,2012,t1,presidential
16584,34,HERAULT,58251,44452,649,43803,2012,t1,presidential
16585,34,HERAULT,77193,65405,1127,64278,2012,t1,presidential
16586,34,HERAULT,103137,86731,1533,85198,2012,t1,presidential
16587,34,HERAULT,90867,75650,1364,74286,2012,t1,presidential
16588,34,HERAULT,86114,70023,1096,68927,2012,t1,presidential
16589,34,HERAULT,95924,78812,1336,77476,2012,t1,presidential
16590,34,HERAULT,80607,66301,1222,65079,2012,t1,presidential
16591,34,HERAULT,75492,62099,1056,61043,2012,t1,presidential
16592,35,ILLE-ET-VILAINE,87048,72281,1140,71141,2012,t1,presidential
16593,35,ILLE-ET-VILAINE,86833,74753,1172,73581,2012,t1,presidential
16594,35,ILLE-ET-VILAINE,81381,69987,1277,68710,2012,t1,presidential
16595,35,ILLE-ET-VILAINE,85031,73146,1358,71788,2012,t1,presidential
16596,35,ILLE-ET-VILAINE,97396,83772,1813,81959,2012,t1,presidential
16597,35,ILLE-ET-VILAINE,85292,72673,1599,71074,2012,t1,presidential
16598,35,ILLE-ET-VILAINE,95210,77903,1748,76155,2012,t1,presidential
16599,35,ILLE-ET-VILAINE,78852,65556,938,64618,2012,t1,presidential
16600,36,INDRE,82209,66128,1561,64567,2012,t1,presidential
16601,36,INDRE,91563,76308,1927,74381,2012,t1,presidential
16602,37,INDRE-ET-LOIRE,65487,51305,750,50555,2012,t1,presidential
16603,37,INDRE-ET-LOIRE,84326,71012,1339,69673,2012,t1,presidential
16604,37,INDRE-ET-LOIRE,94500,79209,1508,77701,2012,t1,presidential
16605,37,INDRE-ET-LOIRE,88179,72851,1458,71393,2012,t1,presidential
16606,37,INDRE-ET-LOIRE,80412,67169,1236,65933,2012,t1,presidential
16607,38,ISERE,80549,66494,912,65582,2012,t1,presidential
16608,38,ISERE,75014,62109,1055,61054,2012,t1,presidential
16609,38,ISERE,59876,47804,712,47092,2012,t1,presidential
16610,38,ISERE,87773,73035,1214,71821,2012,t1,presidential
16611,38,ISERE,97730,82284,1387,80897,2012,t1,presidential
16612,38,ISERE,77054,62854,1137,61717,2012,t1,presidential
16613,38,ISERE,87576,73164,1507,71657,2012,t1,presidential
16614,38,ISERE,74923,62324,1204,61120,2012,t1,presidential
16615,38,ISERE,93219,77271,1591,75680,2012,t1,presidential
16616,38,ISERE,87565,71033,1314,69719,2012,t1,presidential
16617,39,JURA,65037,54247,1165,53082,2012,t1,presidential
16618,39,JURA,54939,45667,967,44700,2012,t1,presidential
16619,39,JURA,68276,57421,1110,56311,2012,t1,presidential
16620,40,LANDES,97627,80312,1540,78772,2012,t1,presidential
16621,40,LANDES,104556,87242,1636,85606,2012,t1,presidential
16622,40,LANDES,94557,81113,1661,79452,2012,t1,presidential
16623,41,LOIR-ET-CHER,80410,65439,1129,64310,2012,t1,presidential
16624,41,LOIR-ET-CHER,80275,66339,1341,64998,2012,t1,presidential
16625,41,LOIR-ET-CHER,82376,69498,1505,67993,2012,t1,presidential
16626,42,LOIRE,67953,54379,846,53533,2012,t1,presidential
16627,42,LOIRE,57287,44335,638,43697,2012,t1,presidential
16628,42,LOIRE,80375,66638,1201,65437,2012,t1,presidential
16629,42,LOIRE,99044,82673,1557,81116,2012,t1,presidential
16630,42,LOIRE,101180,84818,1946,82872,2012,t1,presidential
16631,42,LOIRE,103862,87632,1864,85768,2012,t1,presidential
16632,43,HAUTE-LOIRE,95744,81685,1950,79735,2012,t1,presidential
16633,43,HAUTE-LOIRE,80359,67193,1829,65364,2012,t1,presidential
16634,44,LOIRE-ATLANTIQUE,72688,59617,904,58713,2012,t1,presidential
16635,44,LOIRE-ATLANTIQUE,81535,66456,884,65572,2012,t1,presidential
16636,44,LOIRE-ATLANTIQUE,88998,71963,1198,70765,2012,t1,presidential
16637,44,LOIRE-ATLANTIQUE,82720,69717,1210,68507,2012,t1,presidential
16638,44,LOIRE-ATLANTIQUE,105488,90558,1539,89019,2012,t1,presidential
16639,44,LOIRE-ATLANTIQUE,106779,91201,2085,89116,2012,t1,presidential
16640,44,LOIRE-ATLANTIQUE,101902,86132,1556,84576,2012,t1,presidential
16641,44,LOIRE-ATLANTIQUE,81009,66528,1094,65434,2012,t1,presidential
16642,44,LOIRE-ATLANTIQUE,107606,92396,1766,90630,2012,t1,presidential
16643,44,LOIRE-ATLANTIQUE,106529,93325,1935,91390,2012,t1,presidential
16644,45,LOIRET,73161,60332,1091,59241,2012,t1,presidential
16645,45,LOIRET,81883,66598,1212,65386,2012,t1,presidential
16646,45,LOIRET,71053,59110,1103,58007,2012,t1,presidential
16647,45,LOIRET,74980,60131,1150,58981,2012,t1,presidential
16648,45,LOIRET,72673,59427,1123,58304,2012,t1,presidential
16649,45,LOIRET,69178,57133,1007,56126,2012,t1,presidential
16650,46,LOT,70151,60102,1134,58968,2012,t1,presidential
16651,46,LOT,65027,56338,1236,55102,2012,t1,presidential
16652,47,LOT-ET-GARONNE,86690,72602,1507,71095,2012,t1,presidential
16653,47,LOT-ET-GARONNE,77711,64595,1323,63272,2012,t1,presidential
16654,47,LOT-ET-GARONNE,76525,63423,1258,62165,2012,t1,presidential
16655,48,LOZERE,59890,51033,1027,50006,2012,t1,presidential
16656,49,MAINE-ET-LOIRE,80729,67018,1323,65695,2012,t1,presidential
16657,49,MAINE-ET-LOIRE,87336,73540,1602,71938,2012,t1,presidential
16658,49,MAINE-ET-LOIRE,68407,58011,1457,56554,2012,t1,presidential
16659,49,MAINE-ET-LOIRE,73602,61751,1405,60346,2012,t1,presidential
16660,49,MAINE-ET-LOIRE,75267,62993,1523,61470,2012,t1,presidential
16661,49,MAINE-ET-LOIRE,92436,79464,2131,77333,2012,t1,presidential
16662,49,MAINE-ET-LOIRE,75237,63851,1414,62437,2012,t1,presidential
16663,50,MANCHE,86456,72037,1346,70691,2012,t1,presidential
16664,50,MANCHE,94746,79418,1827,77591,2012,t1,presidential
16665,50,MANCHE,105836,88571,1581,86990,2012,t1,presidential
16666,50,MANCHE,88678,72055,1198,70857,2012,t1,presidential
16667,51,MARNE,69203,53292,784,52508,2012,t1,presidential
16668,51,MARNE,72576,56832,863,55969,2012,t1,presidential
16669,51,MARNE,81279,64151,1122,63029,2012,t1,presidential
16670,51,MARNE,80837,63491,1087,62404,2012,t1,presidential
16671,51,MARNE,78108,64198,1121,63077,2012,t1,presidential
16672,52,HAUTE-MARNE,74607,60324,1213,59111,2012,t1,presidential
16673,52,HAUTE-MARNE,64322,51260,1018,50242,2012,t1,presidential
16674,53,MAYENNE,72582,60692,1504,59188,2012,t1,presidential
16675,53,MAYENNE,76637,64987,1526,63461,2012,t1,presidential
16676,53,MAYENNE,72274,61293,1671,59622,2012,t1,presidential
16677,54,MEURTHE-ET-MOSELLE,80648,63229,918,62311,2012,t1,presidential
16678,54,MEURTHE-ET-MOSELLE,70856,56146,817,55329,2012,t1,presidential
16679,54,MEURTHE-ET-MOSELLE,83005,64275,989,63286,2012,t1,presidential
16680,54,MEURTHE-ET-MOSELLE,97171,78953,1371,77582,2012,t1,presidential
16681,54,MEURTHE-ET-MOSELLE,76585,63588,1068,62520,2012,t1,presidential
16682,54,MEURTHE-ET-MOSELLE,87241,69954,1079,68875,2012,t1,presidential
16683,55,MEUSE,78882,65296,1225,64071,2012,t1,presidential
16684,55,MEUSE,61251,49233,850,48383,2012,t1,presidential
16685,56,MORBIHAN,98822,83863,1222,82641,2012,t1,presidential
16686,56,MORBIHAN,98595,83823,1435,82388,2012,t1,presidential
16687,56,MORBIHAN,86774,74823,1498,73325,2012,t1,presidential
16688,56,MORBIHAN,102136,87560,1691,85869,2012,t1,presidential
16689,56,MORBIHAN,80340,64336,1174,63162,2012,t1,presidential
16690,56,MORBIHAN,89152,75291,1518,73773,2012,t1,presidential
16691,57,MOSELLE,88138,69359,1130,68229,2012,t1,presidential
16692,57,MOSELLE,76137,59847,998,58849,2012,t1,presidential
16693,57,MOSELLE,74012,57589,928,56661,2012,t1,presidential
16694,57,MOSELLE,81115,66423,1375,65048,2012,t1,presidential
16695,57,MOSELLE,74554,59066,1283,57783,2012,t1,presidential
16696,57,MOSELLE,72289,53908,968,52940,2012,t1,presidential
16697,57,MOSELLE,91531,72142,1261,70881,2012,t1,presidential
16698,57,MOSELLE,90881,68371,1242,67129,2012,t1,presidential
16699,57,MOSELLE,97021,76025,1473,74552,2012,t1,presidential
16700,58,NIEVRE,78208,62299,1243,61056,2012,t1,presidential
16701,58,NIEVRE,86703,70891,1351,69540,2012,t1,presidential
16702,59,NORD,60434,44574,662,43912,2012,t1,presidential
16703,59,NORD,87210,67390,1115,66275,2012,t1,presidential
16704,59,NORD,96461,73377,1266,72111,2012,t1,presidential
16705,59,NORD,97081,75692,1161,74531,2012,t1,presidential
16706,59,NORD,96321,78226,1452,76774,2012,t1,presidential
16707,59,NORD,84619,70934,1139,69795,2012,t1,presidential
16708,59,NORD,72067,55243,867,54376,2012,t1,presidential
16709,59,NORD,69238,48813,840,47973,2012,t1,presidential
16710,59,NORD,89146,67938,980,66958,2012,t1,presidential
16711,59,NORD,80282,59271,1136,58135,2012,t1,presidential
16712,59,NORD,90333,69151,1093,68058,2012,t1,presidential
16713,59,NORD,93655,75064,1281,73783,2012,t1,presidential
16714,59,NORD,90479,69953,1654,68299,2012,t1,presidential
16715,59,NORD,98692,81002,1576,79426,2012,t1,presidential
16716,59,NORD,95256,78118,1636,76482,2012,t1,presidential
16717,59,NORD,83552,65432,1161,64271,2012,t1,presidential
16718,59,NORD,74984,58735,963,57772,2012,t1,presidential
16719,59,NORD,91923,72432,1452,70980,2012,t1,presidential
16720,59,NORD,78813,61724,1093,60631,2012,t1,presidential
16721,59,NORD,80776,60546,1149,59397,2012,t1,presidential
16722,59,NORD,81037,62221,1061,61160,2012,t1,presidential
16723,60,OISE,80708,65798,1194,64604,2012,t1,presidential
16724,60,OISE,85945,70551,1229,69322,2012,t1,presidential
16725,60,OISE,71230,56639,941,55698,2012,t1,presidential
16726,60,OISE,90018,72829,1129,71700,2012,t1,presidential
16727,60,OISE,71315,57388,958,56430,2012,t1,presidential
16728,60,OISE,74639,59857,1010,58847,2012,t1,presidential
16729,60,OISE,74990,61141,1773,59368,2012,t1,presidential
16730,61,ORNE,71172,59010,1192,57818,2012,t1,presidential
16731,61,ORNE,68817,57161,1036,56125,2012,t1,presidential
16732,61,ORNE,72532,60972,1161,59811,2012,t1,presidential
16733,62,PAS-DE-CALAIS,103048,87464,1657,85807,2012,t1,presidential
16734,62,PAS-DE-CALAIS,84252,69628,1432,68196,2012,t1,presidential
16735,62,PAS-DE-CALAIS,87303,65717,1348,64369,2012,t1,presidential
16736,62,PAS-DE-CALAIS,87406,72111,1406,70705,2012,t1,presidential
16737,62,PAS-DE-CALAIS,89811,70843,1057,69786,2012,t1,presidential
16738,62,PAS-DE-CALAIS,88973,75847,1453,74394,2012,t1,presidential
16739,62,PAS-DE-CALAIS,92272,71177,1283,69894,2012,t1,presidential
16740,62,PAS-DE-CALAIS,93137,74934,1454,73480,2012,t1,presidential
16741,62,PAS-DE-CALAIS,79240,63663,1161,62502,2012,t1,presidential
16742,62,PAS-DE-CALAIS,89751,68887,1388,67499,2012,t1,presidential
16743,62,PAS-DE-CALAIS,94027,71650,1358,70292,2012,t1,presidential
16744,62,PAS-DE-CALAIS,94508,73640,1425,72215,2012,t1,presidential
16745,63,PUY-DE-DOME,80416,66080,1287,64793,2012,t1,presidential
16746,63,PUY-DE-DOME,86266,73391,1747,71644,2012,t1,presidential
16747,63,PUY-DE-DOME,86752,72512,1467,71045,2012,t1,presidential
16748,63,PUY-DE-DOME,95438,81119,1689,79430,2012,t1,presidential
16749,63,PUY-DE-DOME,100375,84564,2032,82532,2012,t1,presidential
16750,64,PYRENEES-ATLANTIQUES,68872,55639,952,54687,2012,t1,presidential
16751,64,PYRENEES-ATLANTIQUES,77655,65189,1229,63960,2012,t1,presidential
16752,64,PYRENEES-ATLANTIQUES,81932,68977,1342,67635,2012,t1,presidential
16753,64,PYRENEES-ATLANTIQUES,80359,67433,1440,65993,2012,t1,presidential
16754,64,PYRENEES-ATLANTIQUES,85472,68811,2046,66765,2012,t1,presidential
16755,64,PYRENEES-ATLANTIQUES,94656,76109,1492,74617,2012,t1,presidential
16756,65,HAUTES-PYRENEES,88416,72910,1516,71394,2012,t1,presidential
16757,65,HAUTES-PYRENEES,89001,74763,1453,73310,2012,t1,presidential
16758,66,PYRENEES-ORIENTALES,67579,54072,904,53168,2012,t1,presidential
16759,66,PYRENEES-ORIENTALES,89162,73800,1319,72481,2012,t1,presidential
16760,66,PYRENEES-ORIENTALES,80154,65163,1297,63866,2012,t1,presidential
16761,66,PYRENEES-ORIENTALES,92348,76271,1592,74679,2012,t1,presidential
16762,67,BAS-RHIN,63853,48676,571,48105,2012,t1,presidential
16763,67,BAS-RHIN,71121,53772,808,52964,2012,t1,presidential
16764,67,BAS-RHIN,68309,52379,799,51580,2012,t1,presidential
16765,67,BAS-RHIN,89817,73495,1181,72314,2012,t1,presidential
16766,67,BAS-RHIN,98393,80096,1727,78369,2012,t1,presidential
16767,67,BAS-RHIN,91107,74426,1454,72972,2012,t1,presidential
16768,67,BAS-RHIN,84580,68915,1446,67469,2012,t1,presidential
16769,67,BAS-RHIN,92698,74255,1929,72326,2012,t1,presidential
16770,67,BAS-RHIN,88209,71169,1336,69833,2012,t1,presidential
16771,68,HAUT-RHIN,74637,58520,1061,57459,2012,t1,presidential
16772,68,HAUT-RHIN,91283,74356,1499,72857,2012,t1,presidential
16773,68,HAUT-RHIN,83595,67676,1328,66348,2012,t1,presidential
16774,68,HAUT-RHIN,99218,81159,1686,79473,2012,t1,presidential
16775,68,HAUT-RHIN,79642,59972,1333,58639,2012,t1,presidential
16776,68,HAUT-RHIN,92799,72125,1490,70635,2012,t1,presidential
16777,69,RHONE,68034,53667,749,52918,2012,t1,presidential
16778,69,RHONE,74861,59751,765,58986,2012,t1,presidential
16779,69,RHONE,70269,55982,741,55241,2012,t1,presidential
16780,69,RHONE,79705,63928,859,63069,2012,t1,presidential
16781,69,RHONE,80421,68153,992,67161,2012,t1,presidential
16782,69,RHONE,78307,62186,978,61208,2012,t1,presidential
16783,69,RHONE,64610,49471,835,48636,2012,t1,presidential
16784,69,RHONE,98374,82887,1360,81527,2012,t1,presidential
16785,69,RHONE,85755,71282,1345,69937,2012,t1,presidential
16786,69,RHONE,89479,75936,1350,74586,2012,t1,presidential
16787,69,RHONE,85346,72019,1295,70724,2012,t1,presidential
16788,69,RHONE,76108,63430,843,62587,2012,t1,presidential
16789,69,RHONE,79390,65013,1096,63917,2012,t1,presidential
16790,69,RHONE,69973,54179,1025,53154,2012,t1,presidential
16791,70,HAUTE-SAONE,88775,74408,1680,72728,2012,t1,presidential
16792,70,HAUTE-SAONE,91871,75810,2002,73808,2012,t1,presidential
16793,71,SAONE-ET-LOIRE,72494,58631,1257,57374,2012,t1,presidential
16794,71,SAONE-ET-LOIRE,81318,66681,1736,64945,2012,t1,presidential
16795,71,SAONE-ET-LOIRE,83710,68565,1538,67027,2012,t1,presidential
16796,71,SAONE-ET-LOIRE,81210,66443,1518,64925,2012,t1,presidential
16797,71,SAONE-ET-LOIRE,91255,72090,1535,70555,2012,t1,presidential
16798,72,SARTHE,72544,59491,1381,58110,2012,t1,presidential
16799,72,SARTHE,83308,66574,1612,64962,2012,t1,presidential
16800,72,SARTHE,84790,70767,1806,68961,2012,t1,presidential
16801,72,SARTHE,78821,65541,1638,63903,2012,t1,presidential
16802,72,SARTHE,87395,71962,1796,70166,2012,t1,presidential
16803,73,SAVOIE,82082,68581,1278,67303,2012,t1,presidential
16804,73,SAVOIE,74896,61299,1574,59725,2012,t1,presidential
16805,73,SAVOIE,70313,59046,1133,57913,2012,t1,presidential
16806,73,SAVOIE,71494,59321,1147,58174,2012,t1,presidential
16807,74,HAUTE-SAVOIE,93012,77985,1312,76673,2012,t1,presidential
16808,74,HAUTE-SAVOIE,90282,74658,1229,73429,2012,t1,presidential
16809,74,HAUTE-SAVOIE,75148,62334,1273,61061,2012,t1,presidential
16810,74,HAUTE-SAVOIE,80428,62295,1053,61242,2012,t1,presidential
16811,74,HAUTE-SAVOIE,89879,71665,1398,70267,2012,t1,presidential
16812,74,HAUTE-SAVOIE,75925,60421,1078,59343,2012,t1,presidential
16813,75,PARIS,76628,61565,686,60879,2012,t1,presidential
16814,75,PARIS,71232,58073,617,57456,2012,t1,presidential
16815,75,PARIS,64992,51624,649,50975,2012,t1,presidential
16816,75,PARIS,67284,54077,553,53524,2012,t1,presidential
16817,75,PARIS,70913,57085,628,56457,2012,t1,presidential
16818,75,PARIS,73259,59094,743,58351,2012,t1,presidential
16819,75,PARIS,72442,58967,645,58322,2012,t1,presidential
16820,75,PARIS,80126,64554,824,63730,2012,t1,presidential
16821,75,PARIS,66549,53153,789,52364,2012,t1,presidential
16822,75,PARIS,66673,52996,755,52241,2012,t1,presidential
16823,75,PARIS,69509,56747,673,56074,2012,t1,presidential
16824,75,PARIS,71250,57835,647,57188,2012,t1,presidential
16825,75,PARIS,72571,58505,716,57789,2012,t1,presidential
16826,75,PARIS,69857,56359,487,55872,2012,t1,presidential
16827,75,PARIS,73917,58533,788,57745,2012,t1,presidential
16828,75,PARIS,66160,51633,614,51019,2012,t1,presidential
16829,75,PARIS,54982,42079,664,41415,2012,t1,presidential
16830,75,PARIS,64978,51688,615,51073,2012,t1,presidential
16831,76,SEINE-MARITIME,64685,51533,763,50770,2012,t1,presidential
16832,76,SEINE-MARITIME,91321,76212,1272,74940,2012,t1,presidential
16833,76,SEINE-MARITIME,69191,55669,1012,54657,2012,t1,presidential
16834,76,SEINE-MARITIME,88898,71246,1436,69810,2012,t1,presidential
16835,76,SEINE-MARITIME,94019,77330,1406,75924,2012,t1,presidential
16836,76,SEINE-MARITIME,110282,89839,1695,88144,2012,t1,presidential
16837,76,SEINE-MARITIME,89140,69536,1536,68000,2012,t1,presidential
16838,76,SEINE-MARITIME,70437,51384,1214,50170,2012,t1,presidential
16839,76,SEINE-MARITIME,92335,76561,1485,75076,2012,t1,presidential
16840,76,SEINE-MARITIME,105857,89561,1651,87910,2012,t1,presidential
16841,77,SEINE-ET-MARNE,67656,52094,871,51223,2012,t1,presidential
16842,77,SEINE-ET-MARNE,78737,62498,1000,61498,2012,t1,presidential
16843,77,SEINE-ET-MARNE,72363,57890,1082,56808,2012,t1,presidential
16844,77,SEINE-ET-MARNE,85018,67943,1221,66722,2012,t1,presidential
16845,77,SEINE-ET-MARNE,78816,61799,1001,60798,2012,t1,presidential
16846,77,SEINE-ET-MARNE,73813,58029,1044,56985,2012,t1,presidential
16847,77,SEINE-ET-MARNE,81797,63250,1046,62204,2012,t1,presidential
16848,77,SEINE-ET-MARNE,82707,64022,1070,62952,2012,t1,presidential
16849,77,SEINE-ET-MARNE,82075,62998,1075,61923,2012,t1,presidential
16850,77,SEINE-ET-MARNE,78227,59253,1026,58227,2012,t1,presidential
16851,77,SEINE-ET-MARNE,62464,47500,1042,46458,2012,t1,presidential
16852,78,YVELINES,81999,64946,923,64023,2012,t1,presidential
16853,78,YVELINES,83055,66962,978,65984,2012,t1,presidential
16854,78,YVELINES,81513,64746,807,63939,2012,t1,presidential
16855,78,YVELINES,76770,60650,787,59863,2012,t1,presidential
16856,78,YVELINES,72022,55791,798,54993,2012,t1,presidential
16857,78,YVELINES,74012,56579,781,55798,2012,t1,presidential
16858,78,YVELINES,78349,61180,1004,60176,2012,t1,presidential
16859,78,YVELINES,71073,54330,1017,53313,2012,t1,presidential
16860,78,YVELINES,89222,70818,1201,69617,2012,t1,presidential
16861,78,YVELINES,86660,70873,1081,69792,2012,t1,presidential
16862,78,YVELINES,65593,50585,891,49694,2012,t1,presidential
16863,78,YVELINES,66351,52919,798,52121,2012,t1,presidential
16864,79,DEUX-SEVRES,88418,73218,1544,71674,2012,t1,presidential
16865,79,DEUX-SEVRES,97194,82148,1939,80209,2012,t1,presidential
16866,79,DEUX-SEVRES,85099,71749,1917,69832,2012,t1,presidential
16867,80,SOMME,84976,67384,1174,66210,2012,t1,presidential
16868,80,SOMME,74997,59332,940,58392,2012,t1,presidential
16869,80,SOMME,84633,71439,1461,69978,2012,t1,presidential
16870,80,SOMME,82862,69479,1290,68189,2012,t1,presidential
16871,80,SOMME,81976,67515,1147,66368,2012,t1,presidential
16872,81,TARN,83047,70654,1689,68965,2012,t1,presidential
16873,81,TARN,102399,87189,1804,85385,2012,t1,presidential
16874,81,TARN,98438,84217,1853,82364,2012,t1,presidential
16875,82,TARN-ET-GARONNE,86086,73010,1510,71500,2012,t1,presidential
16876,82,TARN-ET-GARONNE,89226,76000,1656,74344,2012,t1,presidential
16877,83,VAR,73565,57027,828,56199,2012,t1,presidential
16878,83,VAR,86851,69620,1199,68421,2012,t1,presidential
16879,83,VAR,97658,79076,1264,77812,2012,t1,presidential
16880,83,VAR,99243,81033,1268,79765,2012,t1,presidential
16881,83,VAR,90985,73676,1020,72656,2012,t1,presidential
16882,83,VAR,108002,88857,1402,87455,2012,t1,presidential
16883,83,VAR,101188,79820,1171,78649,2012,t1,presidential
16884,83,VAR,99688,81054,1281,79773,2012,t1,presidential
16885,84,VAUCLUSE,72365,57171,922,56249,2012,t1,presidential
16886,84,VAUCLUSE,80323,66670,1158,65512,2012,t1,presidential
16887,84,VAUCLUSE,70881,58761,954,57807,2012,t1,presidential
16888,84,VAUCLUSE,86044,71119,1384,69735,2012,t1,presidential
16889,84,VAUCLUSE,78439,64714,1128,63586,2012,t1,presidential
16890,85,VENDEE,102054,87318,2071,85247,2012,t1,presidential
16891,85,VENDEE,97819,83817,1914,81903,2012,t1,presidential
16892,85,VENDEE,113883,94958,1863,93095,2012,t1,presidential
16893,85,VENDEE,94459,82666,2317,80349,2012,t1,presidential
16894,85,VENDEE,80604,68342,1552,66790,2012,t1,presidential
16895,86,VIENNE,77162,63850,1248,62602,2012,t1,presidential
16896,86,VIENNE,75551,62804,1190,61614,2012,t1,presidential
16897,86,VIENNE,74858,62934,1506,61428,2012,t1,presidential
16898,86,VIENNE,76082,61508,1462,60046,2012,t1,presidential
16899,87,HAUTE-VIENNE,84655,71042,1501,69541,2012,t1,presidential
16900,87,HAUTE-VIENNE,96684,82588,1874,80714,2012,t1,presidential
16901,87,HAUTE-VIENNE,83575,70259,2575,67684,2012,t1,presidential
16902,88,VOSGES,76569,62273,1335,60938,2012,t1,presidential
16903,88,VOSGES,74246,60521,1337,59184,2012,t1,presidential
16904,88,VOSGES,66692,55194,1390,53804,2012,t1,presidential
16905,88,VOSGES,67903,56088,1112,54976,2012,t1,presidential
16906,89,YONNE,78386,63983,1166,62817,2012,t1,presidential
16907,89,YONNE,77724,63313,1078,62235,2012,t1,presidential
16908,89,YONNE,89148,70727,1303,69424,2012,t1,presidential
16909,90,TERRITOIRE DE BELFORT,47161,38142,754,37388,2012,t1,presidential
16910,90,TERRITOIRE DE BELFORT,47728,38365,830,37535,2012,t1,presidential
16911,91,ESSONNE,70316,52583,1009,51574,2012,t1,presidential
16912,91,ESSONNE,87069,70394,1275,69119,2012,t1,presidential
16913,91,ESSONNE,91957,74010,1247,72763,2012,t1,presidential
16914,91,ESSONNE,92043,74448,1218,73230,2012,t1,presidential
16915,91,ESSONNE,66536,54192,789,53403,2012,t1,presidential
16916,91,ESSONNE,76035,60383,981,59402,2012,t1,presidential
16917,91,ESSONNE,71597,56035,1013,55022,2012,t1,presidential
16918,91,ESSONNE,75214,59131,776,58355,2012,t1,presidential
16919,91,ESSONNE,75942,59898,1010,58888,2012,t1,presidential
16920,91,ESSONNE,60583,46454,959,45495,2012,t1,presidential
16921,92,HAUTS-DE-SEINE,59623,44540,922,43618,2012,t1,presidential
16922,92,HAUTS-DE-SEINE,63482,50513,687,49826,2012,t1,presidential
16923,92,HAUTS-DE-SEINE,76507,59994,982,59012,2012,t1,presidential
16924,92,HAUTS-DE-SEINE,70765,55220,1079,54141,2012,t1,presidential
16925,92,HAUTS-DE-SEINE,68723,54641,812,53829,2012,t1,presidential
16926,92,HAUTS-DE-SEINE,73307,59861,869,58992,2012,t1,presidential
16927,92,HAUTS-DE-SEINE,83746,67176,900,66276,2012,t1,presidential
16928,92,HAUTS-DE-SEINE,66906,53810,792,53018,2012,t1,presidential
16929,92,HAUTS-DE-SEINE,60995,49092,686,48406,2012,t1,presidential
16930,92,HAUTS-DE-SEINE,71664,56578,868,55710,2012,t1,presidential
16931,92,HAUTS-DE-SEINE,67311,52935,777,52158,2012,t1,presidential
16932,92,HAUTS-DE-SEINE,89771,71823,1103,70720,2012,t1,presidential
16933,92,HAUTS-DE-SEINE,85738,69195,1249,67946,2012,t1,presidential
16934,93,SEINE-SAINT-DENIS,55097,39727,682,39045,2012,t1,presidential
16935,93,SEINE-SAINT-DENIS,51694,35979,723,35256,2012,t1,presidential
16936,93,SEINE-SAINT-DENIS,70622,54551,994,53557,2012,t1,presidential
16937,93,SEINE-SAINT-DENIS,60063,42890,1050,41840,2012,t1,presidential
16938,93,SEINE-SAINT-DENIS,62178,44121,849,43272,2012,t1,presidential
16939,93,SEINE-SAINT-DENIS,49896,36149,681,35468,2012,t1,presidential
16940,93,SEINE-SAINT-DENIS,71196,52173,800,51373,2012,t1,presidential
16941,93,SEINE-SAINT-DENIS,60079,46010,918,45092,2012,t1,presidential
16942,93,SEINE-SAINT-DENIS,66448,49827,815,49012,2012,t1,presidential
16943,93,SEINE-SAINT-DENIS,66951,49204,900,48304,2012,t1,presidential
16944,93,SEINE-SAINT-DENIS,61966,45167,914,44253,2012,t1,presidential
16945,93,SEINE-SAINT-DENIS,64346,48221,778,47443,2012,t1,presidential
16946,94,VAL-DE-MARNE,82541,65591,955,64636,2012,t1,presidential
16947,94,VAL-DE-MARNE,64960,50033,924,49109,2012,t1,presidential
16948,94,VAL-DE-MARNE,70692,54378,950,53428,2012,t1,presidential
16949,94,VAL-DE-MARNE,71770,56516,935,55581,2012,t1,presidential
16950,94,VAL-DE-MARNE,85891,65441,935,64506,2012,t1,presidential
16951,94,VAL-DE-MARNE,77865,61608,757,60851,2012,t1,presidential
16952,94,VAL-DE-MARNE,63673,49559,842,48717,2012,t1,presidential
16953,94,VAL-DE-MARNE,73706,58226,876,57350,2012,t1,presidential
16954,94,VAL-DE-MARNE,53275,40161,765,39396,2012,t1,presidential
16955,94,VAL-DE-MARNE,63291,48020,782,47238,2012,t1,presidential
16956,94,VAL-DE-MARNE,59907,45330,780,44550,2012,t1,presidential
16957,95,VAL-D'OISE,78589,63218,1074,62144,2012,t1,presidential
16958,95,VAL-D'OISE,73354,58297,1011,57286,2012,t1,presidential
16959,95,VAL-D'OISE,87927,67836,1151,66685,2012,t1,presidential
16960,95,VAL-D'OISE,72471,56382,907,55475,2012,t1,presidential
16961,95,VAL-D'OISE,67998,50070,916,49154,2012,t1,presidential
16962,95,VAL-D'OISE,74545,56944,909,56035,2012,t1,presidential
16963,95,VAL-D'OISE,67663,52317,853,51464,2012,t1,presidential
16964,95,VAL-D'OISE,52049,37765,862,36903,2012,t1,presidential
16965,95,VAL-D'OISE,67551,51341,1063,50278,2012,t1,presidential
16966,95,VAL-D'OISE,62663,48297,1006,47291,2012,t1,presidential
16967,971,GUADELOUPE,72685,37457,2915,34542,2012,t1,presidential
16968,971,GUADELOUPE,81396,42164,2970,39194,2012,t1,presidential
16969,971,GUADELOUPE,76834,40210,2676,37534,2012,t1,presidential
16970,971,GUADELOUPE,67193,36692,2803,33889,2012,t1,presidential
16971,972,MARTINIQUE,76407,42456,3579,38877,2012,t1,presidential
16972,972,MARTINIQUE,81656,44259,3422,40837,2012,t1,presidential
16973,972,MARTINIQUE,65906,33126,2679,30447,2012,t1,presidential
16974,972,MARTINIQUE,78934,38936,2827,36109,2012,t1,presidential
16975,973,GUYANE,46084,24412,1092,23320,2012,t1,presidential
16976,973,GUYANE,30790,14756,664,14092,2012,t1,presidential
16977,974,LA REUNION,73748,48384,1512,46872,2012,t1,presidential
16978,974,LA REUNION,83925,54711,2447,52264,2012,t1,presidential
16979,974,LA REUNION,83635,55970,2629,53341,2012,t1,presidential
16980,974,LA REUNION,94808,65671,2687,62984,2012,t1,presidential
16981,974,LA REUNION,75680,46884,1740,45144,2012,t1,presidential
16982,974,LA REUNION,67693,42638,1556,41082,2012,t1,presidential
16983,974,LA REUNION,98920,65130,2732,62398,2012,t1,presidential
16984,975,SAINT-PIERRE-ET-MIQUELON,4923,2730,99,2631,2012,t1,presidential
16985,979,SAINT-BARTHELEMY et SAINT-MARTIN,22685,8277,244,8033,2012,t1,presidential
16986,985,MAYOTTE,35496,16493,736,15757,2012,t1,presidential
16987,985,MAYOTTE,41917,21189,963,20226,2012,t1,presidential
16988,986,WALLIS ET FUTUNA,8940,6446,39,6407,2012,t1,presidential
16989,987,POLYNESIE FRANCAISE,67166,33759,788,32971,2012,t1,presidential
16990,987,POLYNESIE FRANCAISE,59397,28233,722,27511,2012,t1,presidential
16991,987,POLYNESIE FRANCAISE,60079,30108,771,29337,2012,t1,presidential
16992,988,NOUVELLE-CALEDONIE,76323,42230,881,41349,2012,t1,presidential
16993,988,NOUVELLE-CALEDONIE,89144,49398,1488,47910,2012,t1,presidential
16994,99,FRANCAIS DE L'ETRANGER,157767,52936,542,52394,2012,t1,presidential
16995,99,FRANCAIS DE L'ETRANGER,73912,21264,363,20901,2012,t1,presidential
16996,99,FRANCAIS DE L'ETRANGER,88133,28410,269,28141,2012,t1,presidential
16997,99,FRANCAIS DE L'ETRANGER,95182,48202,432,47770,2012,t1,presidential
16998,99,FRANCAIS DE L'ETRANGER,80761,27546,305,27241,2012,t1,presidential
16999,99,FRANCAIS DE L'ETRANGER,79508,50050,514,49536,2012,t1,presidential
17000,99,FRANCAIS DE L'ETRANGER,89643,34662,318,34344,2012,t1,presidential
17001,99,FRANCAIS DE L'ETRANGER,109763,25297,292,25005,2012,t1,presidential
17002,99,FRANCAIS DE L'ETRANGER,98997,39110,321,38789,2012,t1,presidential
17003,99,FRANCAIS DE L'ETRANGER,89859,43077,566,42511,2012,t1,presidential
17004,99,FRANCAIS DE L'ETRANGER,80061,37150,488,36662,2012,t1,presidential
17005,1,AIN,80534,51255,897,50358,2002,t1,legislative
17006,1,AIN,83249,51480,941,50539,2002,t1,legislative
17007,1,AIN,77413,47487,1202,46285,2002,t1,legislative
17008,1,AIN,98271,62404,1072,61332,2002,t1,legislative
17009,2,AISNE,70129,44478,984,43494,2002,t1,legislative
17010,2,AISNE,73010,47915,861,47054,2002,t1,legislative
17011,2,AISNE,72659,46162,1084,45078,2002,t1,legislative
17012,2,AISNE,76158,47010,828,46182,2002,t1,legislative
17013,2,AISNE,75534,48661,979,47682,2002,t1,legislative
17014,3,ALLIER,57895,37997,1108,36889,2002,t1,legislative
17015,3,ALLIER,65653,43770,1018,42752,2002,t1,legislative
17016,3,ALLIER,70148,47750,1396,46354,2002,t1,legislative
17017,3,ALLIER,62826,42101,866,41235,2002,t1,legislative
17018,4,ALPES-DE-HAUTE-PROVENCE,53751,36443,937,35506,2002,t1,legislative
17019,4,ALPES-DE-HAUTE-PROVENCE,55411,38166,864,37302,2002,t1,legislative
17020,5,HAUTES-ALPES,52844,36654,871,35783,2002,t1,legislative
17021,5,HAUTES-ALPES,42515,28463,631,27832,2002,t1,legislative
17022,6,ALPES-MARITIMES,61562,34487,557,33930,2002,t1,legislative
17023,6,ALPES-MARITIMES,67362,37648,484,37164,2002,t1,legislative
17024,6,ALPES-MARITIMES,72483,40590,626,39964,2002,t1,legislative
17025,6,ALPES-MARITIMES,70356,43329,721,42608,2002,t1,legislative
17026,6,ALPES-MARITIMES,83399,51457,985,50472,2002,t1,legislative
17027,6,ALPES-MARITIMES,95021,60801,940,59861,2002,t1,legislative
17028,6,ALPES-MARITIMES,89600,56751,800,55951,2002,t1,legislative
17029,6,ALPES-MARITIMES,60983,38341,464,37877,2002,t1,legislative
17030,6,ALPES-MARITIMES,94753,61730,669,61061,2002,t1,legislative
17031,7,ARDECHE,68981,47496,912,46584,2002,t1,legislative
17032,7,ARDECHE,83133,55349,1054,54295,2002,t1,legislative
17033,7,ARDECHE,68130,47618,935,46683,2002,t1,legislative
17034,8,ARDENNES,70398,43857,848,43009,2002,t1,legislative
17035,8,ARDENNES,64159,38155,696,37459,2002,t1,legislative
17036,8,ARDENNES,58179,37611,517,37094,2002,t1,legislative
17037,9,ARIEGE,54069,36794,1267,35527,2002,t1,legislative
17038,9,ARIEGE,55180,38519,1059,37460,2002,t1,legislative
17039,10,AUBE,55575,35612,816,34796,2002,t1,legislative
17040,10,AUBE,68838,44159,888,43271,2002,t1,legislative
17041,10,AUBE,69854,44024,787,43237,2002,t1,legislative
17042,11,AUDE,65699,46037,1216,44821,2002,t1,legislative
17043,11,AUDE,99726,67405,1619,65786,2002,t1,legislative
17044,11,AUDE,71661,51161,1530,49631,2002,t1,legislative
17045,12,AVEYRON,72568,51716,1387,50329,2002,t1,legislative
17046,12,AVEYRON,71863,50838,1807,49031,2002,t1,legislative
17047,12,AVEYRON,70276,52455,1495,50960,2002,t1,legislative
17048,13,BOUCHES-DU-RHONE,55174,35358,529,34829,2002,t1,legislative
17049,13,BOUCHES-DU-RHONE,58400,39228,393,38835,2002,t1,legislative
17050,13,BOUCHES-DU-RHONE,43103,26387,370,26017,2002,t1,legislative
17051,13,BOUCHES-DU-RHONE,42843,24163,330,23833,2002,t1,legislative
17052,13,BOUCHES-DU-RHONE,47853,30206,443,29763,2002,t1,legislative
17053,13,BOUCHES-DU-RHONE,63494,40111,628,39483,2002,t1,legislative
17054,13,BOUCHES-DU-RHONE,46649,26871,454,26417,2002,t1,legislative
17055,13,BOUCHES-DU-RHONE,64346,39934,691,39243,2002,t1,legislative
17056,13,BOUCHES-DU-RHONE,83557,53436,1024,52412,2002,t1,legislative
17057,13,BOUCHES-DU-RHONE,112115,73544,1095,72449,2002,t1,legislative
17058,13,BOUCHES-DU-RHONE,88360,57698,1113,56585,2002,t1,legislative
17059,13,BOUCHES-DU-RHONE,100030,62733,1325,61408,2002,t1,legislative
17060,13,BOUCHES-DU-RHONE,83418,53225,1347,51878,2002,t1,legislative
17061,13,BOUCHES-DU-RHONE,91027,60571,1062,59509,2002,t1,legislative
17062,13,BOUCHES-DU-RHONE,90035,59810,1298,58512,2002,t1,legislative
17063,13,BOUCHES-DU-RHONE,79408,50087,1151,48936,2002,t1,legislative
17064,14,CALVADOS,69518,43547,636,42911,2002,t1,legislative
17065,14,CALVADOS,64788,39691,811,38880,2002,t1,legislative
17066,14,CALVADOS,71637,44847,1048,43799,2002,t1,legislative
17067,14,CALVADOS,75610,48723,784,47939,2002,t1,legislative
17068,14,CALVADOS,94414,59987,1190,58797,2002,t1,legislative
17069,14,CALVADOS,83595,55369,1279,54090,2002,t1,legislative
17070,15,CANTAL,64056,44777,1118,43659,2002,t1,legislative
17071,15,CANTAL,59842,40453,692,39761,2002,t1,legislative
17072,16,CHARENTE,62611,40472,919,39553,2002,t1,legislative
17073,16,CHARENTE,60816,39497,782,38715,2002,t1,legislative
17074,16,CHARENTE,69349,47617,1401,46216,2002,t1,legislative
17075,16,CHARENTE,62747,41121,941,40180,2002,t1,legislative
17076,17,CHARENTE-MARITIME,87546,57675,736,56939,2002,t1,legislative
17077,17,CHARENTE-MARITIME,83252,53089,1154,51935,2002,t1,legislative
17078,17,CHARENTE-MARITIME,76492,50074,1194,48880,2002,t1,legislative
17079,17,CHARENTE-MARITIME,81865,53007,1252,51755,2002,t1,legislative
17080,17,CHARENTE-MARITIME,89676,58135,1106,57029,2002,t1,legislative
17081,18,CHER,74219,48109,1282,46827,2002,t1,legislative
17082,18,CHER,68845,42669,1186,41483,2002,t1,legislative
17083,18,CHER,85526,56023,1388,54635,2002,t1,legislative
17084,19,CORREZE,65482,51090,1268,49822,2002,t1,legislative
17085,19,CORREZE,66326,47206,1298,45908,2002,t1,legislative
17086,19,CORREZE,52536,39977,1128,38849,2002,t1,legislative
17087,21,COTE-D'OR,63487,44023,613,43410,2002,t1,legislative
17088,21,COTE-D'OR,58516,38882,638,38244,2002,t1,legislative
17089,21,COTE-D'OR,63336,40322,752,39570,2002,t1,legislative
17090,21,COTE-D'OR,68471,45827,932,44895,2002,t1,legislative
17091,21,COTE-D'OR,77586,50867,937,49930,2002,t1,legislative
17092,22,COTES-D'ARMOR,83820,56812,1018,55794,2002,t1,legislative
17093,22,COTES-D'ARMOR,86082,60747,1413,59334,2002,t1,legislative
17094,22,COTES-D'ARMOR,83319,59674,1199,58475,2002,t1,legislative
17095,22,COTES-D'ARMOR,79125,55965,1187,54778,2002,t1,legislative
17096,22,COTES-D'ARMOR,97517,67500,1160,66340,2002,t1,legislative
17097,23,CREUSE,51316,34559,876,33683,2002,t1,legislative
17098,23,CREUSE,50509,35119,1098,34021,2002,t1,legislative
17099,24,DORDOGNE,72869,51136,1606,49530,2002,t1,legislative
17100,24,DORDOGNE,77503,54118,1424,52694,2002,t1,legislative
17101,24,DORDOGNE,71072,53195,1548,51647,2002,t1,legislative
17102,24,DORDOGNE,82999,61062,1540,59522,2002,t1,legislative
17103,25,DOUBS,65445,44041,939,43102,2002,t1,legislative
17104,25,DOUBS,69931,47963,902,47061,2002,t1,legislative
17105,25,DOUBS,64363,42677,1157,41520,2002,t1,legislative
17106,25,DOUBS,65602,42107,1039,41068,2002,t1,legislative
17107,25,DOUBS,70532,46834,1597,45237,2002,t1,legislative
17108,26,DROME,68306,44289,623,43666,2002,t1,legislative
17109,26,DROME,74518,49207,926,48281,2002,t1,legislative
17110,26,DROME,90338,62558,1232,61326,2002,t1,legislative
17111,26,DROME,77567,51238,892,50346,2002,t1,legislative
17112,27,EURE,78277,49533,829,48704,2002,t1,legislative
17113,27,EURE,70251,45368,1192,44176,2002,t1,legislative
17114,27,EURE,73323,48772,887,47885,2002,t1,legislative
17115,27,EURE,77245,48528,1138,47390,2002,t1,legislative
17116,27,EURE,79700,50476,1155,49321,2002,t1,legislative
17117,28,EURE-ET-LOIR,78945,51405,946,50459,2002,t1,legislative
17118,28,EURE-ET-LOIR,64752,39657,833,38824,2002,t1,legislative
17119,28,EURE-ET-LOIR,69335,43903,1007,42896,2002,t1,legislative
17120,28,EURE-ET-LOIR,65630,44042,1107,42935,2002,t1,legislative
17121,29,FINISTERE,79422,55339,998,54341,2002,t1,legislative
17122,29,FINISTERE,68034,43667,494,43173,2002,t1,legislative
17123,29,FINISTERE,86632,57096,810,56286,2002,t1,legislative
17124,29,FINISTERE,78593,54449,838,53611,2002,t1,legislative
17125,29,FINISTERE,84570,57409,832,56577,2002,t1,legislative
17126,29,FINISTERE,85633,60686,781,59905,2002,t1,legislative
17127,29,FINISTERE,76691,52631,759,51872,2002,t1,legislative
17128,29,FINISTERE,77818,52246,931,51315,2002,t1,legislative
17129,2A,CORSE-DU-SUD,41176,24364,373,23991,2002,t1,legislative
17130,2A,CORSE-DU-SUD,45367,29053,608,28445,2002,t1,legislative
17131,2B,HAUTE-CORSE,47659,31825,535,31290,2002,t1,legislative
17132,2B,HAUTE-CORSE,57204,34424,577,33847,2002,t1,legislative
17133,30,GARD,77145,47265,951,46314,2002,t1,legislative
17134,30,GARD,102289,65335,1432,63903,2002,t1,legislative
17135,30,GARD,103250,69726,1498,68228,2002,t1,legislative
17136,30,GARD,79795,53316,1332,51984,2002,t1,legislative
17137,30,GARD,84438,56731,1641,55090,2002,t1,legislative
17138,31,HAUTE-GARONNE,64030,41489,645,40844,2002,t1,legislative
17139,31,HAUTE-GARONNE,99808,69798,1393,68405,2002,t1,legislative
17140,31,HAUTE-GARONNE,79039,56881,972,55909,2002,t1,legislative
17141,31,HAUTE-GARONNE,50341,32875,466,32409,2002,t1,legislative
17142,31,HAUTE-GARONNE,120117,83588,1951,81637,2002,t1,legislative
17143,31,HAUTE-GARONNE,113016,78102,1638,76464,2002,t1,legislative
17144,31,HAUTE-GARONNE,108007,77832,2078,75754,2002,t1,legislative
17145,31,HAUTE-GARONNE,79132,53946,1489,52457,2002,t1,legislative
17146,32,GERS,70237,49760,1451,48309,2002,t1,legislative
17147,32,GERS,65434,46836,1347,45489,2002,t1,legislative
17148,33,GIRONDE,72884,49212,672,48540,2002,t1,legislative
17149,33,GIRONDE,52179,34254,427,33827,2002,t1,legislative
17150,33,GIRONDE,64925,44366,761,43605,2002,t1,legislative
17151,33,GIRONDE,77010,49610,1067,48543,2002,t1,legislative
17152,33,GIRONDE,86129,57845,986,56859,2002,t1,legislative
17153,33,GIRONDE,80088,56292,845,55447,2002,t1,legislative
17154,33,GIRONDE,90668,62524,1111,61413,2002,t1,legislative
17155,33,GIRONDE,105638,72745,1190,71555,2002,t1,legislative
17156,33,GIRONDE,91084,63070,1302,61768,2002,t1,legislative
17157,33,GIRONDE,74283,50376,1064,49312,2002,t1,legislative
17158,33,GIRONDE,76125,50950,1066,49884,2002,t1,legislative
17159,34,HERAULT,67665,44655,889,43766,2002,t1,legislative
17160,34,HERAULT,57788,38118,675,37443,2002,t1,legislative
17161,34,HERAULT,114722,78307,1626,76681,2002,t1,legislative
17162,34,HERAULT,118966,81763,2013,79750,2002,t1,legislative
17163,34,HERAULT,88371,60325,1815,58510,2002,t1,legislative
17164,34,HERAULT,80288,51426,1183,50243,2002,t1,legislative
17165,34,HERAULT,107449,70496,1505,68991,2002,t1,legislative
17166,35,ILLE-ET-VILAINE,71900,44299,641,43658,2002,t1,legislative
17167,35,ILLE-ET-VILAINE,90031,59823,1073,58750,2002,t1,legislative
17168,35,ILLE-ET-VILAINE,83468,55600,895,54705,2002,t1,legislative
17169,35,ILLE-ET-VILAINE,98887,64686,1256,63430,2002,t1,legislative
17170,35,ILLE-ET-VILAINE,108991,72592,1336,71256,2002,t1,legislative
17171,35,ILLE-ET-VILAINE,74105,49530,1345,48185,2002,t1,legislative
17172,35,ILLE-ET-VILAINE,93268,61028,1145,59883,2002,t1,legislative
17173,36,INDRE,55393,35918,1047,34871,2002,t1,legislative
17174,36,INDRE,64285,45102,1056,44046,2002,t1,legislative
17175,36,INDRE,57192,39655,1095,38560,2002,t1,legislative
17176,37,INDRE-ET-LOIRE,53768,32726,529,32197,2002,t1,legislative
17177,37,INDRE-ET-LOIRE,84815,56080,1412,54668,2002,t1,legislative
17178,37,INDRE-ET-LOIRE,87822,59405,1217,58188,2002,t1,legislative
17179,37,INDRE-ET-LOIRE,82137,52769,1250,51519,2002,t1,legislative
17180,37,INDRE-ET-LOIRE,73572,48623,1065,47558,2002,t1,legislative
17181,38,ISERE,74819,51709,582,51127,2002,t1,legislative
17182,38,ISERE,66002,42621,780,41841,2002,t1,legislative
17183,38,ISERE,54408,34886,539,34347,2002,t1,legislative
17184,38,ISERE,77881,51519,679,50840,2002,t1,legislative
17185,38,ISERE,83187,54946,857,54089,2002,t1,legislative
17186,38,ISERE,92619,56959,1109,55850,2002,t1,legislative
17187,38,ISERE,88419,56126,1279,54847,2002,t1,legislative
17188,38,ISERE,93862,59040,1249,57791,2002,t1,legislative
17189,38,ISERE,80436,52697,1007,51690,2002,t1,legislative
17190,39,JURA,62709,42310,971,41339,2002,t1,legislative
17191,39,JURA,53724,34154,886,33268,2002,t1,legislative
17192,39,JURA,65421,44213,1087,43126,2002,t1,legislative
17193,40,LANDES,84368,58788,1350,57438,2002,t1,legislative
17194,40,LANDES,95940,66357,1390,64967,2002,t1,legislative
17195,40,LANDES,79315,57822,1562,56260,2002,t1,legislative
17196,41,LOIR-ET-CHER,86801,56754,1178,55576,2002,t1,legislative
17197,41,LOIR-ET-CHER,76928,51830,1056,50774,2002,t1,legislative
17198,41,LOIR-ET-CHER,69373,46985,1201,45784,2002,t1,legislative
17199,42,LOIRE,66492,39926,637,39289,2002,t1,legislative
17200,42,LOIRE,50487,29324,402,28922,2002,t1,legislative
17201,42,LOIRE,75070,48188,685,47503,2002,t1,legislative
17202,42,LOIRE,67007,42319,824,41495,2002,t1,legislative
17203,42,LOIRE,68453,44041,781,43260,2002,t1,legislative
17204,42,LOIRE,65577,42356,1073,41283,2002,t1,legislative
17205,42,LOIRE,92517,59647,1214,58433,2002,t1,legislative
17206,43,HAUTE-LOIRE,87655,59377,1735,57642,2002,t1,legislative
17207,43,HAUTE-LOIRE,78904,53118,1471,51647,2002,t1,legislative
17208,44,LOIRE-ATLANTIQUE,69243,45332,584,44748,2002,t1,legislative
17209,44,LOIRE-ATLANTIQUE,76572,48757,539,48218,2002,t1,legislative
17210,44,LOIRE-ATLANTIQUE,81062,51954,792,51162,2002,t1,legislative
17211,44,LOIRE-ATLANTIQUE,74167,49514,839,48675,2002,t1,legislative
17212,44,LOIRE-ATLANTIQUE,104280,71073,1595,69478,2002,t1,legislative
17213,44,LOIRE-ATLANTIQUE,71030,47714,1102,46612,2002,t1,legislative
17214,44,LOIRE-ATLANTIQUE,94621,63914,929,62985,2002,t1,legislative
17215,44,LOIRE-ATLANTIQUE,72255,45223,894,44329,2002,t1,legislative
17216,44,LOIRE-ATLANTIQUE,86229,57487,1278,56209,2002,t1,legislative
17217,44,LOIRE-ATLANTIQUE,88698,61249,1205,60044,2002,t1,legislative
17218,45,LOIRET,77716,51681,916,50765,2002,t1,legislative
17219,45,LOIRET,77449,50440,1004,49436,2002,t1,legislative
17220,45,LOIRET,83338,54254,1330,52924,2002,t1,legislative
17221,45,LOIRET,88569,57372,1253,56119,2002,t1,legislative
17222,45,LOIRET,83704,55932,1267,54665,2002,t1,legislative
17223,46,LOT,65721,47241,1392,45849,2002,t1,legislative
17224,46,LOT,62734,45765,1493,44272,2002,t1,legislative
17225,47,LOT-ET-GARONNE,80206,54735,1384,53351,2002,t1,legislative
17226,47,LOT-ET-GARONNE,75530,52067,1532,50535,2002,t1,legislative
17227,47,LOT-ET-GARONNE,73607,51198,1224,49974,2002,t1,legislative
17228,48,LOZERE,31333,22420,535,21885,2002,t1,legislative
17229,48,LOZERE,27507,20054,584,19470,2002,t1,legislative
17230,49,MAINE-ET-LOIRE,75326,49915,1024,48891,2002,t1,legislative
17231,49,MAINE-ET-LOIRE,80043,53138,1574,51564,2002,t1,legislative
17232,49,MAINE-ET-LOIRE,64291,41288,1230,40058,2002,t1,legislative
17233,49,MAINE-ET-LOIRE,68675,44894,1000,43894,2002,t1,legislative
17234,49,MAINE-ET-LOIRE,70560,46642,1025,45617,2002,t1,legislative
17235,49,MAINE-ET-LOIRE,84647,56809,1606,55203,2002,t1,legislative
17236,49,MAINE-ET-LOIRE,68227,45917,1161,44756,2002,t1,legislative
17237,50,MANCHE,72275,45527,1122,44405,2002,t1,legislative
17238,50,MANCHE,75123,50331,1239,49092,2002,t1,legislative
17239,50,MANCHE,73408,47113,895,46218,2002,t1,legislative
17240,50,MANCHE,69380,43411,901,42510,2002,t1,legislative
17241,50,MANCHE,69138,42612,882,41730,2002,t1,legislative
17242,51,MARNE,56497,32977,438,32539,2002,t1,legislative
17243,51,MARNE,64859,39209,683,38526,2002,t1,legislative
17244,51,MARNE,62589,36576,713,35863,2002,t1,legislative
17245,51,MARNE,59356,36146,608,35538,2002,t1,legislative
17246,51,MARNE,62268,40251,649,39602,2002,t1,legislative
17247,51,MARNE,67350,40131,928,39203,2002,t1,legislative
17248,52,HAUTE-MARNE,77043,48034,1303,46731,2002,t1,legislative
17249,52,HAUTE-MARNE,66829,40338,898,39440,2002,t1,legislative
17250,53,MAYENNE,79033,51702,1284,50418,2002,t1,legislative
17251,53,MAYENNE,65042,41365,1341,40024,2002,t1,legislative
17252,53,MAYENNE,70367,46748,1502,45246,2002,t1,legislative
17253,54,MEURTHE-ET-MOSELLE,48585,29739,423,29316,2002,t1,legislative
17254,54,MEURTHE-ET-MOSELLE,74895,47077,753,46324,2002,t1,legislative
17255,54,MEURTHE-ET-MOSELLE,56593,35192,529,34663,2002,t1,legislative
17256,54,MEURTHE-ET-MOSELLE,74877,45684,1083,44601,2002,t1,legislative
17257,54,MEURTHE-ET-MOSELLE,70982,45360,996,44364,2002,t1,legislative
17258,54,MEURTHE-ET-MOSELLE,75216,44473,901,43572,2002,t1,legislative
17259,54,MEURTHE-ET-MOSELLE,69899,38655,678,37977,2002,t1,legislative
17260,55,MEUSE,78711,50331,1239,49092,2002,t1,legislative
17261,55,MEUSE,60711,37601,827,36774,2002,t1,legislative
17262,56,MORBIHAN,93416,63995,899,63096,2002,t1,legislative
17263,56,MORBIHAN,83495,56074,914,55160,2002,t1,legislative
17264,56,MORBIHAN,77377,53537,1234,52303,2002,t1,legislative
17265,56,MORBIHAN,82308,56254,843,55411,2002,t1,legislative
17266,56,MORBIHAN,80070,50172,939,49233,2002,t1,legislative
17267,56,MORBIHAN,83498,57915,1109,56806,2002,t1,legislative
17268,57,MOSELLE,70605,40165,718,39447,2002,t1,legislative
17269,57,MOSELLE,71690,41555,795,40760,2002,t1,legislative
17270,57,MOSELLE,69538,39887,771,39116,2002,t1,legislative
17271,57,MOSELLE,67943,41368,1205,40163,2002,t1,legislative
17272,57,MOSELLE,73938,41929,1054,40875,2002,t1,legislative
17273,57,MOSELLE,72347,36285,735,35550,2002,t1,legislative
17274,57,MOSELLE,76858,41274,1241,40033,2002,t1,legislative
17275,57,MOSELLE,72226,41047,872,40175,2002,t1,legislative
17276,57,MOSELLE,70980,38296,709,37587,2002,t1,legislative
17277,57,MOSELLE,69017,35125,795,34330,2002,t1,legislative
17278,58,NIEVRE,55372,34456,854,33602,2002,t1,legislative
17279,58,NIEVRE,59837,38428,997,37431,2002,t1,legislative
17280,58,NIEVRE,55367,36643,903,35740,2002,t1,legislative
17281,59,NORD,58435,31435,546,30889,2002,t1,legislative
17282,59,NORD,70938,43493,602,42891,2002,t1,legislative
17283,59,NORD,60044,35287,568,34719,2002,t1,legislative
17284,59,NORD,69835,42810,839,41971,2002,t1,legislative
17285,59,NORD,83592,52217,1318,50899,2002,t1,legislative
17286,59,NORD,76935,52119,1148,50971,2002,t1,legislative
17287,59,NORD,68409,38169,933,37236,2002,t1,legislative
17288,59,NORD,68057,36225,677,35548,2002,t1,legislative
17289,59,NORD,65480,39702,596,39106,2002,t1,legislative
17290,59,NORD,73773,42463,761,41702,2002,t1,legislative
17291,59,NORD,84290,52961,1165,51796,2002,t1,legislative
17292,59,NORD,69728,41085,1145,39940,2002,t1,legislative
17293,59,NORD,64968,41641,813,40828,2002,t1,legislative
17294,59,NORD,71435,48823,1268,47555,2002,t1,legislative
17295,59,NORD,71207,46525,1492,45033,2002,t1,legislative
17296,59,NORD,79861,48521,1253,47268,2002,t1,legislative
17297,59,NORD,73192,44416,856,43560,2002,t1,legislative
17298,59,NORD,77644,50390,966,49424,2002,t1,legislative
17299,59,NORD,77993,46107,1042,45065,2002,t1,legislative
17300,59,NORD,80477,47307,879,46428,2002,t1,legislative
17301,59,NORD,75098,45301,565,44736,2002,t1,legislative
17302,59,NORD,74213,48191,1139,47052,2002,t1,legislative
17303,59,NORD,67111,38997,682,38315,2002,t1,legislative
17304,59,NORD,64534,38863,741,38122,2002,t1,legislative
17305,60,OISE,74839,49049,1091,47958,2002,t1,legislative
17306,60,OISE,79718,51440,1427,50013,2002,t1,legislative
17307,60,OISE,64589,38767,894,37873,2002,t1,legislative
17308,60,OISE,83674,51840,963,50877,2002,t1,legislative
17309,60,OISE,65787,41748,642,41106,2002,t1,legislative
17310,60,OISE,69410,45629,802,44827,2002,t1,legislative
17311,60,OISE,69919,42598,960,41638,2002,t1,legislative
17312,61,ORNE,71444,47122,999,46123,2002,t1,legislative
17313,61,ORNE,69440,44751,926,43825,2002,t1,legislative
17314,61,ORNE,73576,48720,850,47870,2002,t1,legislative
17315,62,PAS-DE-CALAIS,77802,52780,1589,51191,2002,t1,legislative
17316,62,PAS-DE-CALAIS,73865,49585,1249,48336,2002,t1,legislative
17317,62,PAS-DE-CALAIS,73013,53064,1520,51544,2002,t1,legislative
17318,62,PAS-DE-CALAIS,76741,49224,1277,47947,2002,t1,legislative
17319,62,PAS-DE-CALAIS,63022,38265,941,37324,2002,t1,legislative
17320,62,PAS-DE-CALAIS,70581,42947,1174,41773,2002,t1,legislative
17321,62,PAS-DE-CALAIS,81260,47172,1392,45780,2002,t1,legislative
17322,62,PAS-DE-CALAIS,67261,45374,1406,43968,2002,t1,legislative
17323,62,PAS-DE-CALAIS,79657,52320,1535,50785,2002,t1,legislative
17324,62,PAS-DE-CALAIS,72038,42758,1580,41178,2002,t1,legislative
17325,62,PAS-DE-CALAIS,91864,56223,1835,54388,2002,t1,legislative
17326,62,PAS-DE-CALAIS,77668,45730,1585,44145,2002,t1,legislative
17327,62,PAS-DE-CALAIS,71606,43268,1073,42195,2002,t1,legislative
17328,62,PAS-DE-CALAIS,74065,44649,931,43718,2002,t1,legislative
17329,63,PUY-DE-DOME,58699,37065,765,36300,2002,t1,legislative
17330,63,PUY-DE-DOME,72693,48938,989,47949,2002,t1,legislative
17331,63,PUY-DE-DOME,71772,49300,912,48388,2002,t1,legislative
17332,63,PUY-DE-DOME,73661,50466,1133,49333,2002,t1,legislative
17333,63,PUY-DE-DOME,64969,43160,1218,41942,2002,t1,legislative
17334,63,PUY-DE-DOME,84923,58024,1527,56497,2002,t1,legislative
17335,64,PYRENEES-ATLANTIQUES,65499,44355,861,43494,2002,t1,legislative
17336,64,PYRENEES-ATLANTIQUES,69447,49902,1030,48872,2002,t1,legislative
17337,64,PYRENEES-ATLANTIQUES,76708,54627,1378,53249,2002,t1,legislative
17338,64,PYRENEES-ATLANTIQUES,78925,55325,1354,53971,2002,t1,legislative
17339,64,PYRENEES-ATLANTIQUES,76780,49869,1064,48805,2002,t1,legislative
17340,64,PYRENEES-ATLANTIQUES,85397,54416,1473,52943,2002,t1,legislative
17341,65,HAUTES-PYRENEES,59171,39743,1404,38339,2002,t1,legislative
17342,65,HAUTES-PYRENEES,60061,42082,1136,40946,2002,t1,legislative
17343,65,HAUTES-PYRENEES,50248,34704,2219,32485,2002,t1,legislative
17344,66,PYRENEES-ORIENTALES,58840,37927,899,37028,2002,t1,legislative
17345,66,PYRENEES-ORIENTALES,85493,55975,1344,54631,2002,t1,legislative
17346,66,PYRENEES-ORIENTALES,61699,40601,933,39668,2002,t1,legislative
17347,66,PYRENEES-ORIENTALES,80515,53493,1439,52054,2002,t1,legislative
17348,67,BAS-RHIN,49330,31099,288,30811,2002,t1,legislative
17349,67,BAS-RHIN,48370,28830,350,28480,2002,t1,legislative
17350,67,BAS-RHIN,61396,36282,438,35844,2002,t1,legislative
17351,67,BAS-RHIN,106733,63873,997,62876,2002,t1,legislative
17352,67,BAS-RHIN,92990,54695,1591,53104,2002,t1,legislative
17353,67,BAS-RHIN,75284,46169,1115,45054,2002,t1,legislative
17354,67,BAS-RHIN,78653,46361,1241,45120,2002,t1,legislative
17355,67,BAS-RHIN,68063,39590,1176,38414,2002,t1,legislative
17356,67,BAS-RHIN,97767,56488,1323,55165,2002,t1,legislative
17357,68,HAUT-RHIN,68320,41169,1007,40162,2002,t1,legislative
17358,68,HAUT-RHIN,71593,44110,1279,42831,2002,t1,legislative
17359,68,HAUT-RHIN,78403,50405,1013,49392,2002,t1,legislative
17360,68,HAUT-RHIN,68865,41180,671,40509,2002,t1,legislative
17361,68,HAUT-RHIN,51774,31049,472,30577,2002,t1,legislative
17362,68,HAUT-RHIN,70648,40213,1068,39145,2002,t1,legislative
17363,68,HAUT-RHIN,71089,43776,1032,42744,2002,t1,legislative
17364,69,RHONE,54623,36413,456,35957,2002,t1,legislative
17365,69,RHONE,62892,43218,468,42750,2002,t1,legislative
17366,69,RHONE,57264,38666,449,38217,2002,t1,legislative
17367,69,RHONE,63750,44547,545,44002,2002,t1,legislative
17368,69,RHONE,79104,53618,607,53011,2002,t1,legislative
17369,69,RHONE,63924,39522,597,38925,2002,t1,legislative
17370,69,RHONE,53432,32956,482,32474,2002,t1,legislative
17371,69,RHONE,76476,50608,877,49731,2002,t1,legislative
17372,69,RHONE,72649,46075,704,45371,2002,t1,legislative
17373,69,RHONE,81521,54779,836,53943,2002,t1,legislative
17374,69,RHONE,73201,47940,779,47161,2002,t1,legislative
17375,69,RHONE,68867,46292,542,45750,2002,t1,legislative
17376,69,RHONE,83188,52251,790,51461,2002,t1,legislative
17377,69,RHONE,46591,27010,533,26477,2002,t1,legislative
17378,70,HAUTE-SAONE,62041,42849,980,41869,2002,t1,legislative
17379,70,HAUTE-SAONE,61244,40478,1400,39078,2002,t1,legislative
17380,70,HAUTE-SAONE,51597,34677,1249,33428,2002,t1,legislative
17381,71,SAONE-ET-LOIRE,63263,40033,912,39121,2002,t1,legislative
17382,71,SAONE-ET-LOIRE,64604,42536,853,41683,2002,t1,legislative
17383,71,SAONE-ET-LOIRE,67609,43867,1280,42587,2002,t1,legislative
17384,71,SAONE-ET-LOIRE,61304,38385,1035,37350,2002,t1,legislative
17385,71,SAONE-ET-LOIRE,62324,39922,736,39186,2002,t1,legislative
17386,71,SAONE-ET-LOIRE,80482,52827,1283,51544,2002,t1,legislative
17387,72,SARTHE,68201,43941,1102,42839,2002,t1,legislative
17388,72,SARTHE,79492,48758,1312,47446,2002,t1,legislative
17389,72,SARTHE,80880,51535,1815,49720,2002,t1,legislative
17390,72,SARTHE,73858,47649,908,46741,2002,t1,legislative
17391,72,SARTHE,84051,53565,1478,52087,2002,t1,legislative
17392,73,SAVOIE,97902,63297,1044,62253,2002,t1,legislative
17393,73,SAVOIE,79193,48290,700,47590,2002,t1,legislative
17394,73,SAVOIE,89027,57147,893,56254,2002,t1,legislative
17395,74,HAUTE-SAVOIE,92173,59620,1169,58451,2002,t1,legislative
17396,74,HAUTE-SAVOIE,77549,49379,977,48402,2002,t1,legislative
17397,74,HAUTE-SAVOIE,78067,47382,650,46732,2002,t1,legislative
17398,74,HAUTE-SAVOIE,81139,48597,651,47946,2002,t1,legislative
17399,74,HAUTE-SAVOIE,95404,57842,1074,56768,2002,t1,legislative
17400,75,PARIS,54987,38948,374,38574,2002,t1,legislative
17401,75,PARIS,50573,37907,329,37578,2002,t1,legislative
17402,75,PARIS,41244,29214,177,29037,2002,t1,legislative
17403,75,PARIS,51076,35632,350,35282,2002,t1,legislative
17404,75,PARIS,41024,28223,308,27915,2002,t1,legislative
17405,75,PARIS,55329,38340,392,37948,2002,t1,legislative
17406,75,PARIS,55708,39481,416,39065,2002,t1,legislative
17407,75,PARIS,64202,45485,576,44909,2002,t1,legislative
17408,75,PARIS,53611,36529,729,35800,2002,t1,legislative
17409,75,PARIS,58341,42433,437,41996,2002,t1,legislative
17410,75,PARIS,53803,38359,394,37965,2002,t1,legislative
17411,75,PARIS,61209,44069,390,43679,2002,t1,legislative
17412,75,PARIS,63926,45192,452,44740,2002,t1,legislative
17413,75,PARIS,46015,31571,279,31292,2002,t1,legislative
17414,75,PARIS,38603,25531,227,25304,2002,t1,legislative
17415,75,PARIS,49709,35116,299,34817,2002,t1,legislative
17416,75,PARIS,48298,32320,413,31907,2002,t1,legislative
17417,75,PARIS,48673,33790,317,33473,2002,t1,legislative
17418,75,PARIS,40115,25803,380,25423,2002,t1,legislative
17419,75,PARIS,55008,36166,478,35688,2002,t1,legislative
17420,75,PARIS,63810,42799,514,42285,2002,t1,legislative
17421,76,SEINE-MARITIME,55341,35711,499,35212,2002,t1,legislative
17422,76,SEINE-MARITIME,83194,55121,986,54135,2002,t1,legislative
17423,76,SEINE-MARITIME,54309,33869,763,33106,2002,t1,legislative
17424,76,SEINE-MARITIME,70287,44071,851,43220,2002,t1,legislative
17425,76,SEINE-MARITIME,85401,54984,1174,53810,2002,t1,legislative
17426,76,SEINE-MARITIME,75909,47126,782,46344,2002,t1,legislative
17427,76,SEINE-MARITIME,58270,35863,568,35295,2002,t1,legislative
17428,76,SEINE-MARITIME,52613,28139,507,27632,2002,t1,legislative
17429,76,SEINE-MARITIME,81096,52649,1147,51502,2002,t1,legislative
17430,76,SEINE-MARITIME,80753,54411,1047,53364,2002,t1,legislative
17431,76,SEINE-MARITIME,73231,46715,1038,45677,2002,t1,legislative
17432,76,SEINE-MARITIME,70337,46900,879,46021,2002,t1,legislative
17433,77,SEINE-ET-MARNE,81321,50747,767,49980,2002,t1,legislative
17434,77,SEINE-ET-MARNE,72081,47207,697,46510,2002,t1,legislative
17435,77,SEINE-ET-MARNE,71055,45014,767,44247,2002,t1,legislative
17436,77,SEINE-ET-MARNE,76549,48550,1005,47545,2002,t1,legislative
17437,77,SEINE-ET-MARNE,81295,51169,841,50328,2002,t1,legislative
17438,77,SEINE-ET-MARNE,74341,46764,733,46031,2002,t1,legislative
17439,77,SEINE-ET-MARNE,81415,49821,683,49138,2002,t1,legislative
17440,77,SEINE-ET-MARNE,92542,57874,853,57021,2002,t1,legislative
17441,77,SEINE-ET-MARNE,94208,59492,987,58505,2002,t1,legislative
17442,78,YVELINES,83534,58289,622,57667,2002,t1,legislative
17443,78,YVELINES,73901,50726,609,50117,2002,t1,legislative
17444,78,YVELINES,65593,45382,555,44827,2002,t1,legislative
17445,78,YVELINES,69901,47412,575,46837,2002,t1,legislative
17446,78,YVELINES,64236,42888,397,42491,2002,t1,legislative
17447,78,YVELINES,56354,37625,367,37258,2002,t1,legislative
17448,78,YVELINES,68850,45538,565,44973,2002,t1,legislative
17449,78,YVELINES,59394,38172,623,37549,2002,t1,legislative
17450,78,YVELINES,78472,51218,897,50321,2002,t1,legislative
17451,78,YVELINES,95220,64595,939,63656,2002,t1,legislative
17452,78,YVELINES,52431,33075,464,32611,2002,t1,legislative
17453,78,YVELINES,65712,42695,627,42068,2002,t1,legislative
17454,79,DEUX-SEVRES,60102,40872,697,40175,2002,t1,legislative
17455,79,DEUX-SEVRES,70311,48322,1116,47206,2002,t1,legislative
17456,79,DEUX-SEVRES,61451,42443,1002,41441,2002,t1,legislative
17457,79,DEUX-SEVRES,69682,46268,1377,44891,2002,t1,legislative
17458,80,SOMME,57392,35096,768,34328,2002,t1,legislative
17459,80,SOMME,61879,39956,619,39337,2002,t1,legislative
17460,80,SOMME,67678,49477,1740,47737,2002,t1,legislative
17461,80,SOMME,71815,49084,1230,47854,2002,t1,legislative
17462,80,SOMME,64948,42566,1204,41362,2002,t1,legislative
17463,80,SOMME,75896,51632,1300,50332,2002,t1,legislative
17464,81,TARN,56066,40750,1490,39260,2002,t1,legislative
17465,81,TARN,74036,52648,1387,51261,2002,t1,legislative
17466,81,TARN,58277,41965,1210,40755,2002,t1,legislative
17467,81,TARN,73609,54680,1638,53042,2002,t1,legislative
17468,82,TARN-ET-GARONNE,76111,55132,1429,53703,2002,t1,legislative
17469,82,TARN-ET-GARONNE,78039,54163,1770,52393,2002,t1,legislative
17470,83,VAR,49838,29957,515,29442,2002,t1,legislative
17471,83,VAR,53402,32256,649,31607,2002,t1,legislative
17472,83,VAR,103444,64281,1266,63015,2002,t1,legislative
17473,83,VAR,106374,67391,1306,66085,2002,t1,legislative
17474,83,VAR,95197,58187,1265,56922,2002,t1,legislative
17475,83,VAR,138792,89815,1856,87959,2002,t1,legislative
17476,83,VAR,101164,61811,1015,60796,2002,t1,legislative
17477,84,VAUCLUSE,68298,44251,792,43459,2002,t1,legislative
17478,84,VAUCLUSE,110306,72593,1645,70948,2002,t1,legislative
17479,84,VAUCLUSE,89180,58959,1517,57442,2002,t1,legislative
17480,84,VAUCLUSE,76295,53601,1177,52424,2002,t1,legislative
17481,85,VENDEE,86846,56282,1574,54708,2002,t1,legislative
17482,85,VENDEE,83325,56012,1563,54449,2002,t1,legislative
17483,85,VENDEE,96665,60941,1216,59725,2002,t1,legislative
17484,85,VENDEE,85513,58636,1882,56754,2002,t1,legislative
17485,85,VENDEE,76612,51407,1140,50267,2002,t1,legislative
17486,86,VIENNE,76414,52383,6634,45749,2002,t1,legislative
17487,86,VIENNE,69173,47881,945,46936,2002,t1,legislative
17488,86,VIENNE,67811,47232,1207,46025,2002,t1,legislative
17489,86,VIENNE,74192,47990,1327,46663,2002,t1,legislative
17490,87,HAUTE-VIENNE,52167,37031,1022,36009,2002,t1,legislative
17491,87,HAUTE-VIENNE,72616,53553,1968,51585,2002,t1,legislative
17492,87,HAUTE-VIENNE,66436,46638,1475,45163,2002,t1,legislative
17493,87,HAUTE-VIENNE,70022,49827,1473,48354,2002,t1,legislative
17494,88,VOSGES,75440,46832,1340,45492,2002,t1,legislative
17495,88,VOSGES,73371,44759,1541,43218,2002,t1,legislative
17496,88,VOSGES,66174,44096,1022,43074,2002,t1,legislative
17497,88,VOSGES,68847,45276,1361,43915,2002,t1,legislative
17498,89,YONNE,75963,49284,1212,48072,2002,t1,legislative
17499,89,YONNE,72557,46771,1224,45547,2002,t1,legislative
17500,89,YONNE,87634,55296,1131,54165,2002,t1,legislative
17501,90,TERRITOIRE DE BELFORT,43979,29231,806,28425,2002,t1,legislative
17502,90,TERRITOIRE DE BELFORT,45962,30292,817,29475,2002,t1,legislative
17503,91,ESSONNE,60348,36910,612,36298,2002,t1,legislative
17504,91,ESSONNE,75693,50050,924,49126,2002,t1,legislative
17505,91,ESSONNE,86872,57783,944,56839,2002,t1,legislative
17506,91,ESSONNE,76706,51278,839,50439,2002,t1,legislative
17507,91,ESSONNE,61188,43519,534,42985,2002,t1,legislative
17508,91,ESSONNE,67720,45393,523,44870,2002,t1,legislative
17509,91,ESSONNE,65422,42809,677,42132,2002,t1,legislative
17510,91,ESSONNE,68428,44714,782,43932,2002,t1,legislative
17511,91,ESSONNE,68573,44587,627,43960,2002,t1,legislative
17512,91,ESSONNE,54695,34068,564,33504,2002,t1,legislative
17513,92,HAUTS-DE-SEINE,53218,29848,509,29339,2002,t1,legislative
17514,92,HAUTS-DE-SEINE,52441,35329,318,35011,2002,t1,legislative
17515,92,HAUTS-DE-SEINE,69705,47156,538,46618,2002,t1,legislative
17516,92,HAUTS-DE-SEINE,60239,38215,482,37733,2002,t1,legislative
17517,92,HAUTS-DE-SEINE,58696,39269,477,38792,2002,t1,legislative
17518,92,HAUTS-DE-SEINE,59332,41002,577,40425,2002,t1,legislative
17519,92,HAUTS-DE-SEINE,79070,52596,518,52078,2002,t1,legislative
17520,92,HAUTS-DE-SEINE,64376,44668,387,44281,2002,t1,legislative
17521,92,HAUTS-DE-SEINE,53700,36313,287,36026,2002,t1,legislative
17522,92,HAUTS-DE-SEINE,56748,39749,411,39338,2002,t1,legislative
17523,92,HAUTS-DE-SEINE,59550,38454,456,37998,2002,t1,legislative
17524,92,HAUTS-DE-SEINE,78402,53065,666,52399,2002,t1,legislative
17525,92,HAUTS-DE-SEINE,78803,56680,626,56054,2002,t1,legislative
17526,93,SEINE-SAINT-DENIS,42748,24432,356,24076,2002,t1,legislative
17527,93,SEINE-SAINT-DENIS,44568,24645,434,24211,2002,t1,legislative
17528,93,SEINE-SAINT-DENIS,40346,22311,435,21876,2002,t1,legislative
17529,93,SEINE-SAINT-DENIS,41635,23082,403,22679,2002,t1,legislative
17530,93,SEINE-SAINT-DENIS,47788,27641,411,27230,2002,t1,legislative
17531,93,SEINE-SAINT-DENIS,53066,32417,515,31902,2002,t1,legislative
17532,93,SEINE-SAINT-DENIS,44070,26567,389,26178,2002,t1,legislative
17533,93,SEINE-SAINT-DENIS,55970,34974,748,34226,2002,t1,legislative
17534,93,SEINE-SAINT-DENIS,48690,29886,504,29382,2002,t1,legislative
17535,93,SEINE-SAINT-DENIS,47395,28325,497,27828,2002,t1,legislative
17536,93,SEINE-SAINT-DENIS,51531,31043,441,30602,2002,t1,legislative
17537,93,SEINE-SAINT-DENIS,56011,35729,509,35220,2002,t1,legislative
17538,93,SEINE-SAINT-DENIS,60588,38429,591,37838,2002,t1,legislative
17539,94,VAL-DE-MARNE,50590,34514,494,34020,2002,t1,legislative
17540,94,VAL-DE-MARNE,58419,35374,632,34742,2002,t1,legislative
17541,94,VAL-DE-MARNE,62781,39453,621,38832,2002,t1,legislative
17542,94,VAL-DE-MARNE,64213,43084,551,42533,2002,t1,legislative
17543,94,VAL-DE-MARNE,56963,36117,424,35693,2002,t1,legislative
17544,94,VAL-DE-MARNE,69523,46749,526,46223,2002,t1,legislative
17545,94,VAL-DE-MARNE,53147,35835,414,35421,2002,t1,legislative
17546,94,VAL-DE-MARNE,54758,37019,479,36540,2002,t1,legislative
17547,94,VAL-DE-MARNE,46599,27854,527,27327,2002,t1,legislative
17548,94,VAL-DE-MARNE,54212,33560,510,33050,2002,t1,legislative
17549,94,VAL-DE-MARNE,52022,32268,459,31809,2002,t1,legislative
17550,94,VAL-DE-MARNE,59256,38419,451,37968,2002,t1,legislative
17551,95,VAL-D'OISE,69997,46193,778,45415,2002,t1,legislative
17552,95,VAL-D'OISE,98918,64303,1890,62413,2002,t1,legislative
17553,95,VAL-D'OISE,75994,49094,844,48250,2002,t1,legislative
17554,95,VAL-D'OISE,69002,43873,738,43135,2002,t1,legislative
17555,95,VAL-D'OISE,55742,33868,558,33310,2002,t1,legislative
17556,95,VAL-D'OISE,63679,40966,569,40397,2002,t1,legislative
17557,95,VAL-D'OISE,73231,46960,645,46315,2002,t1,legislative
17558,95,VAL-D'OISE,43133,24406,426,23980,2002,t1,legislative
17559,95,VAL-D'OISE,58062,35118,768,34350,2002,t1,legislative
17560,971,GUADELOUPE,61291,22662,1328,21334,2002,t1,legislative
17561,971,GUADELOUPE,80343,25757,1296,24461,2002,t1,legislative
17562,971,GUADELOUPE,73350,23161,1436,21725,2002,t1,legislative
17563,971,GUADELOUPE,66637,23198,1134,22064,2002,t1,legislative
17564,972,MARTINIQUE,57317,22590,1023,21567,2002,t1,legislative
17565,972,MARTINIQUE,58884,17380,1013,16367,2002,t1,legislative
17566,972,MARTINIQUE,55750,16899,904,15995,2002,t1,legislative
17567,972,MARTINIQUE,94595,30788,1115,29673,2002,t1,legislative
17568,973,GUYANE,19494,6175,243,5932,2002,t1,legislative
17569,973,GUYANE,32291,11401,385,11016,2002,t1,legislative
17570,974,LA REUNION,71674,33813,1683,32130,2002,t1,legislative
17571,974,LA REUNION,92147,48935,2171,46764,2002,t1,legislative
17572,974,LA REUNION,106761,60787,3484,57303,2002,t1,legislative
17573,974,LA REUNION,80247,45715,2112,43603,2002,t1,legislative
17574,974,LA REUNION,87107,43824,1854,41970,2002,t1,legislative
17575,975,SAINT-PIERRE-ET-MIQUELON,4824,3214,62,3152,2002,t1,legislative
17576,985,MAYOTTE,52300,29607,496,29111,2002,t1,legislative
17577,986,WALLIS ET FUTUNA,9376,7149,40,7109,2002,t1,legislative
17578,987,POLYNESIE FRANCAISE,84235,44291,559,43732,2002,t1,legislative
17579,987,POLYNESIE FRANCAISE,65659,38232,569,37663,2002,t1,legislative
17580,988,NOUVELLE-CALEDONIE,60779,25588,740,24848,2002,t1,legislative
17581,988,NOUVELLE-CALEDONIE,66925,27529,852,26677,2002,t1,legislative
17582,1,AIN,79072,47900,938,46962,2012,t2,legislative
17583,1,AIN,86951,51411,1038,50383,2012,t2,legislative
17584,1,AIN,69847,35900,981,34919,2012,t2,legislative
17585,1,AIN,84589,47205,1261,45944,2012,t2,legislative
17586,1,AIN,73713,40324,1304,39030,2012,t2,legislative
17587,2,AISNE,72613,42356,972,41384,2012,t2,legislative
17588,2,AISNE,73254,45983,1315,44668,2012,t2,legislative
17589,2,AISNE,70385,41413,1361,40052,2012,t2,legislative
17590,2,AISNE,78988,42392,1593,40799,2012,t2,legislative
17591,2,AISNE,81007,49212,819,48393,2012,t2,legislative
17592,3,ALLIER,90327,56193,2030,54163,2012,t2,legislative
17593,3,ALLIER,86703,53478,2063,51415,2012,t2,legislative
17594,3,ALLIER,78992,47389,1542,45847,2012,t2,legislative
17595,4,ALPES-DE-HAUTE-PROVENCE,60572,37351,1886,35465,2012,t2,legislative
17596,4,ALPES-DE-HAUTE-PROVENCE,63340,39060,1292,37768,2012,t2,legislative
17597,5,HAUTES-ALPES,56125,34110,1568,32542,2012,t2,legislative
17598,5,HAUTES-ALPES,50810,31409,1032,30387,2012,t2,legislative
17599,6,ALPES-MARITIMES,82287,43314,1368,41946,2012,t2,legislative
17600,6,ALPES-MARITIMES,82396,46109,1407,44703,2012,t2,legislative
17601,6,ALPES-MARITIMES,87373,44457,1786,42671,2012,t2,legislative
17602,6,ALPES-MARITIMES,84882,42207,5145,37062,2012,t2,legislative
17603,6,ALPES-MARITIMES,85420,46119,1932,44187,2012,t2,legislative
17604,6,ALPES-MARITIMES,80580,37825,3117,34708,2012,t2,legislative
17605,6,ALPES-MARITIMES,77291,40673,970,39703,2012,t2,legislative
17606,7,ARDECHE,76624,44471,3428,41043,2012,t2,legislative
17607,7,ARDECHE,90925,55672,1336,54336,2012,t2,legislative
17608,7,ARDECHE,76059,51281,1436,49845,2012,t2,legislative
17609,8,ARDENNES,73262,42303,1275,41036,2012,t2,legislative
17610,8,ARDENNES,65105,35464,1035,34439,2012,t2,legislative
17611,9,ARIEGE,59751,35678,1983,33695,2012,t2,legislative
17612,10,AUBE,64415,39518,765,38753,2012,t2,legislative
17613,10,AUBE,72910,42673,1859,40814,2012,t2,legislative
17614,10,AUBE,66188,36706,1189,35517,2012,t2,legislative
17615,11,AUDE,92733,57296,3977,53319,2012,t2,legislative
17616,11,AUDE,83694,49045,2829,46216,2012,t2,legislative
17617,11,AUDE,87626,54366,2705,51661,2012,t2,legislative
17618,12,AVEYRON,75453,49622,1645,47977,2012,t2,legislative
17619,12,AVEYRON,70570,44679,1413,43266,2012,t2,legislative
17620,12,AVEYRON,71907,48096,1838,46258,2012,t2,legislative
17621,13,BOUCHES-DU-RHONE,73877,40340,1367,38873,2012,t2,legislative
17622,13,BOUCHES-DU-RHONE,77369,41886,1224,40662,2012,t2,legislative
17623,13,BOUCHES-DU-RHONE,70329,37291,2066,35225,2012,t2,legislative
17624,13,BOUCHES-DU-RHONE,58696,28517,1339,27178,2012,t2,legislative
17625,13,BOUCHES-DU-RHONE,68665,40326,1215,39031,2012,t2,legislative
17626,13,BOUCHES-DU-RHONE,72561,40706,425,40381,2012,t2,legislative
17627,13,BOUCHES-DU-RHONE,63071,28553,1227,27326,2012,t2,legislative
17628,13,BOUCHES-DU-RHONE,93083,55994,834,55160,2012,t2,legislative
17629,13,BOUCHES-DU-RHONE,92600,45858,5894,39964,2012,t2,legislative
17630,13,BOUCHES-DU-RHONE,100387,60317,966,59251,2012,t2,legislative
17631,13,BOUCHES-DU-RHONE,85346,47557,1396,46161,2012,t2,legislative
17632,13,BOUCHES-DU-RHONE,89006,51000,776,50324,2012,t2,legislative
17633,13,BOUCHES-DU-RHONE,90571,52197,2561,49636,2012,t2,legislative
17634,13,BOUCHES-DU-RHONE,93933,55745,1697,54048,2012,t2,legislative
17635,13,BOUCHES-DU-RHONE,98258,60452,803,59650,2012,t2,legislative
17636,13,BOUCHES-DU-RHONE,88592,54465,2182,52283,2012,t2,legislative
17637,14,CALVADOS,70398,40932,1396,39536,2012,t2,legislative
17638,14,CALVADOS,67110,37685,1071,36614,2012,t2,legislative
17639,14,CALVADOS,78452,46457,1513,44944,2012,t2,legislative
17640,14,CALVADOS,97727,56319,1358,54961,2012,t2,legislative
17641,14,CALVADOS,86422,52181,1541,50640,2012,t2,legislative
17642,14,CALVADOS,90970,56989,1480,55509,2012,t2,legislative
17643,15,CANTAL,64432,43485,1103,42383,2012,t2,legislative
17644,16,CHARENTE,84796,48307,1475,46832,2012,t2,legislative
17645,17,CHARENTE-MARITIME,98754,63247,2041,61206,2012,t2,legislative
17646,17,CHARENTE-MARITIME,97489,57703,1559,56143,2012,t2,legislative
17647,17,CHARENTE-MARITIME,81736,46507,1560,44947,2012,t2,legislative
17648,17,CHARENTE-MARITIME,87675,52896,1616,51280,2012,t2,legislative
17649,17,CHARENTE-MARITIME,105996,62171,1608,60563,2012,t2,legislative
17650,18,CHER,73570,43328,1648,41680,2012,t2,legislative
17651,18,CHER,70320,23542,7800,15742,2012,t2,legislative
17652,18,CHER,87097,52218,2370,49848,2012,t2,legislative
17653,19,CORREZE,91923,58559,2266,56293,2012,t2,legislative
17654,21,COTE-D'OR,67637,41927,1043,40884,2012,t2,legislative
17655,21,COTE-D'OR,66185,39333,998,38335,2012,t2,legislative
17656,21,COTE-D'OR,69183,38870,1272,37598,2012,t2,legislative
17657,21,COTE-D'OR,69038,44603,1439,43163,2012,t2,legislative
17658,21,COTE-D'OR,82956,49058,1274,47784,2012,t2,legislative
17659,22,COTES-D'ARMOR,89033,52743,2005,50738,2012,t2,legislative
17660,22,COTES-D'ARMOR,93778,60351,1816,58335,2012,t2,legislative
17661,22,COTES-D'ARMOR,86363,60771,1031,59760,2012,t2,legislative
17662,22,COTES-D'ARMOR,79632,49978,2565,47413,2012,t2,legislative
17663,22,COTES-D'ARMOR,103336,63516,2055,61461,2012,t2,legislative
17664,23,CREUSE,96735,64210,2590,61620,2012,t2,legislative
17665,24,DORDOGNE,75070,46273,1803,44471,2012,t2,legislative
17666,24,DORDOGNE,81109,50303,2570,47531,2012,t2,legislative
17667,25,DOUBS,73034,43061,1175,41886,2012,t2,legislative
17668,25,DOUBS,76305,47717,1361,46356,2012,t2,legislative
17669,25,DOUBS,65421,39350,1569,37781,2012,t2,legislative
17670,25,DOUBS,67392,39856,704,39152,2012,t2,legislative
17671,25,DOUBS,77318,44004,1388,42616,2012,t2,legislative
17672,26,DROME,72886,42803,1337,41465,2012,t2,legislative
17673,26,DROME,87793,51318,1736,49582,2012,t2,legislative
17674,26,DROME,103603,66362,1831,64531,2012,t2,legislative
17675,26,DROME,90037,52523,1403,51120,2012,t2,legislative
17676,27,EURE,85358,48080,1575,46505,2012,t2,legislative
17677,27,EURE,76977,45216,1535,43681,2012,t2,legislative
17678,27,EURE,81697,48963,1633,47330,2012,t2,legislative
17679,27,EURE,86705,47917,1978,45939,2012,t2,legislative
17680,27,EURE,87231,43622,6720,36903,2012,t2,legislative
17681,28,EURE-ET-LOIR,87303,52332,1490,50842,2012,t2,legislative
17682,28,EURE-ET-LOIR,71962,39194,1162,38032,2012,t2,legislative
17683,28,EURE-ET-LOIR,71263,42196,1197,40999,2012,t2,legislative
17684,29,FINISTERE,85899,51818,1509,50309,2012,t2,legislative
17685,29,FINISTERE,78114,40491,1394,39097,2012,t2,legislative
17686,29,FINISTERE,86266,53031,1110,51911,2012,t2,legislative
17687,29,FINISTERE,82120,50921,1217,49704,2012,t2,legislative
17688,29,FINISTERE,91125,55221,1353,53868,2012,t2,legislative
17689,29,FINISTERE,89355,56586,1814,54772,2012,t2,legislative
17690,29,FINISTERE,79856,50546,1366,49180,2012,t2,legislative
17691,29,FINISTERE,84422,48799,1912,46887,2012,t2,legislative
17692,2A,CORSE-DU-SUD,47853,28919,1074,27845,2012,t2,legislative
17693,2A,CORSE-DU-SUD,53679,32334,2160,30374,2012,t2,legislative
17694,2B,HAUTE-CORSE,54656,35937,1006,34931,2012,t2,legislative
17695,2B,HAUTE-CORSE,63922,38224,1860,36364,2012,t2,legislative
17696,30,GARD,83375,50056,658,49398,2012,t2,legislative
17697,30,GARD,82311,53897,694,53203,2012,t2,legislative
17698,30,GARD,88908,56459,843,55616,2012,t2,legislative
17699,30,GARD,87722,54294,1941,52353,2012,t2,legislative
17700,30,GARD,93425,57997,3862,54135,2012,t2,legislative
17701,30,GARD,77642,45849,729,45120,2012,t2,legislative
17702,31,HAUTE-GARONNE,76430,40329,1074,39255,2012,t2,legislative
17703,31,HAUTE-GARONNE,94420,50975,1641,49334,2012,t2,legislative
17704,31,HAUTE-GARONNE,73122,44147,1197,42950,2012,t2,legislative
17705,31,HAUTE-GARONNE,66103,32899,961,31938,2012,t2,legislative
17706,31,HAUTE-GARONNE,90348,50912,1936,48976,2012,t2,legislative
17707,31,HAUTE-GARONNE,103286,58134,2531,55603,2012,t2,legislative
17708,31,HAUTE-GARONNE,92509,52819,2006,50813,2012,t2,legislative
17709,31,HAUTE-GARONNE,76388,40366,1952,38414,2012,t2,legislative
17710,31,HAUTE-GARONNE,88443,56584,3103,53481,2012,t2,legislative
17711,32,GERS,70330,43949,1952,41997,2012,t2,legislative
17712,33,GIRONDE,86035,49189,1105,48084,2012,t2,legislative
17713,33,GIRONDE,62176,33621,732,32889,2012,t2,legislative
17714,33,GIRONDE,86739,42717,1854,40863,2012,t2,legislative
17715,33,GIRONDE,103516,57603,1949,55654,2012,t2,legislative
17716,33,GIRONDE,95291,53180,1369,51811,2012,t2,legislative
17717,33,GIRONDE,97831,60600,1807,58793,2012,t2,legislative
17718,33,GIRONDE,85680,50050,2124,47926,2012,t2,legislative
17719,33,GIRONDE,78551,47530,1753,45777,2012,t2,legislative
17720,33,GIRONDE,88206,48391,2110,46281,2012,t2,legislative
17721,33,GIRONDE,78644,47245,1523,45722,2012,t2,legislative
17722,34,HERAULT,79107,44689,2069,42620,2012,t2,legislative
17723,34,HERAULT,58366,29145,1032,28133,2012,t2,legislative
17724,34,HERAULT,77416,45656,2698,42958,2012,t2,legislative
17725,34,HERAULT,103243,60678,2351,58327,2012,t2,legislative
17726,34,HERAULT,90937,54313,3445,50868,2012,t2,legislative
17727,34,HERAULT,86217,52567,675,51892,2012,t2,legislative
17728,34,HERAULT,95974,62232,1074,61158,2012,t2,legislative
17729,34,HERAULT,80691,45732,1992,43740,2012,t2,legislative
17730,34,HERAULT,75616,43414,1874,41540,2012,t2,legislative
17731,35,ILLE-ET-VILAINE,87110,47167,1295,45872,2012,t2,legislative
17732,35,ILLE-ET-VILAINE,86967,51764,1266,50498,2012,t2,legislative
17733,35,ILLE-ET-VILAINE,81490,48605,1334,47271,2012,t2,legislative
17734,35,ILLE-ET-VILAINE,85089,46610,1522,45088,2012,t2,legislative
17735,35,ILLE-ET-VILAINE,97503,55009,1244,53765,2012,t2,legislative
17736,35,ILLE-ET-VILAINE,85286,52320,1478,50842,2012,t2,legislative
17737,35,ILLE-ET-VILAINE,95131,57648,1527,56121,2012,t2,legislative
17738,35,ILLE-ET-VILAINE,78950,42729,1192,41537,2012,t2,legislative
17739,36,INDRE,82181,48300,1612,46688,2012,t2,legislative
17740,36,INDRE,91526,58965,2125,56840,2012,t2,legislative
17741,37,INDRE-ET-LOIRE,65540,35989,1099,34890,2012,t2,legislative
17742,37,INDRE-ET-LOIRE,84410,51173,1448,49725,2012,t2,legislative
17743,37,INDRE-ET-LOIRE,94506,57054,2003,55052,2012,t2,legislative
17744,37,INDRE-ET-LOIRE,88312,53289,1489,51800,2012,t2,legislative
17745,37,INDRE-ET-LOIRE,80474,49431,1471,47960,2012,t2,legislative
17746,38,ISERE,79900,46647,1391,45256,2012,t2,legislative
17747,38,ISERE,75154,39098,1139,37959,2012,t2,legislative
17748,38,ISERE,59259,29999,1151,28848,2012,t2,legislative
17749,38,ISERE,87944,49665,1060,48605,2012,t2,legislative
17750,38,ISERE,97929,54325,1358,52967,2012,t2,legislative
17751,38,ISERE,77141,40695,1121,39574,2012,t2,legislative
17752,38,ISERE,87620,50657,1388,49269,2012,t2,legislative
17753,38,ISERE,75067,42517,1182,41335,2012,t2,legislative
17754,38,ISERE,93416,52237,1824,50413,2012,t2,legislative
17755,38,ISERE,87766,45981,1481,44500,2012,t2,legislative
17756,39,JURA,65059,41307,1206,40303,2012,t2,legislative
17757,39,JURA,54978,31936,962,30974,2012,t2,legislative
17758,39,JURA,68319,43367,1427,41940,2012,t2,legislative
17759,40,LANDES,97684,55858,2004,53854,2012,t2,legislative
17760,40,LANDES,104777,59716,2363,57353,2012,t2,legislative
17761,41,LOIR-ET-CHER,80495,47691,1504,46187,2012,t2,legislative
17762,41,LOIR-ET-CHER,80386,48378,1613,46765,2012,t2,legislative
17763,41,LOIR-ET-CHER,82398,51252,1555,49697,2012,t2,legislative
17764,42,LOIRE,67995,34776,1083,33693,2012,t2,legislative
17765,42,LOIRE,57280,28246,797,27449,2012,t2,legislative
17766,42,LOIRE,80453,44540,1706,42834,2012,t2,legislative
17767,42,LOIRE,99109,59535,1081,58454,2012,t2,legislative
17768,42,LOIRE,103386,61553,2130,59423,2012,t2,legislative
17769,42,LOIRE,103990,60822,1770,59052,2012,t2,legislative
17770,43,HAUTE-LOIRE,95797,58892,1579,57313,2012,t2,legislative
17771,43,HAUTE-LOIRE,80389,49848,1906,47942,2012,t2,legislative
17772,44,LOIRE-ATLANTIQUE,72772,41518,943,40575,2012,t2,legislative
17773,44,LOIRE-ATLANTIQUE,81582,43051,935,42116,2012,t2,legislative
17774,44,LOIRE-ATLANTIQUE,105676,61262,1426,59836,2012,t2,legislative
17775,44,LOIRE-ATLANTIQUE,106907,64631,2150,62481,2012,t2,legislative
17776,44,LOIRE-ATLANTIQUE,103050,61257,1284,59973,2012,t2,legislative
17777,44,LOIRE-ATLANTIQUE,107719,67346,2030,65336,2012,t2,legislative
17778,44,LOIRE-ATLANTIQUE,106661,65335,1394,63941,2012,t2,legislative
17779,45,LOIRET,73261,43311,1167,42144,2012,t2,legislative
17780,45,LOIRET,81930,48703,1226,47476,2012,t2,legislative
17781,45,LOIRET,71107,42166,1618,40548,2012,t2,legislative
17782,45,LOIRET,74996,42289,1686,40603,2012,t2,legislative
17783,45,LOIRET,72691,41656,1473,40383,2012,t2,legislative
17784,45,LOIRET,69209,40317,1348,38969,2012,t2,legislative
17785,46,LOT,70388,45037,1839,43188,2012,t2,legislative
17786,47,LOT-ET-GARONNE,86724,54952,2686,52266,2012,t2,legislative
17787,47,LOT-ET-GARONNE,77688,48860,2172,46688,2012,t2,legislative
17788,47,LOT-ET-GARONNE,76361,47872,1832,46040,2012,t2,legislative
17789,48,LOZERE,59904,41415,1552,39863,2012,t2,legislative
17790,49,MAINE-ET-LOIRE,80924,47493,1158,46335,2012,t2,legislative
17791,49,MAINE-ET-LOIRE,87427,48900,1355,47545,2012,t2,legislative
17792,49,MAINE-ET-LOIRE,68436,39937,1067,38870,2012,t2,legislative
17793,49,MAINE-ET-LOIRE,73568,42703,1204,41497,2012,t2,legislative
17794,49,MAINE-ET-LOIRE,75356,42693,1009,41684,2012,t2,legislative
17795,49,MAINE-ET-LOIRE,92541,52205,2953,49252,2012,t2,legislative
17796,49,MAINE-ET-LOIRE,75333,44835,1149,43686,2012,t2,legislative
17797,50,MANCHE,86504,52610,1124,51486,2012,t2,legislative
17798,50,MANCHE,94632,54888,2490,52398,2012,t2,legislative
17799,50,MANCHE,105840,63607,1836,61771,2012,t2,legislative
17800,51,MARNE,69253,36066,981,35085,2012,t2,legislative
17801,51,MARNE,72607,39858,944,38914,2012,t2,legislative
17802,51,MARNE,81309,42980,1504,41476,2012,t2,legislative
17803,51,MARNE,80926,44056,1414,42642,2012,t2,legislative
17804,51,MARNE,78224,44123,1231,42892,2012,t2,legislative
17805,52,HAUTE-MARNE,74519,45592,1371,44221,2012,t2,legislative
17806,52,HAUTE-MARNE,64327,35445,1135,34310,2012,t2,legislative
17807,53,MAYENNE,72662,41621,1340,40381,2012,t2,legislative
17808,53,MAYENNE,76721,43828,1472,42356,2012,t2,legislative
17809,54,MEURTHE-ET-MOSELLE,80687,45570,1096,44474,2012,t2,legislative
17810,54,MEURTHE-ET-MOSELLE,70929,41254,993,40361,2012,t2,legislative
17811,54,MEURTHE-ET-MOSELLE,83073,38743,1411,37332,2012,t2,legislative
17812,54,MEURTHE-ET-MOSELLE,97146,55563,1804,53759,2012,t2,legislative
17813,54,MEURTHE-ET-MOSELLE,76718,47046,1918,45128,2012,t2,legislative
17814,54,MEURTHE-ET-MOSELLE,87344,44141,1742,42399,2012,t2,legislative
17815,55,MEUSE,78861,46975,1860,45115,2012,t2,legislative
17816,55,MEUSE,61296,34878,1335,33543,2012,t2,legislative
17817,56,MORBIHAN,98874,63821,1409,62412,2012,t2,legislative
17818,56,MORBIHAN,98524,62935,1363,61572,2012,t2,legislative
17819,56,MORBIHAN,86768,54804,1513,53291,2012,t2,legislative
17820,56,MORBIHAN,103159,63216,1955,61261,2012,t2,legislative
17821,56,MORBIHAN,80306,44765,1689,43076,2012,t2,legislative
17822,56,MORBIHAN,89073,57240,1440,55800,2012,t2,legislative
17823,57,MOSELLE,88219,44781,1503,43278,2012,t2,legislative
17824,57,MOSELLE,76232,39757,1351,38406,2012,t2,legislative
17825,57,MOSELLE,74064,38785,1206,37579,2012,t2,legislative
17826,57,MOSELLE,81176,47350,781,46569,2012,t2,legislative
17827,57,MOSELLE,74623,37840,1787,36053,2012,t2,legislative
17828,57,MOSELLE,72286,34916,1837,33079,2012,t2,legislative
17829,57,MOSELLE,91558,49837,895,48942,2012,t2,legislative
17830,57,MOSELLE,91177,41639,2124,39515,2012,t2,legislative
17831,57,MOSELLE,97052,51184,1218,49966,2012,t2,legislative
17832,58,NIEVRE,78228,42700,2064,40636,2012,t2,legislative
17833,58,NIEVRE,86663,50306,2098,48008,2012,t2,legislative
17834,59,NORD,60531,27808,1030,26778,2012,t2,legislative
17835,59,NORD,87326,43743,1660,42083,2012,t2,legislative
17836,59,NORD,96578,47871,2765,45106,2012,t2,legislative
17837,59,NORD,97181,51365,1426,49939,2012,t2,legislative
17838,59,NORD,96486,54806,2049,52757,2012,t2,legislative
17839,59,NORD,84779,50852,1654,49198,2012,t2,legislative
17840,59,NORD,72159,36631,1031,35600,2012,t2,legislative
17841,59,NORD,69044,28066,2038,26038,2012,t2,legislative
17842,59,NORD,89257,44181,1084,43097,2012,t2,legislative
17843,59,NORD,80361,37312,1627,35685,2012,t2,legislative
17844,59,NORD,90403,45360,1619,43741,2012,t2,legislative
17845,59,NORD,93678,51037,3808,47209,2012,t2,legislative
17846,59,NORD,90529,47203,2599,44604,2012,t2,legislative
17847,59,NORD,98765,59315,1864,57451,2012,t2,legislative
17848,59,NORD,95226,56648,2244,54404,2012,t2,legislative
17849,59,NORD,83611,30505,7044,23461,2012,t2,legislative
17850,59,NORD,75067,26897,7133,19764,2012,t2,legislative
17851,59,NORD,92037,51168,1645,49523,2012,t2,legislative
17852,59,NORD,79055,26660,6787,19873,2012,t2,legislative
17853,59,NORD,80858,39207,1839,37368,2012,t2,legislative
17854,59,NORD,81076,42346,1221,41125,2012,t2,legislative
17855,60,OISE,80790,47355,1354,46003,2012,t2,legislative
17856,60,OISE,86048,51410,980,50430,2012,t2,legislative
17857,60,OISE,71318,36624,1329,35295,2012,t2,legislative
17858,60,OISE,90388,47772,2067,45705,2012,t2,legislative
17859,60,OISE,71394,39706,1105,38603,2012,t2,legislative
17860,60,OISE,74661,43987,1062,42925,2012,t2,legislative
17861,60,OISE,75109,42798,1306,41492,2012,t2,legislative
17862,61,ORNE,71221,42742,1449,41293,2012,t2,legislative
17863,61,ORNE,68837,40308,1605,38603,2012,t2,legislative
17864,61,ORNE,72534,46198,1150,45048,2012,t2,legislative
17865,62,PAS-DE-CALAIS,103081,62883,2688,60395,2012,t2,legislative
17866,62,PAS-DE-CALAIS,84287,49285,2677,46608,2012,t2,legislative
17867,62,PAS-DE-CALAIS,87344,45235,2761,42474,2012,t2,legislative
17868,62,PAS-DE-CALAIS,87387,54047,1739,52308,2012,t2,legislative
17869,62,PAS-DE-CALAIS,89031,53675,3388,50387,2012,t2,legislative
17870,62,PAS-DE-CALAIS,92392,45908,2190,43718,2012,t2,legislative
17871,62,PAS-DE-CALAIS,93191,51736,2358,49378,2012,t2,legislative
17872,62,PAS-DE-CALAIS,79278,44830,2514,42316,2012,t2,legislative
17873,62,PAS-DE-CALAIS,89833,45462,2773,42689,2012,t2,legislative
17874,62,PAS-DE-CALAIS,94135,55683,2173,53510,2012,t2,legislative
17875,62,PAS-DE-CALAIS,94598,49423,3303,46121,2012,t2,legislative
17876,63,PUY-DE-DOME,80629,41123,1818,39305,2012,t2,legislative
17877,63,PUY-DE-DOME,86122,52993,1828,51165,2012,t2,legislative
17878,63,PUY-DE-DOME,86584,54390,1453,52937,2012,t2,legislative
17879,63,PUY-DE-DOME,100327,57324,2128,55196,2012,t2,legislative
17880,64,PYRENEES-ATLANTIQUES,68848,38484,2294,36190,2012,t2,legislative
17881,64,PYRENEES-ATLANTIQUES,77678,48151,1192,46959,2012,t2,legislative
17882,64,PYRENEES-ATLANTIQUES,80336,53159,2840,50319,2012,t2,legislative
17883,64,PYRENEES-ATLANTIQUES,85475,49864,1933,47931,2012,t2,legislative
17884,64,PYRENEES-ATLANTIQUES,94877,56000,2444,53556,2012,t2,legislative
17885,65,HAUTES-PYRENEES,88447,52160,2229,49931,2012,t2,legislative
17886,65,HAUTES-PYRENEES,88975,52414,2363,50051,2012,t2,legislative
17887,66,PYRENEES-ORIENTALES,67600,40723,910,39813,2012,t2,legislative
17888,66,PYRENEES-ORIENTALES,89077,53548,2665,50883,2012,t2,legislative
17889,66,PYRENEES-ORIENTALES,80323,49827,1819,48008,2012,t2,legislative
17890,66,PYRENEES-ORIENTALES,92337,57000,2858,54142,2012,t2,legislative
17891,67,BAS-RHIN,63979,31439,721,30718,2012,t2,legislative
17892,67,BAS-RHIN,71163,36728,764,35964,2012,t2,legislative
17893,67,BAS-RHIN,68329,34780,833,33947,2012,t2,legislative
17894,67,BAS-RHIN,89926,46142,1323,44819,2012,t2,legislative
17895,67,BAS-RHIN,98427,48959,1652,47307,2012,t2,legislative
17896,67,BAS-RHIN,84668,40476,3039,37457,2012,t2,legislative
17897,67,BAS-RHIN,88325,38709,3203,35508,2012,t2,legislative
17898,68,HAUT-RHIN,74121,37880,1304,36576,2012,t2,legislative
17899,68,HAUT-RHIN,91131,47357,1743,45614,2012,t2,legislative
17900,68,HAUT-RHIN,99246,50690,1807,48883,2012,t2,legislative
17901,68,HAUT-RHIN,78845,40355,1376,38979,2012,t2,legislative
17902,68,HAUT-RHIN,92577,47006,794,46212,2012,t2,legislative
17903,69,RHONE,68147,35952,996,34956,2012,t2,legislative
17904,69,RHONE,74894,41251,814,40437,2012,t2,legislative
17905,69,RHONE,70342,37138,916,36222,2012,t2,legislative
17906,69,RHONE,79525,43960,819,43141,2012,t2,legislative
17907,69,RHONE,80543,45494,849,44645,2012,t2,legislative
17908,69,RHONE,78362,38070,1229,36841,2012,t2,legislative
17909,69,RHONE,64848,29790,986,28804,2012,t2,legislative
17910,69,RHONE,98428,55044,1139,53905,2012,t2,legislative
17911,69,RHONE,85947,45291,1236,44055,2012,t2,legislative
17912,69,RHONE,89518,50374,1197,49177,2012,t2,legislative
17913,69,RHONE,85515,41326,6728,34598,2012,t2,legislative
17914,69,RHONE,76167,43760,899,42861,2012,t2,legislative
17915,69,RHONE,79500,43524,1232,42292,2012,t2,legislative
17916,69,RHONE,70347,33574,1679,31895,2012,t2,legislative
17917,70,HAUTE-SAONE,88838,57774,2125,55649,2012,t2,legislative
17918,70,HAUTE-SAONE,91944,58727,2603,56124,2012,t2,legislative
17919,71,SAONE-ET-LOIRE,72446,41410,1641,39769,2012,t2,legislative
17920,71,SAONE-ET-LOIRE,81299,49089,1522,47567,2012,t2,legislative
17921,71,SAONE-ET-LOIRE,83713,50350,1961,48189,2012,t2,legislative
17922,71,SAONE-ET-LOIRE,81136,48771,1532,47239,2012,t2,legislative
17923,71,SAONE-ET-LOIRE,91109,48189,1903,46287,2012,t2,legislative
17924,72,SARTHE,72564,42311,1191,41120,2012,t2,legislative
17925,72,SARTHE,83343,44261,1634,42627,2012,t2,legislative
17926,72,SARTHE,84844,50473,1588,48885,2012,t2,legislative
17927,72,SARTHE,78907,45184,1416,43768,2012,t2,legislative
17928,72,SARTHE,87454,52783,1782,51003,2012,t2,legislative
17929,73,SAVOIE,82249,44938,1233,43705,2012,t2,legislative
17930,73,SAVOIE,75062,37404,976,36428,2012,t2,legislative
17931,73,SAVOIE,70400,41575,1278,40397,2012,t2,legislative
17932,73,SAVOIE,71712,39031,1136,37875,2012,t2,legislative
17933,74,HAUTE-SAVOIE,93243,50366,1358,49008,2012,t2,legislative
17934,74,HAUTE-SAVOIE,90369,47840,1183,46657,2012,t2,legislative
17935,74,HAUTE-SAVOIE,75236,38635,1305,37330,2012,t2,legislative
17936,74,HAUTE-SAVOIE,79941,38356,849,37507,2012,t2,legislative
17937,74,HAUTE-SAVOIE,89910,45688,1603,44087,2012,t2,legislative
17938,74,HAUTE-SAVOIE,75879,38206,1162,37044,2012,t2,legislative
17939,75,PARIS,76654,44446,796,43650,2012,t2,legislative
17940,75,PARIS,71179,43112,647,42465,2012,t2,legislative
17941,75,PARIS,64992,36436,752,35684,2012,t2,legislative
17942,75,PARIS,67393,25696,5170,20526,2012,t2,legislative
17943,75,PARIS,70914,40308,1042,39066,2012,t2,legislative
17944,75,PARIS,73258,40531,1726,38805,2012,t2,legislative
17945,75,PARIS,72451,41991,962,41039,2012,t2,legislative
17946,75,PARIS,80063,47411,1189,46222,2012,t2,legislative
17947,75,PARIS,66531,37393,1239,36154,2012,t2,legislative
17948,75,PARIS,66677,37758,1618,36140,2012,t2,legislative
17949,75,PARIS,69506,43244,925,42319,2012,t2,legislative
17950,75,PARIS,71293,42791,676,42115,2012,t2,legislative
17951,75,PARIS,72578,44639,748,43891,2012,t2,legislative
17952,75,PARIS,73924,39863,1195,38668,2012,t2,legislative
17953,75,PARIS,66220,33786,1327,32459,2012,t2,legislative
17954,75,PARIS,55056,27112,820,26292,2012,t2,legislative
17955,75,PARIS,64935,36231,876,35355,2012,t2,legislative
17956,76,SEINE-MARITIME,64460,35227,1091,34136,2012,t2,legislative
17957,76,SEINE-MARITIME,91512,54474,1564,52910,2012,t2,legislative
17958,76,SEINE-MARITIME,69261,25282,5482,19800,2012,t2,legislative
17959,76,SEINE-MARITIME,94284,51707,1605,50303,2012,t2,legislative
17960,76,SEINE-MARITIME,110391,65242,2339,62903,2012,t2,legislative
17961,76,SEINE-MARITIME,88954,49434,1305,48129,2012,t2,legislative
17962,76,SEINE-MARITIME,70540,24832,6873,17959,2012,t2,legislative
17963,76,SEINE-MARITIME,92408,55100,1662,53438,2012,t2,legislative
17964,76,SEINE-MARITIME,105885,67212,1717,65495,2012,t2,legislative
17965,77,SEINE-ET-MARNE,67677,37379,852,36527,2012,t2,legislative
17966,77,SEINE-ET-MARNE,78540,44815,1297,43518,2012,t2,legislative
17967,77,SEINE-ET-MARNE,72477,42227,1273,40954,2012,t2,legislative
17968,77,SEINE-ET-MARNE,85120,47388,1466,45922,2012,t2,legislative
17969,77,SEINE-ET-MARNE,78936,42648,1262,41386,2012,t2,legislative
17970,77,SEINE-ET-MARNE,74055,41790,1175,40615,2012,t2,legislative
17971,77,SEINE-ET-MARNE,81916,44303,1205,43096,2012,t2,legislative
17972,77,SEINE-ET-MARNE,82689,43856,1207,42649,2012,t2,legislative
17973,77,SEINE-ET-MARNE,82227,43456,1062,42394,2012,t2,legislative
17974,77,SEINE-ET-MARNE,78330,39126,1044,38082,2012,t2,legislative
17975,77,SEINE-ET-MARNE,62580,30691,1048,29643,2012,t2,legislative
17976,78,YVELINES,81682,47683,909,46774,2012,t2,legislative
17977,78,YVELINES,83176,49992,1093,48899,2012,t2,legislative
17978,78,YVELINES,81509,45715,1500,44215,2012,t2,legislative
17979,78,YVELINES,76864,43208,1067,42141,2012,t2,legislative
17980,78,YVELINES,72109,39712,877,38835,2012,t2,legislative
17981,78,YVELINES,74199,38811,1080,37731,2012,t2,legislative
17982,78,YVELINES,78358,43681,955,42726,2012,t2,legislative
17983,78,YVELINES,71086,37592,1137,36455,2012,t2,legislative
17984,78,YVELINES,89312,48366,1592,46774,2012,t2,legislative
17985,78,YVELINES,86780,53516,1254,52262,2012,t2,legislative
17986,78,YVELINES,65697,36825,847,35978,2012,t2,legislative
17987,78,YVELINES,66384,39042,1086,37956,2012,t2,legislative
17988,79,DEUX-SEVRES,88435,49392,1871,47521,2012,t2,legislative
17989,79,DEUX-SEVRES,85107,49943,1230,48713,2012,t2,legislative
17990,80,SOMME,85129,46427,2108,44319,2012,t2,legislative
17991,80,SOMME,75032,42676,1276,41400,2012,t2,legislative
17992,80,SOMME,84660,55093,2443,52650,2012,t2,legislative
17993,80,SOMME,82795,52191,2045,50346,2012,t2,legislative
17994,80,SOMME,81979,50974,1312,49662,2012,t2,legislative
17995,81,TARN,83057,52260,2732,49528,2012,t2,legislative
17996,81,TARN,103427,62772,4342,58430,2012,t2,legislative
17997,81,TARN,98449,63880,2449,61431,2012,t2,legislative
17998,82,TARN-ET-GARONNE,86112,56045,1934,54111,2012,t2,legislative
17999,82,TARN-ET-GARONNE,89289,54699,3837,50862,2012,t2,legislative
18000,83,VAR,73594,38518,1390,37128,2012,t2,legislative
18001,83,VAR,87294,49059,688,48371,2012,t2,legislative
18002,83,VAR,97734,56995,892,56103,2012,t2,legislative
18003,83,VAR,99266,50409,5938,44471,2012,t2,legislative
18004,83,VAR,91037,46212,4369,41843,2012,t2,legislative
18005,83,VAR,108388,54714,6867,47847,2012,t2,legislative
18006,83,VAR,103226,57715,800,56915,2012,t2,legislative
18007,83,VAR,99851,60340,822,59518,2012,t2,legislative
18008,84,VAUCLUSE,72480,41336,976,40360,2012,t2,legislative
18009,84,VAUCLUSE,80312,44405,6067,38338,2012,t2,legislative
18010,84,VAUCLUSE,70912,45698,752,44946,2012,t2,legislative
18011,84,VAUCLUSE,86180,52968,2369,50599,2012,t2,legislative
18012,84,VAUCLUSE,78542,47242,2284,44958,2012,t2,legislative
18013,85,VENDEE,103173,57943,1540,56403,2012,t2,legislative
18014,85,VENDEE,97864,58459,1953,56506,2012,t2,legislative
18015,85,VENDEE,113870,56211,7595,48616,2012,t2,legislative
18016,85,VENDEE,80641,49598,1518,48080,2012,t2,legislative
18017,86,VIENNE,77231,41967,1665,40303,2012,t2,legislative
18018,86,VIENNE,75575,43290,1416,41874,2012,t2,legislative
18019,86,VIENNE,74805,44567,1594,42973,2012,t2,legislative
18020,86,VIENNE,75943,43794,1696,42098,2012,t2,legislative
18021,87,HAUTE-VIENNE,84649,46927,3557,43370,2012,t2,legislative
18022,87,HAUTE-VIENNE,96669,58608,3352,55256,2012,t2,legislative
18023,87,HAUTE-VIENNE,83518,50431,3049,47382,2012,t2,legislative
18024,88,VOSGES,76604,42905,1939,40966,2012,t2,legislative
18025,88,VOSGES,74263,45708,1979,43729,2012,t2,legislative
18026,88,VOSGES,66793,40704,1339,39365,2012,t2,legislative
18027,88,VOSGES,67893,42886,1793,41093,2012,t2,legislative
18028,89,YONNE,78334,47972,1336,46636,2012,t2,legislative
18029,89,YONNE,77711,46032,1698,44324,2012,t2,legislative
18030,89,YONNE,89161,50969,1573,49396,2012,t2,legislative
18031,90,TERRITOIRE-DE-BELFORT,47185,28372,1079,27293,2012,t2,legislative
18032,90,TERRITOIRE-DE-BELFORT,47621,28093,1521,26572,2012,t2,legislative
18033,91,ESSONNE,70336,32784,1444,31340,2012,t2,legislative
18034,91,ESSONNE,87350,49219,1275,47944,2012,t2,legislative
18035,91,ESSONNE,92133,52959,1616,51343,2012,t2,legislative
18036,91,ESSONNE,92236,58300,1313,56987,2012,t2,legislative
18037,91,ESSONNE,66684,41974,974,41000,2012,t2,legislative
18038,91,ESSONNE,76222,42868,1428,41440,2012,t2,legislative
18039,91,ESSONNE,71747,39003,1275,37726,2012,t2,legislative
18040,91,ESSONNE,75338,43077,746,42331,2012,t2,legislative
18041,91,ESSONNE,76276,42414,1867,40547,2012,t2,legislative
18042,91,ESSONNE,60673,30729,1425,29304,2012,t2,legislative
18043,92,HAUTS-DE-SEINE,59481,20373,4678,15495,2012,t2,legislative
18044,92,HAUTS-DE-SEINE,63567,36736,1476,35260,2012,t2,legislative
18045,92,HAUTS-DE-SEINE,76553,43879,1041,42838,2012,t2,legislative
18046,92,HAUTS-DE-SEINE,70836,37542,1311,36231,2012,t2,legislative
18047,92,HAUTS-DE-SEINE,68822,40390,1880,38310,2012,t2,legislative
18048,92,HAUTS-DE-SEINE,73407,41640,977,40663,2012,t2,legislative
18049,92,HAUTS-DE-SEINE,83959,46742,1347,45395,2012,t2,legislative
18050,92,HAUTS-DE-SEINE,67039,40630,1061,39569,2012,t2,legislative
18051,92,HAUTS-DE-SEINE,61030,35918,564,35354,2012,t2,legislative
18052,92,HAUTS-DE-SEINE,71749,42630,942,41688,2012,t2,legislative
18053,92,HAUTS-DE-SEINE,67356,37480,1288,36192,2012,t2,legislative
18054,92,HAUTS-DE-SEINE,89872,56652,1085,55567,2012,t2,legislative
18055,92,HAUTS-DE-SEINE,86550,55039,1562,53457,2012,t2,legislative
18056,93,SEINE-SAINT-DENIS,55214,18647,3587,15060,2012,t2,legislative
18057,93,SEINE-SAINT-DENIS,52134,21957,1396,20561,2012,t2,legislative
18058,93,SEINE-SAINT-DENIS,70715,35967,1336,34631,2012,t2,legislative
18059,93,SEINE-SAINT-DENIS,60362,19485,4454,15031,2012,t2,legislative
18060,93,SEINE-SAINT-DENIS,62241,29247,818,28429,2012,t2,legislative
18061,93,SEINE-SAINT-DENIS,49966,18003,3626,14376,2012,t2,legislative
18062,93,SEINE-SAINT-DENIS,71233,22523,6403,16121,2012,t2,legislative
18063,93,SEINE-SAINT-DENIS,60335,33336,872,32464,2012,t2,legislative
18064,93,SEINE-SAINT-DENIS,66536,32200,1762,30438,2012,t2,legislative
18065,93,SEINE-SAINT-DENIS,67064,32589,927,31662,2012,t2,legislative
18066,93,SEINE-SAINT-DENIS,62048,20403,4324,16078,2012,t2,legislative
18067,93,SEINE-SAINT-DENIS,64452,32976,986,31990,2012,t2,legislative
18068,94,VAL-DE-MARNE,82696,46851,1557,45294,2012,t2,legislative
18069,94,VAL-DE-MARNE,65093,30867,1074,29793,2012,t2,legislative
18070,94,VAL-DE-MARNE,70806,37478,1383,36095,2012,t2,legislative
18071,94,VAL-DE-MARNE,71848,40375,1109,39266,2012,t2,legislative
18072,94,VAL-DE-MARNE,86113,46374,978,45396,2012,t2,legislative
18073,94,VAL-DE-MARNE,77995,45355,995,44360,2012,t2,legislative
18074,94,VAL-DE-MARNE,63664,35510,881,34629,2012,t2,legislative
18075,94,VAL-DE-MARNE,73789,42542,814,41728,2012,t2,legislative
18076,94,VAL-DE-MARNE,52760,24670,874,23796,2012,t2,legislative
18077,94,VAL-DE-MARNE,63303,22915,4972,17943,2012,t2,legislative
18078,94,VAL-DE-MARNE,59907,21741,4856,16885,2012,t2,legislative
18079,95,VAL-D'OISE,78698,45961,1127,44834,2012,t2,legislative
18080,95,VAL-D'OISE,73472,41907,889,41038,2012,t2,legislative
18081,95,VAL-D'OISE,88036,47776,1313,46463,2012,t2,legislative
18082,95,VAL-D'OISE,72598,41034,974,40040,2012,t2,legislative
18083,95,VAL-D'OISE,68075,33949,1146,32803,2012,t2,legislative
18084,95,VAL-D'OISE,74709,39830,1063,38767,2012,t2,legislative
18085,95,VAL-D'OISE,67930,36850,707,36143,2012,t2,legislative
18086,95,VAL-D'OISE,52042,22182,812,21370,2012,t2,legislative
18087,95,VAL-D'OISE,67835,33615,991,32624,2012,t2,legislative
18088,95,VAL-D'OISE,62833,31915,1274,30641,2012,t2,legislative
18089,971,GUADELOUPE,73177,26434,2438,23996,2012,t2,legislative
18090,971,GUADELOUPE,81530,29717,1636,28081,2012,t2,legislative
18091,971,GUADELOUPE,76925,32603,1975,30628,2012,t2,legislative
18092,972,MARTINIQUE,76388,31051,1989,29062,2012,t2,legislative
18093,972,MARTINIQUE,81693,32887,2579,30308,2012,t2,legislative
18094,972,MARTINIQUE,66117,23190,1568,21622,2012,t2,legislative
18095,972,MARTINIQUE,78998,31036,1928,29108,2012,t2,legislative
18096,973,GUYANE,46389,16332,1032,15300,2012,t2,legislative
18097,973,GUYANE,30823,12078,469,11609,2012,t2,legislative
18098,974,LA-REUNION,73995,38333,2787,35546,2012,t2,legislative
18099,974,LA-REUNION,83831,48582,3482,45100,2012,t2,legislative
18100,974,LA-REUNION,75798,36229,2489,33740,2012,t2,legislative
18101,974,LA-REUNION,67878,34285,2333,31952,2012,t2,legislative
18102,974,LA-REUNION,99095,48625,4727,43898,2012,t2,legislative
18103,979,SAINT-MARTIN/SAINT-BARTHELEMY,22738,8154,298,7856,2012,t2,legislative
18104,985,MAYOTTE,35603,17100,740,16360,2012,t2,legislative
18105,985,MAYOTTE,42003,24583,1205,23378,2012,t2,legislative
18106,986,WALLIS-ET-FUTUNA,8984,7440,66,7374,2012,t2,legislative
18107,987,POLYNESIE-FRANCAISE,67424,36318,1404,34914,2012,t2,legislative
18108,987,POLYNESIE-FRANCAISE,59478,31634,911,30723,2012,t2,legislative
18109,987,POLYNESIE-FRANCAISE,59645,32745,1195,31550,2012,t2,legislative
18110,988,NOUVELLE-CALEDONIE,76406,35073,2922,32151,2012,t2,legislative
18111,988,NOUVELLE-CALEDONIE,89311,55740,1698,54042,2012,t2,legislative
18112,99,FRANCAIS-DE-L'ETRANGER,156645,29869,646,29223,2012,t2,legislative
18113,99,FRANCAIS-DE-L'ETRANGER,73229,11390,245,11145,2012,t2,legislative
18114,99,FRANCAIS-DE-L'ETRANGER,88405,18178,503,17676,2012,t2,legislative
18115,99,FRANCAIS-DE-L'ETRANGER,96964,25242,620,24622,2012,t2,legislative
18116,99,FRANCAIS-DE-L'ETRANGER,79530,16507,398,16109,2012,t2,legislative
18117,99,FRANCAIS-DE-L'ETRANGER,106689,23872,365,23507,2012,t2,legislative
18118,99,FRANCAIS-DE-L'ETRANGER,89089,21449,411,21038,2012,t2,legislative
18119,99,FRANCAIS-DE-L'ETRANGER,109389,13965,394,13571,2012,t2,legislative
18120,99,FRANCAIS-DE-L'ETRANGER,97068,17724,332,17392,2012,t2,legislative
18121,99,FRANCAIS-DE-L'ETRANGER,91324,21038,488,20550,2012,t2,legislative
18122,99,FRANCAIS-DE-L'ETRANGER,78893,20569,647,19922,2012,t2,legislative
18123,1,AIN,86608,52701,1009,51692,2007,t2,legislative
18124,1,AIN,86694,45112,1296,43816,2007,t2,legislative
18125,2,AISNE,72343,44947,1420,43527,2007,t2,legislative
18126,2,AISNE,72225,46992,1255,45737,2007,t2,legislative
18127,2,AISNE,79252,46570,1145,45425,2007,t2,legislative
18128,2,AISNE,79984,48362,1724,46638,2007,t2,legislative
18129,3,ALLIER,58297,39089,1079,38010,2007,t2,legislative
18130,3,ALLIER,66360,44644,1206,43438,2007,t2,legislative
18131,3,ALLIER,70733,48039,1657,46382,2007,t2,legislative
18132,3,ALLIER,64842,43553,988,42565,2007,t2,legislative
18133,4,ALPES-DE-HAUTE-PROVENCE,58494,40929,1211,39718,2007,t2,legislative
18134,4,ALPES-DE-HAUTE-PROVENCE,60861,39926,1188,38738,2007,t2,legislative
18135,5,HAUTES-ALPES,57644,37483,1517,35966,2007,t2,legislative
18136,5,HAUTES-ALPES,45842,32202,855,31347,2007,t2,legislative
18137,6,ALPES-MARITIMES,58292,30942,797,30145,2007,t2,legislative
18138,6,ALPES-MARITIMES,67697,35982,2690,33292,2007,t2,legislative
18139,7,ARDECHE,73752,47805,1363,46442,2007,t2,legislative
18140,7,ARDECHE,88923,55883,1714,54169,2007,t2,legislative
18141,7,ARDECHE,73290,48413,1495,46918,2007,t2,legislative
18142,8,ARDENNES,73470,42846,1168,41678,2007,t2,legislative
18143,8,ARDENNES,66233,40411,856,39555,2007,t2,legislative
18144,9,ARIEGE,56035,35533,1797,33736,2007,t2,legislative
18145,9,ARIEGE,58234,38646,1477,37169,2007,t2,legislative
18146,10,AUBE,58061,33671,1171,32500,2007,t2,legislative
18147,10,AUBE,73367,40264,1908,38356,2007,t2,legislative
18148,11,AUDE,70191,48210,1784,46426,2007,t2,legislative
18149,11,AUDE,110417,74423,2290,72133,2007,t2,legislative
18150,11,AUDE,74180,51057,1874,49183,2007,t2,legislative
18151,12,AVEYRON,74595,50742,1816,48926,2007,t2,legislative
18152,12,AVEYRON,71707,49591,1913,47678,2007,t2,legislative
18153,12,AVEYRON,72114,49398,1977,47421,2007,t2,legislative
18154,13,BOUCHES-DU-RHONE,60365,33689,914,32775,2007,t2,legislative
18155,13,BOUCHES-DU-RHONE,46648,25720,872,24848,2007,t2,legislative
18156,13,BOUCHES-DU-RHONE,48045,24037,1001,23036,2007,t2,legislative
18157,13,BOUCHES-DU-RHONE,54181,29148,830,28318,2007,t2,legislative
18158,13,BOUCHES-DU-RHONE,52030,26532,792,25740,2007,t2,legislative
18159,13,BOUCHES-DU-RHONE,74123,42441,893,41548,2007,t2,legislative
18160,13,BOUCHES-DU-RHONE,123761,71901,2164,69737,2007,t2,legislative
18161,13,BOUCHES-DU-RHONE,100137,56777,1815,54962,2007,t2,legislative
18162,13,BOUCHES-DU-RHONE,89515,53911,1689,52222,2007,t2,legislative
18163,13,BOUCHES-DU-RHONE,101906,59536,2283,57253,2007,t2,legislative
18164,13,BOUCHES-DU-RHONE,100084,52247,8782,43465,2007,t2,legislative
18165,13,BOUCHES-DU-RHONE,84621,53859,1584,52275,2007,t2,legislative
18166,14,CALVADOS,71008,45855,930,44925,2007,t2,legislative
18167,14,CALVADOS,67478,41818,799,41019,2007,t2,legislative
18168,14,CALVADOS,74344,44246,1416,42830,2007,t2,legislative
18169,14,CALVADOS,101406,62067,1294,60773,2007,t2,legislative
18170,14,CALVADOS,88719,56349,1514,54835,2007,t2,legislative
18171,15,CANTAL,64764,41605,1247,40358,2007,t2,legislative
18172,16,CHARENTE,63710,39577,955,38622,2007,t2,legislative
18173,16,CHARENTE,62482,38820,1195,37625,2007,t2,legislative
18174,16,CHARENTE,69142,45862,1215,44647,2007,t2,legislative
18175,16,CHARENTE,65347,41510,1141,40369,2007,t2,legislative
18176,17,CHARENTE-MARITIME,96463,61863,3109,58754,2007,t2,legislative
18177,17,CHARENTE-MARITIME,92262,55711,1289,54422,2007,t2,legislative
18178,17,CHARENTE-MARITIME,79763,50552,1529,49023,2007,t2,legislative
18179,18,CHER,75002,44617,1354,43263,2007,t2,legislative
18180,18,CHER,70169,42230,1588,40642,2007,t2,legislative
18181,18,CHER,87452,54681,2018,52663,2007,t2,legislative
18182,19,CORREZE,65946,48881,1627,47254,2007,t2,legislative
18183,19,CORREZE,69666,46795,1438,45357,2007,t2,legislative
18184,19,CORREZE,51939,38336,1311,37025,2007,t2,legislative
18185,21,COTE-D'OR,67227,41524,1131,40393,2007,t2,legislative
18186,21,COTE-D'OR,64494,39297,997,38300,2007,t2,legislative
18187,21,COTE-D'OR,68647,40855,956,39899,2007,t2,legislative
18188,22,COTES-D'ARMOR,88480,57919,1433,56486,2007,t2,legislative
18189,22,COTES-D'ARMOR,91340,64824,1483,63341,2007,t2,legislative
18190,22,COTES-D'ARMOR,85571,60232,1077,59155,2007,t2,legislative
18191,22,COTES-D'ARMOR,79889,53971,1662,52309,2007,t2,legislative
18192,22,COTES-D'ARMOR,101749,69818,1530,68288,2007,t2,legislative
18193,23,CREUSE,50903,33187,1080,32107,2007,t2,legislative
18194,23,CREUSE,48947,34107,1724,32383,2007,t2,legislative
18195,24,DORDOGNE,74689,51756,1430,50326,2007,t2,legislative
18196,24,DORDOGNE,79156,53074,2059,51015,2007,t2,legislative
18197,24,DORDOGNE,70428,52631,1705,50926,2007,t2,legislative
18198,24,DORDOGNE,85677,61541,1865,59676,2007,t2,legislative
18199,25,DOUBS,71436,44220,1002,43218,2007,t2,legislative
18200,25,DOUBS,75379,47652,1302,46350,2007,t2,legislative
18201,25,DOUBS,66133,40906,1343,39563,2007,t2,legislative
18202,25,DOUBS,67556,41561,1351,40210,2007,t2,legislative
18203,26,DROME,73056,42978,1900,41078,2007,t2,legislative
18204,26,DROME,82524,49977,1599,48378,2007,t2,legislative
18205,26,DROME,98040,65048,2053,62995,2007,t2,legislative
18206,26,DROME,85630,51496,1321,50175,2007,t2,legislative
18207,27,EURE,83343,47617,1561,46056,2007,t2,legislative
18208,27,EURE,74686,44816,1502,43314,2007,t2,legislative
18209,27,EURE,83469,50029,1342,48687,2007,t2,legislative
18210,27,EURE,85006,49625,1644,47981,2007,t2,legislative
18211,28,EURE-ET-LOIR,85310,49200,2147,47053,2007,t2,legislative
18212,28,EURE-ET-LOIR,70133,38121,1505,36616,2007,t2,legislative
18213,28,EURE-ET-LOIR,71275,41896,1298,40598,2007,t2,legislative
18214,29,FINISTERE,84715,57950,1289,56661,2007,t2,legislative
18215,29,FINISTERE,71219,43694,1033,42661,2007,t2,legislative
18216,29,FINISTERE,92507,59583,1365,58218,2007,t2,legislative
18217,29,FINISTERE,82375,56199,1343,54856,2007,t2,legislative
18218,29,FINISTERE,88792,55364,1055,54309,2007,t2,legislative
18219,29,FINISTERE,88693,61126,1550,59576,2007,t2,legislative
18220,29,FINISTERE,79285,54314,1302,53012,2007,t2,legislative
18221,29,FINISTERE,82001,55961,1691,54270,2007,t2,legislative
18222,2A,CORSE-DU-SUD,44709,29999,653,29346,2007,t2,legislative
18223,2B,HAUTE-CORSE,51549,35864,1573,34291,2007,t2,legislative
18224,2B,HAUTE-CORSE,60371,45325,1080,44245,2007,t2,legislative
18225,30,GARD,83082,46913,1764,45149,2007,t2,legislative
18226,30,GARD,114607,66377,2164,64213,2007,t2,legislative
18227,30,GARD,113971,69044,2486,66558,2007,t2,legislative
18228,30,GARD,85468,54875,1991,52884,2007,t2,legislative
18229,30,GARD,93691,60594,2236,58358,2007,t2,legislative
18230,31,HAUTE-GARONNE,70421,40808,798,40010,2007,t2,legislative
18231,31,HAUTE-GARONNE,110643,72268,1867,70401,2007,t2,legislative
18232,31,HAUTE-GARONNE,85678,55642,1426,54216,2007,t2,legislative
18233,31,HAUTE-GARONNE,55578,32193,752,31441,2007,t2,legislative
18234,31,HAUTE-GARONNE,138352,87655,2497,85158,2007,t2,legislative
18235,31,HAUTE-GARONNE,130026,81898,2427,79471,2007,t2,legislative
18236,31,HAUTE-GARONNE,121369,80840,2457,78383,2007,t2,legislative
18237,31,HAUTE-GARONNE,82827,53215,2426,50789,2007,t2,legislative
18238,32,GERS,72219,49685,1654,48031,2007,t2,legislative
18239,32,GERS,68527,47702,1786,45916,2007,t2,legislative
18240,33,GIRONDE,82500,49624,1233,48391,2007,t2,legislative
18241,33,GIRONDE,60328,36840,746,36094,2007,t2,legislative
18242,33,GIRONDE,71943,43935,1573,42362,2007,t2,legislative
18243,33,GIRONDE,82750,48179,1391,46788,2007,t2,legislative
18244,33,GIRONDE,95590,59813,1889,57924,2007,t2,legislative
18245,33,GIRONDE,89294,56891,1394,55497,2007,t2,legislative
18246,33,GIRONDE,96627,61995,1777,60218,2007,t2,legislative
18247,33,GIRONDE,119359,77487,2021,75466,2007,t2,legislative
18248,33,GIRONDE,98804,65652,1919,63733,2007,t2,legislative
18249,33,GIRONDE,78583,50758,1537,49221,2007,t2,legislative
18250,33,GIRONDE,82996,53009,1831,51178,2007,t2,legislative
18251,34,HERAULT,76676,45651,1408,44243,2007,t2,legislative
18252,34,HERAULT,67096,40335,1059,39276,2007,t2,legislative
18253,34,HERAULT,126003,78534,2632,75902,2007,t2,legislative
18254,34,HERAULT,134221,87795,3268,84527,2007,t2,legislative
18255,34,HERAULT,95745,64527,2598,61929,2007,t2,legislative
18256,34,HERAULT,84611,49367,2120,47247,2007,t2,legislative
18257,34,HERAULT,119809,76311,2465,73846,2007,t2,legislative
18258,35,ILLE-ET-VILAINE,74489,41693,1164,40529,2007,t2,legislative
18259,35,ILLE-ET-VILAINE,98095,63049,1306,61743,2007,t2,legislative
18260,35,ILLE-ET-VILAINE,91325,58444,1478,56966,2007,t2,legislative
18261,35,ILLE-ET-VILAINE,109621,67621,1518,66103,2007,t2,legislative
18262,35,ILLE-ET-VILAINE,77986,44019,4932,39087,2007,t2,legislative
18263,35,ILLE-ET-VILAINE,99048,59211,1768,57443,2007,t2,legislative
18264,36,INDRE,55980,35160,1184,33976,2007,t2,legislative
18265,36,INDRE,64674,41528,1861,39667,2007,t2,legislative
18266,36,INDRE,56668,38647,1217,37430,2007,t2,legislative
18267,37,INDRE-ET-LOIRE,54537,31825,839,30986,2007,t2,legislative
18268,37,INDRE-ET-LOIRE,92050,56456,1445,55011,2007,t2,legislative
18269,37,INDRE-ET-LOIRE,92488,58954,1777,57177,2007,t2,legislative
18270,37,INDRE-ET-LOIRE,86402,53111,1440,51671,2007,t2,legislative
18271,37,INDRE-ET-LOIRE,78157,47722,1182,46540,2007,t2,legislative
18272,38,ISERE,79522,49588,3289,46299,2007,t2,legislative
18273,38,ISERE,73044,42342,951,41391,2007,t2,legislative
18274,38,ISERE,60329,33413,985,32428,2007,t2,legislative
18275,38,ISERE,85425,51473,923,50550,2007,t2,legislative
18276,38,ISERE,93080,59570,1032,58538,2007,t2,legislative
18277,38,ISERE,106187,56419,1418,55001,2007,t2,legislative
18278,38,ISERE,102616,58448,1689,56759,2007,t2,legislative
18279,38,ISERE,88996,55652,1094,54558,2007,t2,legislative
18280,39,JURA,55534,26092,5263,20829,2007,t2,legislative
18281,39,JURA,67875,43591,1113,42478,2007,t2,legislative
18282,40,LANDES,92984,61773,1972,59801,2007,t2,legislative
18283,40,LANDES,107678,72469,2100,70369,2007,t2,legislative
18284,40,LANDES,83227,58502,1479,57023,2007,t2,legislative
18285,41,LOIR-ET-CHER,90614,54693,2178,52515,2007,t2,legislative
18286,41,LOIR-ET-CHER,80085,49998,1518,48480,2007,t2,legislative
18287,41,LOIR-ET-CHER,70851,44425,2042,42383,2007,t2,legislative
18288,42,LOIRE,68931,37438,1143,36295,2007,t2,legislative
18289,42,LOIRE,50133,26983,694,26289,2007,t2,legislative
18290,42,LOIRE,79118,43877,1203,42674,2007,t2,legislative
18291,42,LOIRE,69174,39725,1181,38544,2007,t2,legislative
18292,42,LOIRE,69276,43135,1050,42085,2007,t2,legislative
18293,42,LOIRE,69472,39063,2045,37018,2007,t2,legislative
18294,43,HAUTE-LOIRE,80367,48987,3511,45476,2007,t2,legislative
18295,44,LOIRE-ATLANTIQUE,72900,45039,779,44260,2007,t2,legislative
18296,44,LOIRE-ATLANTIQUE,82595,49198,843,48355,2007,t2,legislative
18297,44,LOIRE-ATLANTIQUE,87046,50654,1115,49539,2007,t2,legislative
18298,44,LOIRE-ATLANTIQUE,79657,47489,1005,46484,2007,t2,legislative
18299,44,LOIRE-ATLANTIQUE,114928,73861,1678,72183,2007,t2,legislative
18300,44,LOIRE-ATLANTIQUE,77236,47651,1075,46576,2007,t2,legislative
18301,44,LOIRE-ATLANTIQUE,105595,64214,1307,62907,2007,t2,legislative
18302,44,LOIRE-ATLANTIQUE,79109,45496,1219,44277,2007,t2,legislative
18303,44,LOIRE-ATLANTIQUE,99467,61688,1857,59831,2007,t2,legislative
18304,44,LOIRE-ATLANTIQUE,99054,59954,1282,58672,2007,t2,legislative
18305,45,LOIRET,82673,49283,1270,48013,2007,t2,legislative
18306,45,LOIRET,81764,47130,1283,45847,2007,t2,legislative
18307,45,LOIRET,89953,52350,1723,50627,2007,t2,legislative
18308,45,LOIRET,89799,51827,1884,49943,2007,t2,legislative
18309,46,LOT,68790,49689,1634,48055,2007,t2,legislative
18310,46,LOT,64600,45290,1460,43830,2007,t2,legislative
18311,47,LOT-ET-GARONNE,85919,56082,2052,54030,2007,t2,legislative
18312,47,LOT-ET-GARONNE,77560,51821,2505,49316,2007,t2,legislative
18313,47,LOT-ET-GARONNE,76249,54522,1456,53066,2007,t2,legislative
18314,48,LOZERE,32052,22073,762,21311,2007,t2,legislative
18315,49,MAINE-ET-LOIRE,79737,46476,1305,45171,2007,t2,legislative
18316,49,MAINE-ET-LOIRE,85508,52188,1308,50880,2007,t2,legislative
18317,49,MAINE-ET-LOIRE,74423,41809,1516,40293,2007,t2,legislative
18318,49,MAINE-ET-LOIRE,90198,52829,2142,50687,2007,t2,legislative
18319,50,MANCHE,74468,45173,1256,43917,2007,t2,legislative
18320,50,MANCHE,76013,47655,3534,44121,2007,t2,legislative
18321,50,MANCHE,76800,45852,1475,44377,2007,t2,legislative
18322,50,MANCHE,73228,43927,1694,42233,2007,t2,legislative
18323,50,MANCHE,72116,44575,1064,43511,2007,t2,legislative
18324,51,MARNE,57918,30039,1242,28797,2007,t2,legislative
18325,51,MARNE,67389,37251,1220,36031,2007,t2,legislative
18326,51,MARNE,65610,34057,1795,32262,2007,t2,legislative
18327,51,MARNE,61220,32612,1184,31428,2007,t2,legislative
18328,53,MAYENNE,81702,50992,1100,49892,2007,t2,legislative
18329,53,MAYENNE,66988,36790,1943,34847,2007,t2,legislative
18330,54,MEURTHE-ET-MOSELLE,52930,29791,627,29164,2007,t2,legislative
18331,54,MEURTHE-ET-MOSELLE,78215,46360,1086,45274,2007,t2,legislative
18332,54,MEURTHE-ET-MOSELLE,58299,33402,859,32543,2007,t2,legislative
18333,54,MEURTHE-ET-MOSELLE,77951,45119,1398,43721,2007,t2,legislative
18334,54,MEURTHE-ET-MOSELLE,75350,46227,1281,44946,2007,t2,legislative
18335,54,MEURTHE-ET-MOSELLE,78422,43182,1280,41902,2007,t2,legislative
18336,54,MEURTHE-ET-MOSELLE,71293,37576,1121,36455,2007,t2,legislative
18337,55,MEUSE,80063,48637,1968,46669,2007,t2,legislative
18338,55,MEUSE,61649,37801,1218,36583,2007,t2,legislative
18339,56,MORBIHAN,104521,66180,1577,64603,2007,t2,legislative
18340,56,MORBIHAN,93219,58845,1901,56944,2007,t2,legislative
18341,56,MORBIHAN,83348,53337,1458,51879,2007,t2,legislative
18342,56,MORBIHAN,87241,55748,1499,54249,2007,t2,legislative
18343,56,MORBIHAN,81381,49601,1757,47844,2007,t2,legislative
18344,56,MORBIHAN,87089,57185,1346,55839,2007,t2,legislative
18345,57,MOSELLE,74265,38496,1194,37302,2007,t2,legislative
18346,57,MOSELLE,75378,37556,1500,36056,2007,t2,legislative
18347,57,MOSELLE,73486,33066,1284,31782,2007,t2,legislative
18348,57,MOSELLE,76551,39995,1201,38794,2007,t2,legislative
18349,57,MOSELLE,73849,37254,1251,36003,2007,t2,legislative
18350,57,MOSELLE,70846,34506,860,33646,2007,t2,legislative
18351,58,NIEVRE,55622,33110,1152,31958,2007,t2,legislative
18352,58,NIEVRE,60613,37928,1159,36769,2007,t2,legislative
18353,58,NIEVRE,53501,35196,992,34204,2007,t2,legislative
18354,59,NORD,58780,29753,974,28779,2007,t2,legislative
18355,59,NORD,73201,41121,1614,39507,2007,t2,legislative
18356,59,NORD,64299,34490,1132,33358,2007,t2,legislative
18357,59,NORD,72843,40746,1383,39363,2007,t2,legislative
18358,59,NORD,87980,51474,1430,50044,2007,t2,legislative
18359,59,NORD,81029,51734,1626,50108,2007,t2,legislative
18360,59,NORD,71032,36788,1284,35504,2007,t2,legislative
18361,59,NORD,71976,35216,1146,34070,2007,t2,legislative
18362,59,NORD,78409,38949,1863,37086,2007,t2,legislative
18363,59,NORD,86870,52440,1580,50860,2007,t2,legislative
18364,59,NORD,70349,38556,1889,36667,2007,t2,legislative
18365,59,NORD,65044,43428,1378,42050,2007,t2,legislative
18366,59,NORD,74138,43896,2055,41841,2007,t2,legislative
18367,59,NORD,81256,46741,2007,44734,2007,t2,legislative
18368,59,NORD,75022,43303,1182,42121,2007,t2,legislative
18369,59,NORD,79467,47745,1585,46160,2007,t2,legislative
18370,59,NORD,80242,30222,7352,22870,2007,t2,legislative
18371,59,NORD,82714,44393,1120,43273,2007,t2,legislative
18372,59,NORD,75038,47953,1557,46396,2007,t2,legislative
18373,59,NORD,66367,38619,1367,37252,2007,t2,legislative
18374,59,NORD,65008,38729,1257,37472,2007,t2,legislative
18375,60,OISE,79334,48609,1732,46877,2007,t2,legislative
18376,60,OISE,83956,49121,3197,45924,2007,t2,legislative
18377,60,OISE,69812,38835,1051,37784,2007,t2,legislative
18378,60,OISE,73684,44060,1794,42266,2007,t2,legislative
18379,61,ORNE,72495,43815,1208,42607,2007,t2,legislative
18380,62,PAS-DE-CALAIS,79842,52537,1857,50680,2007,t2,legislative
18381,62,PAS-DE-CALAIS,76518,50788,1538,49250,2007,t2,legislative
18382,62,PAS-DE-CALAIS,75375,54012,1455,52557,2007,t2,legislative
18383,62,PAS-DE-CALAIS,78965,50622,1449,49173,2007,t2,legislative
18384,62,PAS-DE-CALAIS,64862,39199,1618,37581,2007,t2,legislative
18385,62,PAS-DE-CALAIS,73693,45076,1508,43568,2007,t2,legislative
18386,62,PAS-DE-CALAIS,85824,49173,1860,47313,2007,t2,legislative
18387,62,PAS-DE-CALAIS,80924,52977,3056,49921,2007,t2,legislative
18388,62,PAS-DE-CALAIS,72399,39575,2024,37551,2007,t2,legislative
18389,62,PAS-DE-CALAIS,96647,55319,2459,52860,2007,t2,legislative
18390,62,PAS-DE-CALAIS,78977,42108,2124,39984,2007,t2,legislative
18391,62,PAS-DE-CALAIS,72398,38811,2100,36711,2007,t2,legislative
18392,62,PAS-DE-CALAIS,75658,43718,2646,41072,2007,t2,legislative
18393,63,PUY-DE-DOME,61592,34418,1026,33392,2007,t2,legislative
18394,63,PUY-DE-DOME,76654,47079,1334,45745,2007,t2,legislative
18395,63,PUY-DE-DOME,74696,46363,1550,44813,2007,t2,legislative
18396,63,PUY-DE-DOME,77667,50101,1330,48771,2007,t2,legislative
18397,63,PUY-DE-DOME,66316,43315,1103,42212,2007,t2,legislative
18398,63,PUY-DE-DOME,88363,59386,2212,57174,2007,t2,legislative
18399,64,PYRENEES-ATLANTIQUES,68348,44166,1426,42740,2007,t2,legislative
18400,64,PYRENEES-ATLANTIQUES,74311,46624,4674,41950,2007,t2,legislative
18401,64,PYRENEES-ATLANTIQUES,80211,53905,1977,51928,2007,t2,legislative
18402,64,PYRENEES-ATLANTIQUES,80289,57762,1304,56458,2007,t2,legislative
18403,64,PYRENEES-ATLANTIQUES,82914,49281,1978,47303,2007,t2,legislative
18404,64,PYRENEES-ATLANTIQUES,91778,54288,2102,52186,2007,t2,legislative
18405,65,HAUTES-PYRENEES,60111,39021,2051,36970,2007,t2,legislative
18406,65,HAUTES-PYRENEES,63202,43114,1285,41829,2007,t2,legislative
18407,65,HAUTES-PYRENEES,53430,34084,1353,32731,2007,t2,legislative
18408,66,PYRENEES-ORIENTALES,66218,38933,1356,37577,2007,t2,legislative
18409,66,PYRENEES-ORIENTALES,96745,58994,2742,56252,2007,t2,legislative
18410,66,PYRENEES-ORIENTALES,65988,42153,1951,40202,2007,t2,legislative
18411,66,PYRENEES-ORIENTALES,87370,58260,2400,55860,2007,t2,legislative
18412,67,BAS-RHIN,52672,28964,542,28422,2007,t2,legislative
18413,67,BAS-RHIN,51496,26326,585,25741,2007,t2,legislative
18414,67,BAS-RHIN,66888,32205,767,31438,2007,t2,legislative
18415,68,HAUT-RHIN,71930,39117,2327,36790,2007,t2,legislative
18416,68,HAUT-RHIN,54524,27618,1000,26618,2007,t2,legislative
18417,69,RHONE,63766,35304,867,34437,2007,t2,legislative
18418,69,RHONE,71688,42136,768,41368,2007,t2,legislative
18419,69,RHONE,67334,38208,832,37376,2007,t2,legislative
18420,69,RHONE,75058,43153,1226,41927,2007,t2,legislative
18421,69,RHONE,74406,41175,1051,40124,2007,t2,legislative
18422,69,RHONE,60697,32389,651,31738,2007,t2,legislative
18423,69,RHONE,89802,52275,1466,50809,2007,t2,legislative
18424,69,RHONE,80136,46928,1220,45708,2007,t2,legislative
18425,69,RHONE,74049,42561,891,41670,2007,t2,legislative
18426,69,RHONE,91374,51291,1040,50251,2007,t2,legislative
18427,69,RHONE,50332,26058,853,25205,2007,t2,legislative
18428,70,HAUTE-SAONE,64111,42056,1763,40293,2007,t2,legislative
18429,71,SAONE-ET-LOIRE,67423,39577,1091,38486,2007,t2,legislative
18430,71,SAONE-ET-LOIRE,64527,41465,1018,40447,2007,t2,legislative
18431,71,SAONE-ET-LOIRE,66692,42550,1311,41239,2007,t2,legislative
18432,71,SAONE-ET-LOIRE,61842,41229,965,40264,2007,t2,legislative
18433,71,SAONE-ET-LOIRE,64590,39728,984,38744,2007,t2,legislative
18434,71,SAONE-ET-LOIRE,85117,59524,1198,58326,2007,t2,legislative
18435,72,SARTHE,71449,40405,1221,39184,2007,t2,legislative
18436,72,SARTHE,82209,45959,1222,44737,2007,t2,legislative
18437,72,SARTHE,84015,49645,1431,48214,2007,t2,legislative
18438,72,SARTHE,86793,51689,1329,50360,2007,t2,legislative
18439,73,SAVOIE,95792,55303,1273,54030,2007,t2,legislative
18440,74,HAUTE-SAVOIE,86636,41486,4675,36811,2007,t2,legislative
18441,74,HAUTE-SAVOIE,106688,54059,1830,52229,2007,t2,legislative
18442,75,PARIS,63045,37817,723,37094,2007,t2,legislative
18443,75,PARIS,53581,33409,1356,32053,2007,t2,legislative
18444,75,PARIS,49766,28275,752,27523,2007,t2,legislative
18445,75,PARIS,66026,38172,889,37283,2007,t2,legislative
18446,75,PARIS,63796,38659,800,37859,2007,t2,legislative
18447,75,PARIS,70824,45580,1209,44371,2007,t2,legislative
18448,75,PARIS,61837,36204,873,35331,2007,t2,legislative
18449,75,PARIS,65236,41783,781,41002,2007,t2,legislative
18450,75,PARIS,59985,37896,795,37101,2007,t2,legislative
18451,75,PARIS,67807,39066,989,38077,2007,t2,legislative
18452,75,PARIS,70847,42710,934,41776,2007,t2,legislative
18453,75,PARIS,56422,32524,617,31907,2007,t2,legislative
18454,75,PARIS,55832,32170,735,31435,2007,t2,legislative
18455,75,PARIS,48135,25700,677,25023,2007,t2,legislative
18456,75,PARIS,65984,36457,1091,35366,2007,t2,legislative
18457,75,PARIS,75326,43089,990,42099,2007,t2,legislative
18458,76,SEINE-MARITIME,61131,35733,763,34970,2007,t2,legislative
18459,76,SEINE-MARITIME,87826,54818,1513,53305,2007,t2,legislative
18460,76,SEINE-MARITIME,56934,32071,1195,30876,2007,t2,legislative
18461,76,SEINE-MARITIME,72431,42076,1304,40772,2007,t2,legislative
18462,76,SEINE-MARITIME,89066,54779,1172,53607,2007,t2,legislative
18463,76,SEINE-MARITIME,79322,45909,1277,44632,2007,t2,legislative
18464,76,SEINE-MARITIME,59165,33271,1078,32193,2007,t2,legislative
18465,76,SEINE-MARITIME,52300,26101,989,25112,2007,t2,legislative
18466,76,SEINE-MARITIME,85480,53618,1399,52219,2007,t2,legislative
18467,76,SEINE-MARITIME,84826,54904,1316,53588,2007,t2,legislative
18468,76,SEINE-MARITIME,75595,49255,1192,48063,2007,t2,legislative
18469,77,SEINE-ET-MARNE,88513,47516,1374,46142,2007,t2,legislative
18470,77,SEINE-ET-MARNE,77273,37048,5124,31924,2007,t2,legislative
18471,77,SEINE-ET-MARNE,76549,42832,1786,41046,2007,t2,legislative
18472,77,SEINE-ET-MARNE,92684,50178,1345,48833,2007,t2,legislative
18473,77,SEINE-ET-MARNE,88625,48095,1071,47024,2007,t2,legislative
18474,77,SEINE-ET-MARNE,111298,60143,1143,59000,2007,t2,legislative
18475,77,SEINE-ET-MARNE,107418,58429,1436,56993,2007,t2,legislative
18476,78,YVELINES,91525,51205,2155,49050,2007,t2,legislative
18477,78,YVELINES,75534,42273,942,41331,2007,t2,legislative
18478,78,YVELINES,67331,36707,1457,35250,2007,t2,legislative
18479,78,YVELINES,101190,59567,2035,57532,2007,t2,legislative
18480,78,YVELINES,58013,31617,953,30664,2007,t2,legislative
18481,78,YVELINES,71604,38807,1876,36931,2007,t2,legislative
18482,79,DEUX-SEVRES,64320,37585,997,36588,2007,t2,legislative
18483,79,DEUX-SEVRES,73668,47397,1204,46193,2007,t2,legislative
18484,79,DEUX-SEVRES,70152,44290,1309,42981,2007,t2,legislative
18485,80,SOMME,60147,33169,1790,31379,2007,t2,legislative
18486,80,SOMME,64509,37361,1049,36312,2007,t2,legislative
18487,80,SOMME,68480,49147,1886,47261,2007,t2,legislative
18488,80,SOMME,73099,47730,2098,45632,2007,t2,legislative
18489,80,SOMME,66051,42568,1114,41454,2007,t2,legislative
18490,80,SOMME,78871,51543,1915,49628,2007,t2,legislative
18491,81,TARN,57444,38648,2360,36288,2007,t2,legislative
18492,81,TARN,79976,54631,1552,53079,2007,t2,legislative
18493,81,TARN,59752,36395,5636,30759,2007,t2,legislative
18494,81,TARN,80069,54566,2095,52471,2007,t2,legislative
18495,82,TARN-ET-GARONNE,82026,55856,2272,53584,2007,t2,legislative
18496,82,TARN-ET-GARONNE,84398,55201,2328,52873,2007,t2,legislative
18497,83,VAR,121416,67919,2672,65247,2007,t2,legislative
18498,84,VAUCLUSE,71552,41676,2038,39638,2007,t2,legislative
18499,84,VAUCLUSE,120712,74020,2527,71493,2007,t2,legislative
18500,84,VAUCLUSE,97321,57661,2321,55340,2007,t2,legislative
18501,84,VAUCLUSE,82854,50285,2988,47297,2007,t2,legislative
18502,85,VENDEE,95366,53058,1988,51070,2007,t2,legislative
18503,85,VENDEE,91771,55226,1570,53656,2007,t2,legislative
18504,86,VIENNE,82889,51411,1412,49999,2007,t2,legislative
18505,86,VIENNE,73476,47270,1213,46057,2007,t2,legislative
18506,86,VIENNE,67729,44532,1402,43130,2007,t2,legislative
18507,86,VIENNE,75889,45265,2378,42887,2007,t2,legislative
18508,87,HAUTE-VIENNE,54280,35497,1184,34313,2007,t2,legislative
18509,87,HAUTE-VIENNE,74002,51953,2440,49513,2007,t2,legislative
18510,87,HAUTE-VIENNE,66256,44246,1522,42724,2007,t2,legislative
18511,87,HAUTE-VIENNE,72013,46420,1896,44524,2007,t2,legislative
18512,88,VOSGES,75670,43591,2337,41254,2007,t2,legislative
18513,88,VOSGES,69407,43336,1434,41902,2007,t2,legislative
18514,89,YONNE,79127,47265,2013,45252,2007,t2,legislative
18515,89,YONNE,73861,44605,1439,43166,2007,t2,legislative
18516,89,YONNE,93241,54187,2469,51718,2007,t2,legislative
18517,90,TERRITOIRE DE BELFORT,46745,29277,1187,28090,2007,t2,legislative
18518,90,TERRITOIRE DE BELFORT,47484,30376,1556,28820,2007,t2,legislative
18519,91,ESSONNE,67362,36671,869,35802,2007,t2,legislative
18520,91,ESSONNE,93545,55125,1549,53576,2007,t2,legislative
18521,91,ESSONNE,84637,50424,1257,49167,2007,t2,legislative
18522,91,ESSONNE,65743,41203,971,40232,2007,t2,legislative
18523,91,ESSONNE,73040,44671,1143,43528,2007,t2,legislative
18524,91,ESSONNE,71880,40452,1012,39440,2007,t2,legislative
18525,91,ESSONNE,74159,42862,929,41933,2007,t2,legislative
18526,91,ESSONNE,60771,34898,896,34002,2007,t2,legislative
18527,92,HAUTS-DE-SEINE,59278,28934,824,28110,2007,t2,legislative
18528,92,HAUTS-DE-SEINE,62438,33868,1260,32608,2007,t2,legislative
18529,92,HAUTS-DE-SEINE,67297,37777,1069,36708,2007,t2,legislative
18530,92,HAUTS-DE-SEINE,68265,37368,2119,35249,2007,t2,legislative
18531,92,HAUTS-DE-SEINE,66489,38223,1116,37107,2007,t2,legislative
18532,92,HAUTS-DE-SEINE,65594,38461,875,37586,2007,t2,legislative
18533,92,HAUTS-DE-SEINE,85816,53615,1214,52401,2007,t2,legislative
18534,92,HAUTS-DE-SEINE,85159,51058,1843,49215,2007,t2,legislative
18535,93,SEINE-SAINT-DENIS,50448,24189,750,23439,2007,t2,legislative
18536,93,SEINE-SAINT-DENIS,50028,23054,788,22266,2007,t2,legislative
18537,93,SEINE-SAINT-DENIS,45095,20574,870,19704,2007,t2,legislative
18538,93,SEINE-SAINT-DENIS,45413,22579,573,22006,2007,t2,legislative
18539,93,SEINE-SAINT-DENIS,53222,27056,676,26380,2007,t2,legislative
18540,93,SEINE-SAINT-DENIS,60998,31659,1084,30575,2007,t2,legislative
18541,93,SEINE-SAINT-DENIS,49878,17059,5147,11912,2007,t2,legislative
18542,93,SEINE-SAINT-DENIS,60718,33263,1079,32184,2007,t2,legislative
18543,93,SEINE-SAINT-DENIS,55283,28420,830,27590,2007,t2,legislative
18544,93,SEINE-SAINT-DENIS,52422,28336,852,27484,2007,t2,legislative
18545,93,SEINE-SAINT-DENIS,58750,31532,761,30771,2007,t2,legislative
18546,93,SEINE-SAINT-DENIS,61849,33545,913,32632,2007,t2,legislative
18547,93,SEINE-SAINT-DENIS,69561,38931,1488,37443,2007,t2,legislative
18548,94,VAL-DE-MARNE,54868,31088,2021,29067,2007,t2,legislative
18549,94,VAL-DE-MARNE,64455,33557,842,32715,2007,t2,legislative
18550,94,VAL-DE-MARNE,68560,37557,1067,36490,2007,t2,legislative
18551,94,VAL-DE-MARNE,70262,38917,1432,37485,2007,t2,legislative
18552,94,VAL-DE-MARNE,61976,33460,1012,32448,2007,t2,legislative
18553,94,VAL-DE-MARNE,77903,43658,1123,42535,2007,t2,legislative
18554,94,VAL-DE-MARNE,58879,32748,932,31816,2007,t2,legislative
18555,94,VAL-DE-MARNE,51790,26146,926,25220,2007,t2,legislative
18556,94,VAL-DE-MARNE,61144,31553,1091,30462,2007,t2,legislative
18557,94,VAL-DE-MARNE,57674,31393,935,30458,2007,t2,legislative
18558,94,VAL-DE-MARNE,64529,36829,997,35832,2007,t2,legislative
18559,95,VAL-D'OISE,76973,44321,1079,43242,2007,t2,legislative
18560,95,VAL-D'OISE,114930,64396,1718,62678,2007,t2,legislative
18561,95,VAL-D'OISE,83938,46115,1237,44878,2007,t2,legislative
18562,95,VAL-D'OISE,71858,40225,1108,39117,2007,t2,legislative
18563,95,VAL-D'OISE,64076,34418,1126,33292,2007,t2,legislative
18564,95,VAL-D'OISE,72546,38642,1054,37588,2007,t2,legislative
18565,95,VAL-D'OISE,80868,44284,1038,43246,2007,t2,legislative
18566,95,VAL-D'OISE,48838,26088,571,25517,2007,t2,legislative
18567,95,VAL-D'OISE,65355,34705,893,33812,2007,t2,legislative
18568,971,GUADELOUPE,62429,25321,2272,23049,2007,t2,legislative
18569,971,GUADELOUPE,88463,38147,2177,35970,2007,t2,legislative
18570,971,GUADELOUPE,81899,33578,2495,31083,2007,t2,legislative
18571,971,GUADELOUPE,70704,31973,1864,30109,2007,t2,legislative
18572,972,MARTINIQUE,60751,27433,1713,25720,2007,t2,legislative
18573,972,MARTINIQUE,61725,27071,1471,25600,2007,t2,legislative
18574,972,MARTINIQUE,62264,25218,1527,23691,2007,t2,legislative
18575,972,MARTINIQUE,103516,41661,2699,38962,2007,t2,legislative
18576,973,GUYANE,22318,9476,495,8981,2007,t2,legislative
18577,973,GUYANE,40489,17896,850,17046,2007,t2,legislative
18578,974,LA REUNION,83856,45989,2831,43158,2007,t2,legislative
18579,974,LA REUNION,108157,62300,3732,58568,2007,t2,legislative
18580,974,LA REUNION,126885,82572,4354,78218,2007,t2,legislative
18581,974,LA REUNION,93834,62737,2622,60115,2007,t2,legislative
18582,974,LA REUNION,100198,58909,2961,55948,2007,t2,legislative
18583,975,SAINT-PIERRE-ET-MIQUELON,4923,3740,198,3542,2007,t2,legislative
18584,985,MAYOTTE,64666,34647,1268,33379,2007,t2,legislative
18585,986,WALLIS ET FUTUNA,11157,8089,72,8017,2007,t2,legislative
18586,987,POLYNESIE FRANCAISE,93812,60876,848,60028,2007,t2,legislative
18587,987,POLYNESIE FRANCAISE,73900,44446,1051,43395,2007,t2,legislative
18588,988,NOUVELLE-CALEDONIE,68928,39789,1166,38623,2007,t2,legislative
18589,988,NOUVELLE-CALEDONIE,77938,48462,1240,47222,2007,t2,legislative
18590,1,AIN,80535,47889,1375,46514,2002,t2,legislative
18591,1,AIN,83244,43882,2180,41702,2002,t2,legislative
18592,1,AIN,77412,41991,1837,40154,2002,t2,legislative
18593,1,AIN,98265,54743,1714,53029,2002,t2,legislative
18594,2,AISNE,70131,42740,2276,40464,2002,t2,legislative
18595,2,AISNE,73005,46574,1693,44881,2002,t2,legislative
18596,2,AISNE,72654,44304,2048,42256,2002,t2,legislative
18597,2,AISNE,76159,45052,1717,43335,2002,t2,legislative
18598,2,AISNE,75338,42738,4915,37823,2002,t2,legislative
18599,3,ALLIER,57891,38011,1491,36520,2002,t2,legislative
18600,3,ALLIER,65642,44057,1659,42398,2002,t2,legislative
18601,3,ALLIER,70143,47627,1879,45748,2002,t2,legislative
18602,3,ALLIER,62819,40927,1360,39567,2002,t2,legislative
18603,4,ALPES-DE-HAUTE-PROVENCE,53747,35158,1872,33286,2002,t2,legislative
18604,4,ALPES-DE-HAUTE-PROVENCE,55400,35956,1900,34056,2002,t2,legislative
18605,5,HAUTES-ALPES,52838,35375,1873,33502,2002,t2,legislative
18606,5,HAUTES-ALPES,42511,28237,836,27401,2002,t2,legislative
18607,6,ALPES-MARITIMES,61563,31363,1602,29761,2002,t2,legislative
18608,6,ALPES-MARITIMES,67364,36126,473,35653,2002,t2,legislative
18609,6,ALPES-MARITIMES,72584,34572,3191,31381,2002,t2,legislative
18610,6,ALPES-MARITIMES,70354,37158,3932,33226,2002,t2,legislative
18611,6,ALPES-MARITIMES,83333,44437,5384,39053,2002,t2,legislative
18612,6,ALPES-MARITIMES,95017,55094,2235,52859,2002,t2,legislative
18613,6,ALPES-MARITIMES,60983,33726,2402,31324,2002,t2,legislative
18614,6,ALPES-MARITIMES,94702,59603,1439,58164,2002,t2,legislative
18615,7,ARDECHE,68975,45765,1507,44258,2002,t2,legislative
18616,7,ARDECHE,83126,51473,2004,49469,2002,t2,legislative
18617,7,ARDECHE,68117,45812,2573,43239,2002,t2,legislative
18618,8,ARDENNES,70389,43133,1413,41720,2002,t2,legislative
18619,8,ARDENNES,64150,36771,1350,35421,2002,t2,legislative
18620,9,ARIEGE,54069,33598,2808,30790,2002,t2,legislative
18621,9,ARIEGE,55166,36417,2354,34063,2002,t2,legislative
18622,10,AUBE,55574,32681,2117,30564,2002,t2,legislative
18623,10,AUBE,68832,40916,1979,38937,2002,t2,legislative
18624,10,AUBE,69793,39148,1886,37262,2002,t2,legislative
18625,11,AUDE,65670,44047,2709,41338,2002,t2,legislative
18626,11,AUDE,99717,64877,3624,61253,2002,t2,legislative
18627,11,AUDE,71634,48827,2751,46076,2002,t2,legislative
18628,12,AVEYRON,72566,48255,2347,45908,2002,t2,legislative
18629,12,AVEYRON,71860,49534,2017,47517,2002,t2,legislative
18630,12,AVEYRON,70318,49390,2213,47177,2002,t2,legislative
18631,13,BOUCHES-DU-RHONE,55164,31185,1477,29708,2002,t2,legislative
18632,13,BOUCHES-DU-RHONE,43095,23284,1253,22031,2002,t2,legislative
18633,13,BOUCHES-DU-RHONE,42836,21430,950,20480,2002,t2,legislative
18634,13,BOUCHES-DU-RHONE,47847,24928,2299,22629,2002,t2,legislative
18635,13,BOUCHES-DU-RHONE,63488,33134,2759,30375,2002,t2,legislative
18636,13,BOUCHES-DU-RHONE,46636,23516,1152,22364,2002,t2,legislative
18637,13,BOUCHES-DU-RHONE,64342,37095,651,36444,2002,t2,legislative
18638,13,BOUCHES-DU-RHONE,83557,45230,5426,39804,2002,t2,legislative
18639,13,BOUCHES-DU-RHONE,112111,66768,3344,63424,2002,t2,legislative
18640,13,BOUCHES-DU-RHONE,88352,52654,2855,49799,2002,t2,legislative
18641,13,BOUCHES-DU-RHONE,100029,56388,3052,53336,2002,t2,legislative
18642,13,BOUCHES-DU-RHONE,83411,48873,2570,46303,2002,t2,legislative
18643,13,BOUCHES-DU-RHONE,91027,55534,2688,52846,2002,t2,legislative
18644,13,BOUCHES-DU-RHONE,90026,53564,3937,49627,2002,t2,legislative
18645,13,BOUCHES-DU-RHONE,79399,48471,2492,45979,2002,t2,legislative
18646,14,CALVADOS,69518,42586,1014,41572,2002,t2,legislative
18647,14,CALVADOS,64787,38633,1618,37015,2002,t2,legislative
18648,14,CALVADOS,71620,43626,1593,42033,2002,t2,legislative
18649,14,CALVADOS,94415,55597,1948,53649,2002,t2,legislative
18650,14,CALVADOS,83596,54221,1749,52472,2002,t2,legislative
18651,15,CANTAL,64053,43544,2087,41457,2002,t2,legislative
18652,16,CHARENTE,62611,39020,1320,37700,2002,t2,legislative
18653,16,CHARENTE,60799,38045,1279,36766,2002,t2,legislative
18654,16,CHARENTE,69338,46760,1932,44828,2002,t2,legislative
18655,16,CHARENTE,62748,38098,1493,36605,2002,t2,legislative
18656,17,CHARENTE-MARITIME,87545,55514,1332,54182,2002,t2,legislative
18657,17,CHARENTE-MARITIME,83250,51355,1552,49803,2002,t2,legislative
18658,17,CHARENTE-MARITIME,76495,48489,1882,46607,2002,t2,legislative
18659,17,CHARENTE-MARITIME,81861,49503,1929,47574,2002,t2,legislative
18660,17,CHARENTE-MARITIME,89664,53568,2084,51484,2002,t2,legislative
18661,18,CHER,74211,44586,1779,42807,2002,t2,legislative
18662,18,CHER,68779,40790,2004,38786,2002,t2,legislative
18663,18,CHER,85521,54047,1927,52120,2002,t2,legislative
18664,19,CORREZE,65465,51956,1578,50378,2002,t2,legislative
18665,19,CORREZE,66322,46542,1747,44795,2002,t2,legislative
18666,19,CORREZE,52525,38659,1569,37090,2002,t2,legislative
18667,21,COTE-D'OR,63487,41865,1165,40700,2002,t2,legislative
18668,21,COTE-D'OR,58518,35756,1385,34371,2002,t2,legislative
18669,21,COTE-D'OR,63336,36966,1260,35706,2002,t2,legislative
18670,21,COTE-D'OR,77579,49114,1607,47507,2002,t2,legislative
18671,22,COTES-D'ARMOR,83801,56014,1841,54173,2002,t2,legislative
18672,22,COTES-D'ARMOR,86069,61115,1758,59357,2002,t2,legislative
18673,22,COTES-D'ARMOR,83253,60315,1653,58662,2002,t2,legislative
18674,22,COTES-D'ARMOR,79114,56091,1897,54194,2002,t2,legislative
18675,22,COTES-D'ARMOR,97504,67251,1926,65325,2002,t2,legislative
18676,23,CREUSE,51313,34584,1292,33292,2002,t2,legislative
18677,23,CREUSE,50479,35590,1391,34199,2002,t2,legislative
18678,24,DORDOGNE,72919,50036,2590,47446,2002,t2,legislative
18679,24,DORDOGNE,77492,52145,2376,49769,2002,t2,legislative
18680,24,DORDOGNE,71047,53154,2344,50810,2002,t2,legislative
18681,24,DORDOGNE,82977,61328,2777,58551,2002,t2,legislative
18682,25,DOUBS,65446,41612,1902,39710,2002,t2,legislative
18683,25,DOUBS,69731,45845,1299,44546,2002,t2,legislative
18684,25,DOUBS,64358,40868,1900,38968,2002,t2,legislative
18685,25,DOUBS,65603,39495,1921,37574,2002,t2,legislative
18686,25,DOUBS,70530,41012,2271,38741,2002,t2,legislative
18687,26,DROME,68305,41999,1113,40886,2002,t2,legislative
18688,26,DROME,74358,45733,2005,43728,2002,t2,legislative
18689,26,DROME,90331,59920,2296,57624,2002,t2,legislative
18690,26,DROME,77563,47885,1728,46157,2002,t2,legislative
18691,27,EURE,78271,45770,1785,43985,2002,t2,legislative
18692,27,EURE,70468,43719,1747,41972,2002,t2,legislative
18693,27,EURE,73318,46208,1438,44770,2002,t2,legislative
18694,27,EURE,77234,45371,2012,43359,2002,t2,legislative
18695,27,EURE,79693,47773,1912,45861,2002,t2,legislative
18696,28,EURE-ET-LOIR,78947,48362,1965,46397,2002,t2,legislative
18697,28,EURE-ET-LOIR,64745,35930,1795,34135,2002,t2,legislative
18698,28,EURE-ET-LOIR,69333,41589,1683,39906,2002,t2,legislative
18699,28,EURE-ET-LOIR,65630,41190,2086,39104,2002,t2,legislative
18700,29,FINISTERE,79406,56242,1625,54617,2002,t2,legislative
18701,29,FINISTERE,68033,42796,895,41901,2002,t2,legislative
18702,29,FINISTERE,86631,57095,1285,55810,2002,t2,legislative
18703,29,FINISTERE,78573,55669,1100,54569,2002,t2,legislative
18704,29,FINISTERE,85609,61428,1532,59896,2002,t2,legislative
18705,29,FINISTERE,76665,53020,1446,51574,2002,t2,legislative
18706,29,FINISTERE,77808,53224,1663,51561,2002,t2,legislative
18707,2A,CORSE-DU-SUD,41173,25589,1205,24384,2002,t2,legislative
18708,2A,CORSE-DU-SUD,45365,25691,2664,23027,2002,t2,legislative
18709,2B,HAUTE-CORSE,47660,29957,2160,27797,2002,t2,legislative
18710,2B,HAUTE-CORSE,57200,36911,1131,35780,2002,t2,legislative
18711,30,GARD,77124,44532,2139,42393,2002,t2,legislative
18712,30,GARD,102284,62408,1407,61001,2002,t2,legislative
18713,30,GARD,103233,66316,1754,64562,2002,t2,legislative
18714,30,GARD,79749,51808,2708,49100,2002,t2,legislative
18715,30,GARD,84460,53091,2829,50262,2002,t2,legislative
18716,31,HAUTE-GARONNE,64030,37283,1071,36212,2002,t2,legislative
18717,31,HAUTE-GARONNE,99806,65071,2550,62521,2002,t2,legislative
18718,31,HAUTE-GARONNE,79141,53611,1604,52007,2002,t2,legislative
18719,31,HAUTE-GARONNE,50340,30468,928,29540,2002,t2,legislative
18720,31,HAUTE-GARONNE,120130,76286,3255,73031,2002,t2,legislative
18721,31,HAUTE-GARONNE,113013,72067,3036,69031,2002,t2,legislative
18722,31,HAUTE-GARONNE,108006,72833,3226,69607,2002,t2,legislative
18723,31,HAUTE-GARONNE,79172,51861,2640,49221,2002,t2,legislative
18724,32,GERS,70216,48690,2227,46463,2002,t2,legislative
18725,32,GERS,65426,45935,2220,43715,2002,t2,legislative
18726,33,GIRONDE,72885,43478,1353,42125,2002,t2,legislative
18727,33,GIRONDE,52179,29900,846,29054,2002,t2,legislative
18728,33,GIRONDE,64918,41035,1732,39303,2002,t2,legislative
18729,33,GIRONDE,77040,44126,2055,42071,2002,t2,legislative
18730,33,GIRONDE,86231,53877,2029,51848,2002,t2,legislative
18731,33,GIRONDE,80087,52085,1478,50607,2002,t2,legislative
18732,33,GIRONDE,90666,57150,1759,55391,2002,t2,legislative
18733,33,GIRONDE,105636,69022,2413,66609,2002,t2,legislative
18734,33,GIRONDE,91089,59450,2901,56549,2002,t2,legislative
18735,33,GIRONDE,74278,48786,1990,46796,2002,t2,legislative
18736,33,GIRONDE,76125,49029,2123,46906,2002,t2,legislative
18737,34,HERAULT,67664,42040,1958,40082,2002,t2,legislative
18738,34,HERAULT,57786,36995,1460,35535,2002,t2,legislative
18739,34,HERAULT,114718,73963,3307,70656,2002,t2,legislative
18740,34,HERAULT,118927,77235,4911,72324,2002,t2,legislative
18741,34,HERAULT,88367,58340,3561,54779,2002,t2,legislative
18742,34,HERAULT,80288,50269,1337,48932,2002,t2,legislative
18743,34,HERAULT,107445,70296,1935,68361,2002,t2,legislative
18744,35,ILLE-ET-VILAINE,71900,41140,1138,40002,2002,t2,legislative
18745,35,ILLE-ET-VILAINE,90031,58761,1328,57433,2002,t2,legislative
18746,35,ILLE-ET-VILAINE,83468,54454,1132,53322,2002,t2,legislative
18747,35,ILLE-ET-VILAINE,98881,60701,2292,58409,2002,t2,legislative
18748,35,ILLE-ET-VILAINE,74119,44410,1633,42777,2002,t2,legislative
18749,36,INDRE,55392,35166,1382,33784,2002,t2,legislative
18750,36,INDRE,64277,43710,1610,42100,2002,t2,legislative
18751,36,INDRE,57190,39060,1628,37432,2002,t2,legislative
18752,37,INDRE-ET-LOIRE,53768,30829,1270,29559,2002,t2,legislative
18753,37,INDRE-ET-LOIRE,85120,54202,1717,52485,2002,t2,legislative
18754,37,INDRE-ET-LOIRE,87871,57112,1802,55310,2002,t2,legislative
18755,37,INDRE-ET-LOIRE,82131,50421,1861,48560,2002,t2,legislative
18756,37,INDRE-ET-LOIRE,73570,45146,1539,43607,2002,t2,legislative
18757,38,ISERE,74818,48051,1117,46934,2002,t2,legislative
18758,38,ISERE,66002,37528,1233,36295,2002,t2,legislative
18759,38,ISERE,54408,31386,1183,30203,2002,t2,legislative
18760,38,ISERE,77867,47099,1142,45957,2002,t2,legislative
18761,38,ISERE,83192,51642,1361,50281,2002,t2,legislative
18762,38,ISERE,92601,49472,1821,47651,2002,t2,legislative
18763,38,ISERE,88408,48333,1694,46639,2002,t2,legislative
18764,38,ISERE,93861,52916,2668,50248,2002,t2,legislative
18765,38,ISERE,80432,49511,1561,47950,2002,t2,legislative
18766,39,JURA,53716,31266,1465,29801,2002,t2,legislative
18767,39,JURA,65417,43083,2033,41050,2002,t2,legislative
18768,40,LANDES,84354,56635,2366,54269,2002,t2,legislative
18769,40,LANDES,95934,64045,2357,61688,2002,t2,legislative
18770,40,LANDES,79301,54255,2227,52028,2002,t2,legislative
18771,41,LOIR-ET-CHER,86801,53992,2139,51853,2002,t2,legislative
18772,41,LOIR-ET-CHER,76928,48872,1781,47091,2002,t2,legislative
18773,42,LOIRE,66492,36484,1174,35310,2002,t2,legislative
18774,42,LOIRE,50487,25787,1201,24586,2002,t2,legislative
18775,42,LOIRE,75070,42046,1445,40601,2002,t2,legislative
18776,42,LOIRE,67008,38556,1786,36770,2002,t2,legislative
18777,42,LOIRE,68452,41407,1166,40241,2002,t2,legislative
18778,42,LOIRE,92536,52098,2107,49991,2002,t2,legislative
18779,43,HAUTE-LOIRE,87652,52156,2608,49548,2002,t2,legislative
18780,43,HAUTE-LOIRE,78789,49016,2341,46675,2002,t2,legislative
18781,44,LOIRE-ATLANTIQUE,69238,42341,772,41569,2002,t2,legislative
18782,44,LOIRE-ATLANTIQUE,76572,45086,778,44308,2002,t2,legislative
18783,44,LOIRE-ATLANTIQUE,74167,45044,1105,43939,2002,t2,legislative
18784,44,LOIRE-ATLANTIQUE,104279,64791,1789,63002,2002,t2,legislative
18785,44,LOIRE-ATLANTIQUE,94613,61759,1389,60370,2002,t2,legislative
18786,44,LOIRE-ATLANTIQUE,72256,41263,1856,39407,2002,t2,legislative
18787,44,LOIRE-ATLANTIQUE,86230,52708,1766,50942,2002,t2,legislative
18788,45,LOIRET,77720,48128,1703,46425,2002,t2,legislative
18789,45,LOIRET,77452,46701,1659,45042,2002,t2,legislative
18790,45,LOIRET,83337,49966,2151,47815,2002,t2,legislative
18791,45,LOIRET,88561,52363,2380,49983,2002,t2,legislative
18792,45,LOIRET,83676,50369,2311,48058,2002,t2,legislative
18793,46,LOT,65720,47413,2127,45286,2002,t2,legislative
18794,46,LOT,62733,45634,1930,43704,2002,t2,legislative
18795,47,LOT-ET-GARONNE,80198,53365,2902,50463,2002,t2,legislative
18796,47,LOT-ET-GARONNE,75583,51349,3176,48173,2002,t2,legislative
18797,47,LOT-ET-GARONNE,73569,51096,2204,48892,2002,t2,legislative
18798,48,LOZERE,31327,22179,920,21259,2002,t2,legislative
18799,49,MAINE-ET-LOIRE,75323,45809,1696,44113,2002,t2,legislative
18800,49,MAINE-ET-LOIRE,80042,49626,1895,47731,2002,t2,legislative
18801,49,MAINE-ET-LOIRE,64287,37620,1345,36275,2002,t2,legislative
18802,49,MAINE-ET-LOIRE,68675,42207,1315,40892,2002,t2,legislative
18803,49,MAINE-ET-LOIRE,70558,41327,1579,39748,2002,t2,legislative
18804,49,MAINE-ET-LOIRE,84643,49901,2614,47287,2002,t2,legislative
18805,49,MAINE-ET-LOIRE,68223,42108,1133,40975,2002,t2,legislative
18806,50,MANCHE,73403,43444,1631,41813,2002,t2,legislative
18807,50,MANCHE,69373,40641,1807,38834,2002,t2,legislative
18808,50,MANCHE,69135,43463,1439,42024,2002,t2,legislative
18809,51,MARNE,56497,30398,996,29402,2002,t2,legislative
18810,51,MARNE,64862,37048,1326,35722,2002,t2,legislative
18811,51,MARNE,62584,32723,1325,31398,2002,t2,legislative
18812,51,MARNE,67343,36545,1550,34995,2002,t2,legislative
18813,52,HAUTE-MARNE,77043,45513,2583,42930,2002,t2,legislative
18814,52,HAUTE-MARNE,66830,34698,3416,31282,2002,t2,legislative
18815,53,MAYENNE,65040,34187,3999,30188,2002,t2,legislative
18816,53,MAYENNE,70365,44216,1626,42590,2002,t2,legislative
18817,54,MEURTHE-ET-MOSELLE,48584,27776,789,26987,2002,t2,legislative
18818,54,MEURTHE-ET-MOSELLE,74888,44172,1481,42691,2002,t2,legislative
18819,54,MEURTHE-ET-MOSELLE,56593,32096,948,31148,2002,t2,legislative
18820,54,MEURTHE-ET-MOSELLE,74859,42765,2347,40418,2002,t2,legislative
18821,54,MEURTHE-ET-MOSELLE,70973,43750,1740,42010,2002,t2,legislative
18822,54,MEURTHE-ET-MOSELLE,75208,41295,1629,39666,2002,t2,legislative
18823,54,MEURTHE-ET-MOSELLE,69891,36261,1726,34535,2002,t2,legislative
18824,55,MEUSE,78703,49105,2024,47081,2002,t2,legislative
18825,55,MEUSE,60699,36792,1735,35057,2002,t2,legislative
18826,56,MORBIHAN,93398,59960,1403,58557,2002,t2,legislative
18827,56,MORBIHAN,83490,51691,2010,49681,2002,t2,legislative
18828,56,MORBIHAN,77375,50871,1444,49427,2002,t2,legislative
18829,56,MORBIHAN,82297,52760,1801,50959,2002,t2,legislative
18830,56,MORBIHAN,80070,49651,1993,47658,2002,t2,legislative
18831,57,MOSELLE,70597,37947,1267,36680,2002,t2,legislative
18832,57,MOSELLE,71689,38259,1546,36713,2002,t2,legislative
18833,57,MOSELLE,69536,36290,1312,34978,2002,t2,legislative
18834,57,MOSELLE,67935,38421,2062,36359,2002,t2,legislative
18835,57,MOSELLE,73928,40269,1712,38557,2002,t2,legislative
18836,57,MOSELLE,72347,33139,1211,31928,2002,t2,legislative
18837,57,MOSELLE,76856,35324,3284,32040,2002,t2,legislative
18838,57,MOSELLE,72213,39023,1380,37643,2002,t2,legislative
18839,57,MOSELLE,70977,35332,1040,34292,2002,t2,legislative
18840,57,MOSELLE,69005,31337,1576,29761,2002,t2,legislative
18841,58,NIEVRE,55378,32805,1463,31342,2002,t2,legislative
18842,58,NIEVRE,59833,36451,1892,34559,2002,t2,legislative
18843,58,NIEVRE,55348,35703,1490,34213,2002,t2,legislative
18844,59,NORD,58435,29655,1022,28633,2002,t2,legislative
18845,59,NORD,70938,39677,2112,37565,2002,t2,legislative
18846,59,NORD,60045,32921,1242,31679,2002,t2,legislative
18847,59,NORD,83592,50641,2699,47942,2002,t2,legislative
18848,59,NORD,76947,49871,1910,47961,2002,t2,legislative
18849,59,NORD,68409,35094,1393,33701,2002,t2,legislative
18850,59,NORD,68057,34129,1163,32966,2002,t2,legislative
18851,59,NORD,74073,40215,1557,38658,2002,t2,legislative
18852,59,NORD,84288,50028,2332,47696,2002,t2,legislative
18853,59,NORD,69727,37984,3047,34937,2002,t2,legislative
18854,59,NORD,64969,40867,2508,38359,2002,t2,legislative
18855,59,NORD,71427,48085,1990,46095,2002,t2,legislative
18856,59,NORD,71240,44896,2151,42745,2002,t2,legislative
18857,59,NORD,79861,30445,7765,22680,2002,t2,legislative
18858,59,NORD,73191,41677,1686,39991,2002,t2,legislative
18859,59,NORD,77646,49301,1976,47325,2002,t2,legislative
18860,59,NORD,77992,28925,7952,20973,2002,t2,legislative
18861,59,NORD,80177,43705,1651,42054,2002,t2,legislative
18862,59,NORD,75097,41721,1229,40492,2002,t2,legislative
18863,59,NORD,74211,46818,2266,44552,2002,t2,legislative
18864,59,NORD,67110,34478,3451,31027,2002,t2,legislative
18865,59,NORD,64534,37634,1763,35871,2002,t2,legislative
18866,60,OISE,74837,46143,2675,43468,2002,t2,legislative
18867,60,OISE,79721,48148,2959,45189,2002,t2,legislative
18868,60,OISE,64490,35525,1589,33936,2002,t2,legislative
18869,60,OISE,83667,46916,1743,45173,2002,t2,legislative
18870,60,OISE,65788,38528,1275,37253,2002,t2,legislative
18871,60,OISE,69409,44311,1649,42662,2002,t2,legislative
18872,60,OISE,69918,39276,1995,37281,2002,t2,legislative
18873,61,ORNE,71442,44382,1352,43030,2002,t2,legislative
18874,62,PAS-DE-CALAIS,77798,51377,2902,48475,2002,t2,legislative
18875,62,PAS-DE-CALAIS,73897,48008,2280,45728,2002,t2,legislative
18876,62,PAS-DE-CALAIS,73007,53704,2292,51412,2002,t2,legislative
18877,62,PAS-DE-CALAIS,76745,48089,2463,45626,2002,t2,legislative
18878,62,PAS-DE-CALAIS,63020,36952,2074,34878,2002,t2,legislative
18879,62,PAS-DE-CALAIS,70576,42983,1734,41249,2002,t2,legislative
18880,62,PAS-DE-CALAIS,81261,45768,2533,43235,2002,t2,legislative
18881,62,PAS-DE-CALAIS,67256,44077,1792,42285,2002,t2,legislative
18882,62,PAS-DE-CALAIS,79654,51745,3217,48528,2002,t2,legislative
18883,62,PAS-DE-CALAIS,72028,38566,2721,35845,2002,t2,legislative
18884,62,PAS-DE-CALAIS,91864,51673,5205,46468,2002,t2,legislative
18885,62,PAS-DE-CALAIS,77667,41573,3579,37994,2002,t2,legislative
18886,62,PAS-DE-CALAIS,71606,40246,2270,37976,2002,t2,legislative
18887,62,PAS-DE-CALAIS,74065,40708,2896,37812,2002,t2,legislative
18888,63,PUY-DE-DOME,58699,33561,1273,32288,2002,t2,legislative
18889,63,PUY-DE-DOME,72686,45529,1666,43863,2002,t2,legislative
18890,63,PUY-DE-DOME,71771,45135,2507,42628,2002,t2,legislative
18891,63,PUY-DE-DOME,73660,48581,1713,46868,2002,t2,legislative
18892,63,PUY-DE-DOME,64957,42359,1563,40796,2002,t2,legislative
18893,63,PUY-DE-DOME,84906,57175,2610,54565,2002,t2,legislative
18894,64,PYRENEES-ATLANTIQUES,65098,42239,1700,40539,2002,t2,legislative
18895,64,PYRENEES-ATLANTIQUES,69440,47284,2116,45168,2002,t2,legislative
18896,64,PYRENEES-ATLANTIQUES,76692,53958,2356,51602,2002,t2,legislative
18897,64,PYRENEES-ATLANTIQUES,78911,53971,2329,51642,2002,t2,legislative
18898,64,PYRENEES-ATLANTIQUES,76774,47492,2078,45414,2002,t2,legislative
18899,64,PYRENEES-ATLANTIQUES,85398,50916,2607,48309,2002,t2,legislative
18900,65,HAUTES-PYRENEES,59173,38476,2153,36323,2002,t2,legislative
18901,65,HAUTES-PYRENEES,60054,41580,1632,39948,2002,t2,legislative
18902,65,HAUTES-PYRENEES,50247,33137,1428,31709,2002,t2,legislative
18903,66,PYRENEES-ORIENTALES,58838,36570,1693,34877,2002,t2,legislative
18904,66,PYRENEES-ORIENTALES,85481,56012,2970,53042,2002,t2,legislative
18905,66,PYRENEES-ORIENTALES,61694,40430,2052,38378,2002,t2,legislative
18906,66,PYRENEES-ORIENTALES,80513,51420,3107,48313,2002,t2,legislative
18907,67,BAS-RHIN,49330,28916,675,28241,2002,t2,legislative
18908,67,BAS-RHIN,48372,26599,602,25997,2002,t2,legislative
18909,67,BAS-RHIN,61396,33710,831,32879,2002,t2,legislative
18910,67,BAS-RHIN,92984,43983,4315,39668,2002,t2,legislative
18911,67,BAS-RHIN,97787,45952,3054,42898,2002,t2,legislative
18912,68,HAUT-RHIN,71589,33389,4197,29192,2002,t2,legislative
18913,68,HAUT-RHIN,68864,34337,1390,32947,2002,t2,legislative
18914,68,HAUT-RHIN,51772,29167,860,28307,2002,t2,legislative
18915,68,HAUT-RHIN,70648,33748,2571,31177,2002,t2,legislative
18916,68,HAUT-RHIN,71088,39015,1422,37593,2002,t2,legislative
18917,69,RHONE,54210,32259,1116,31143,2002,t2,legislative
18918,69,RHONE,62891,38718,1027,37691,2002,t2,legislative
18919,69,RHONE,57266,34453,1033,33420,2002,t2,legislative
18920,69,RHONE,63752,38884,1233,37651,2002,t2,legislative
18921,69,RHONE,79104,47119,1313,45806,2002,t2,legislative
18922,69,RHONE,63935,35016,1211,33805,2002,t2,legislative
18923,69,RHONE,53433,30025,1127,28898,2002,t2,legislative
18924,69,RHONE,72650,38759,2812,35947,2002,t2,legislative
18925,69,RHONE,81459,46875,1535,45340,2002,t2,legislative
18926,69,RHONE,73208,43263,1867,41396,2002,t2,legislative
18927,69,RHONE,83187,48519,684,47835,2002,t2,legislative
18928,69,RHONE,46593,23581,1065,22516,2002,t2,legislative
18929,70,HAUTE-SAONE,62029,40447,1912,38535,2002,t2,legislative
18930,70,HAUTE-SAONE,61238,39782,2503,37279,2002,t2,legislative
18931,70,HAUTE-SAONE,51577,35499,1937,33562,2002,t2,legislative
18932,71,SAONE-ET-LOIRE,64588,41187,1298,39889,2002,t2,legislative
18933,71,SAONE-ET-LOIRE,67599,41992,1993,39999,2002,t2,legislative
18934,71,SAONE-ET-LOIRE,61294,36570,1310,35260,2002,t2,legislative
18935,71,SAONE-ET-LOIRE,62315,35784,1378,34406,2002,t2,legislative
18936,71,SAONE-ET-LOIRE,80465,50824,1798,49026,2002,t2,legislative
18937,72,SARTHE,79487,44340,1405,42935,2002,t2,legislative
18938,72,SARTHE,80876,48570,1821,46749,2002,t2,legislative
18939,72,SARTHE,84037,50197,1766,48431,2002,t2,legislative
18940,73,SAVOIE,97900,56301,1916,54385,2002,t2,legislative
18941,73,SAVOIE,89008,51298,1511,49787,2002,t2,legislative
18942,74,HAUTE-SAVOIE,92173,50871,1626,49245,2002,t2,legislative
18943,74,HAUTE-SAVOIE,77551,41549,1762,39787,2002,t2,legislative
18944,74,HAUTE-SAVOIE,78066,39601,2969,36632,2002,t2,legislative
18945,74,HAUTE-SAVOIE,81136,40414,1341,39073,2002,t2,legislative
18946,74,HAUTE-SAVOIE,95402,50819,1579,49240,2002,t2,legislative
18947,75,PARIS,54973,36773,778,35995,2002,t2,legislative
18948,75,PARIS,50567,34857,1301,33556,2002,t2,legislative
18949,75,PARIS,41238,25429,662,24767,2002,t2,legislative
18950,75,PARIS,41014,26121,773,25348,2002,t2,legislative
18951,75,PARIS,55313,35459,945,34514,2002,t2,legislative
18952,75,PARIS,55694,36899,857,36042,2002,t2,legislative
18953,75,PARIS,64184,42876,1338,41538,2002,t2,legislative
18954,75,PARIS,53605,34613,1003,33610,2002,t2,legislative
18955,75,PARIS,58331,40922,1017,39905,2002,t2,legislative
18956,75,PARIS,53790,36780,769,36011,2002,t2,legislative
18957,75,PARIS,38592,20160,958,19202,2002,t2,legislative
18958,75,PARIS,49695,22622,3934,18688,2002,t2,legislative
18959,75,PARIS,48290,30108,840,29268,2002,t2,legislative
18960,75,PARIS,48673,31610,848,30762,2002,t2,legislative
18961,75,PARIS,40107,23826,784,23042,2002,t2,legislative
18962,75,PARIS,54981,33233,1327,31906,2002,t2,legislative
18963,75,PARIS,63797,39837,1194,38643,2002,t2,legislative
18964,76,SEINE-MARITIME,55341,33985,941,33044,2002,t2,legislative
18965,76,SEINE-MARITIME,83193,51967,1834,50133,2002,t2,legislative
18966,76,SEINE-MARITIME,54309,30140,1691,28449,2002,t2,legislative
18967,76,SEINE-MARITIME,69774,39978,1731,38247,2002,t2,legislative
18968,76,SEINE-MARITIME,85397,52052,1949,50103,2002,t2,legislative
18969,76,SEINE-MARITIME,75911,44250,1993,42257,2002,t2,legislative
18970,76,SEINE-MARITIME,58268,33717,1031,32686,2002,t2,legislative
18971,76,SEINE-MARITIME,52613,26521,830,25691,2002,t2,legislative
18972,76,SEINE-MARITIME,81091,52438,2285,50153,2002,t2,legislative
18973,76,SEINE-MARITIME,80746,52933,2070,50863,2002,t2,legislative
18974,76,SEINE-MARITIME,73229,46283,2147,44136,2002,t2,legislative
18975,76,SEINE-MARITIME,70330,47631,1210,46421,2002,t2,legislative
18976,77,SEINE-ET-MARNE,81309,45636,1377,44259,2002,t2,legislative
18977,77,SEINE-ET-MARNE,72079,42026,1461,40565,2002,t2,legislative
18978,77,SEINE-ET-MARNE,71056,40957,1614,39343,2002,t2,legislative
18979,77,SEINE-ET-MARNE,76481,44025,2089,41936,2002,t2,legislative
18980,77,SEINE-ET-MARNE,81290,46165,1686,44479,2002,t2,legislative
18981,77,SEINE-ET-MARNE,74339,42835,1598,41237,2002,t2,legislative
18982,77,SEINE-ET-MARNE,81399,45865,1504,44361,2002,t2,legislative
18983,77,SEINE-ET-MARNE,92544,53692,1649,52043,2002,t2,legislative
18984,77,SEINE-ET-MARNE,94210,55447,1778,53669,2002,t2,legislative
18985,78,YVELINES,83531,52105,1864,50241,2002,t2,legislative
18986,78,YVELINES,73894,46300,1378,44922,2002,t2,legislative
18987,78,YVELINES,65586,35604,2995,32609,2002,t2,legislative
18988,78,YVELINES,64235,38102,1564,36538,2002,t2,legislative
18989,78,YVELINES,56344,32967,1209,31758,2002,t2,legislative
18990,78,YVELINES,68841,42054,1152,40902,2002,t2,legislative
18991,78,YVELINES,59377,35011,1584,33427,2002,t2,legislative
18992,78,YVELINES,78461,46194,1644,44550,2002,t2,legislative
18993,78,YVELINES,95212,58441,2760,55681,2002,t2,legislative
18994,78,YVELINES,52422,31240,1005,30235,2002,t2,legislative
18995,78,YVELINES,65707,39025,1135,37890,2002,t2,legislative
18996,79,DEUX-SEVRES,60101,39145,776,38369,2002,t2,legislative
18997,79,DEUX-SEVRES,70312,46732,1094,45638,2002,t2,legislative
18998,79,DEUX-SEVRES,69681,42691,1501,41190,2002,t2,legislative
18999,80,SOMME,57348,32017,1469,30548,2002,t2,legislative
19000,80,SOMME,67676,48949,2447,46502,2002,t2,legislative
19001,80,SOMME,71806,47202,2332,44870,2002,t2,legislative
19002,80,SOMME,64937,40969,2126,38843,2002,t2,legislative
19003,80,SOMME,75882,50212,2350,47862,2002,t2,legislative
19004,81,TARN,56066,38053,2812,35241,2002,t2,legislative
19005,81,TARN,74025,50320,2173,48147,2002,t2,legislative
19006,81,TARN,58269,37381,5055,32326,2002,t2,legislative
19007,81,TARN,73604,51841,2625,49216,2002,t2,legislative
19008,82,TARN-ET-GARONNE,76092,53876,2587,51289,2002,t2,legislative
19009,82,TARN-ET-GARONNE,78004,51724,2779,48945,2002,t2,legislative
19010,83,VAR,49838,27369,1451,25918,2002,t2,legislative
19011,83,VAR,53402,29318,1642,27676,2002,t2,legislative
19012,83,VAR,103444,55400,6130,49270,2002,t2,legislative
19013,83,VAR,106373,65123,1306,63817,2002,t2,legislative
19014,83,VAR,95182,51305,5343,45962,2002,t2,legislative
19015,83,VAR,138801,85477,1999,83478,2002,t2,legislative
19016,83,VAR,101155,52758,5524,47234,2002,t2,legislative
19017,84,VAUCLUSE,68298,40725,1978,38747,2002,t2,legislative
19018,84,VAUCLUSE,110302,67300,3793,63507,2002,t2,legislative
19019,84,VAUCLUSE,89166,51343,5552,45791,2002,t2,legislative
19020,84,VAUCLUSE,76284,50251,4378,45873,2002,t2,legislative
19021,85,VENDEE,83322,49742,1441,48301,2002,t2,legislative
19022,86,VIENNE,76414,50238,1315,48923,2002,t2,legislative
19023,86,VIENNE,69171,45152,1392,43760,2002,t2,legislative
19024,86,VIENNE,67812,44141,1505,42636,2002,t2,legislative
19025,86,VIENNE,74194,45490,2116,43374,2002,t2,legislative
19026,87,HAUTE-VIENNE,52166,35170,1842,33328,2002,t2,legislative
19027,87,HAUTE-VIENNE,72609,52858,2386,50472,2002,t2,legislative
19028,87,HAUTE-VIENNE,66433,44555,1951,42604,2002,t2,legislative
19029,87,HAUTE-VIENNE,70019,45806,2184,43622,2002,t2,legislative
19030,88,VOSGES,75427,43549,2087,41462,2002,t2,legislative
19031,88,VOSGES,73380,44113,3115,40998,2002,t2,legislative
19032,88,VOSGES,66171,41742,1367,40375,2002,t2,legislative
19033,88,VOSGES,68841,44390,1861,42529,2002,t2,legislative
19034,89,YONNE,75953,46023,2184,43839,2002,t2,legislative
19035,89,YONNE,72547,44580,2132,42448,2002,t2,legislative
19036,89,YONNE,87603,50750,2311,48439,2002,t2,legislative
19037,90,TERRITOIRE DE BELFORT,43970,29186,1437,27749,2002,t2,legislative
19038,90,TERRITOIRE DE BELFORT,45956,29615,2393,27222,2002,t2,legislative
19039,91,ESSONNE,60340,35320,1004,34316,2002,t2,legislative
19040,91,ESSONNE,75783,45798,1568,44230,2002,t2,legislative
19041,91,ESSONNE,86873,54713,1699,53014,2002,t2,legislative
19042,91,ESSONNE,76695,47662,1379,46283,2002,t2,legislative
19043,91,ESSONNE,61189,41018,1008,40010,2002,t2,legislative
19044,91,ESSONNE,67712,42779,1201,41578,2002,t2,legislative
19045,91,ESSONNE,65413,40348,1235,39113,2002,t2,legislative
19046,91,ESSONNE,68570,40953,1152,39801,2002,t2,legislative
19047,91,ESSONNE,54666,31611,1150,30461,2002,t2,legislative
19048,92,HAUTS-DE-SEINE,53214,27110,829,26281,2002,t2,legislative
19049,92,HAUTS-DE-SEINE,52436,31667,1079,30588,2002,t2,legislative
19050,92,HAUTS-DE-SEINE,60239,35965,1039,34926,2002,t2,legislative
19051,92,HAUTS-DE-SEINE,58699,37755,879,36876,2002,t2,legislative
19052,92,HAUTS-DE-SEINE,79066,45982,1464,44518,2002,t2,legislative
19053,92,HAUTS-DE-SEINE,64376,39944,1735,38209,2002,t2,legislative
19054,92,HAUTS-DE-SEINE,56748,35572,965,34607,2002,t2,legislative
19055,92,HAUTS-DE-SEINE,59550,36049,1012,35037,2002,t2,legislative
19056,92,HAUTS-DE-SEINE,78407,50290,1518,48772,2002,t2,legislative
19057,92,HAUTS-DE-SEINE,78803,51971,1410,50561,2002,t2,legislative
19058,93,SEINE-SAINT-DENIS,42749,22836,908,21928,2002,t2,legislative
19059,93,SEINE-SAINT-DENIS,44568,21503,804,20699,2002,t2,legislative
19060,93,SEINE-SAINT-DENIS,40349,20036,1311,18725,2002,t2,legislative
19061,93,SEINE-SAINT-DENIS,41627,21019,743,20276,2002,t2,legislative
19062,93,SEINE-SAINT-DENIS,47781,26071,681,25390,2002,t2,legislative
19063,93,SEINE-SAINT-DENIS,53068,29535,1393,28142,2002,t2,legislative
19064,93,SEINE-SAINT-DENIS,44070,22493,2156,20337,2002,t2,legislative
19065,93,SEINE-SAINT-DENIS,55970,31823,1167,30656,2002,t2,legislative
19066,93,SEINE-SAINT-DENIS,48675,27074,1198,25876,2002,t2,legislative
19067,93,SEINE-SAINT-DENIS,47392,25827,707,25120,2002,t2,legislative
19068,93,SEINE-SAINT-DENIS,51528,28546,975,27571,2002,t2,legislative
19069,93,SEINE-SAINT-DENIS,56011,33404,1060,32344,2002,t2,legislative
19070,93,SEINE-SAINT-DENIS,60588,35631,1407,34224,2002,t2,legislative
19071,94,VAL-DE-MARNE,50590,30946,1185,29761,2002,t2,legislative
19072,94,VAL-DE-MARNE,58419,32085,1305,30780,2002,t2,legislative
19073,94,VAL-DE-MARNE,62783,36631,1228,35403,2002,t2,legislative
19074,94,VAL-DE-MARNE,64214,39159,1483,37676,2002,t2,legislative
19075,94,VAL-DE-MARNE,56963,32524,896,31628,2002,t2,legislative
19076,94,VAL-DE-MARNE,69523,42092,1340,40752,2002,t2,legislative
19077,94,VAL-DE-MARNE,53147,32819,1113,31706,2002,t2,legislative
19078,94,VAL-DE-MARNE,46599,25178,856,24322,2002,t2,legislative
19079,94,VAL-DE-MARNE,54309,30034,1040,28994,2002,t2,legislative
19080,94,VAL-DE-MARNE,52019,29065,1365,27700,2002,t2,legislative
19081,94,VAL-DE-MARNE,59256,35602,1166,34436,2002,t2,legislative
19082,95,VAL-D'OISE,69995,42527,1464,41063,2002,t2,legislative
19083,95,VAL-D'OISE,98921,60330,1621,58709,2002,t2,legislative
19084,95,VAL-D'OISE,75990,44578,1587,42991,2002,t2,legislative
19085,95,VAL-D'OISE,69004,40186,1320,38866,2002,t2,legislative
19086,95,VAL-D'OISE,55742,32956,900,32056,2002,t2,legislative
19087,95,VAL-D'OISE,63679,37175,1265,35910,2002,t2,legislative
19088,95,VAL-D'OISE,73125,43574,1357,42217,2002,t2,legislative
19089,95,VAL-D'OISE,43129,22476,824,21652,2002,t2,legislative
19090,95,VAL-D'OISE,58060,32625,1586,31039,2002,t2,legislative
19091,971,GUADELOUPE,61287,27604,1705,25899,2002,t2,legislative
19092,971,GUADELOUPE,80332,31498,1559,29939,2002,t2,legislative
19093,971,GUADELOUPE,73348,25034,1670,23364,2002,t2,legislative
19094,971,GUADELOUPE,66611,29464,1459,28005,2002,t2,legislative
19095,972,MARTINIQUE,57314,22079,1040,21039,2002,t2,legislative
19096,972,MARTINIQUE,58881,18757,1234,17523,2002,t2,legislative
19097,972,MARTINIQUE,55743,21184,1302,19882,2002,t2,legislative
19098,972,MARTINIQUE,94640,33630,1995,31635,2002,t2,legislative
19099,973,GUYANE,19494,6391,374,6017,2002,t2,legislative
19100,973,GUYANE,32290,11791,670,11121,2002,t2,legislative
19101,974,LA REUNION,71656,36901,1877,35024,2002,t2,legislative
19102,974,LA REUNION,92144,57469,2857,54612,2002,t2,legislative
19103,974,LA REUNION,87104,50809,2287,48522,2002,t2,legislative
19104,975,SAINT-PIERRE-ET-MIQUELON,4822,3603,197,3406,2002,t2,legislative
19105,985,MAYOTTE,52341,31936,802,31134,2002,t2,legislative
19106,986,WALLIS ET FUTUNA,9375,7543,53,7490,2002,t2,legislative
19107,988,NOUVELLE-CALEDONIE,60770,24624,1895,22729,2002,t2,legislative
19108,988,NOUVELLE-CALEDONIE,66908,30308,2094,28214,2002,t2,legislative
19109,1,AIN,79066,47529,476,47053,2012,t1,legislative
19110,1,AIN,86982,52088,512,51576,2012,t1,legislative
19111,1,AIN,69837,37692,469,37223,2012,t1,legislative
19112,1,AIN,84591,49881,651,49230,2012,t1,legislative
19113,1,AIN,73718,42150,557,41593,2012,t1,legislative
19114,2,AISNE,72620,43164,510,42654,2012,t1,legislative
19115,2,AISNE,73249,45335,583,44752,2012,t1,legislative
19116,2,AISNE,70292,41381,791,40590,2012,t1,legislative
19117,2,AISNE,78987,43712,611,43101,2012,t1,legislative
19118,2,AISNE,81017,48103,632,47471,2012,t1,legislative
19119,3,ALLIER,90355,55940,1056,54884,2012,t1,legislative
19120,3,ALLIER,86739,52640,1075,51565,2012,t1,legislative
19121,3,ALLIER,79029,47827,784,47043,2012,t1,legislative
19122,4,ALPES-DE-HAUTE-PROVENCE,60582,37901,717,37184,2012,t1,legislative
19123,4,ALPES-DE-HAUTE-PROVENCE,63327,39401,605,38796,2012,t1,legislative
19124,5,HAUTES-ALPES,56120,34638,607,34031,2012,t1,legislative
19125,5,HAUTES-ALPES,50805,31702,625,31077,2012,t1,legislative
19126,6,ALPES-MARITIMES,82287,46011,509,45502,2012,t1,legislative
19127,6,ALPES-MARITIMES,82406,48630,566,48064,2012,t1,legislative
19128,6,ALPES-MARITIMES,87373,47893,561,47332,2012,t1,legislative
19129,6,ALPES-MARITIMES,84882,48876,671,48205,2012,t1,legislative
19130,6,ALPES-MARITIMES,85420,49925,604,49321,2012,t1,legislative
19131,6,ALPES-MARITIMES,76095,43093,632,42461,2012,t1,legislative
19132,6,ALPES-MARITIMES,89711,51314,606,50708,2012,t1,legislative
19133,6,ALPES-MARITIMES,80580,43305,717,42588,2012,t1,legislative
19134,6,ALPES-MARITIMES,77292,44033,437,43596,2012,t1,legislative
19135,7,ARDECHE,76645,46405,1246,45159,2012,t1,legislative
19136,7,ARDECHE,90928,56909,750,56159,2012,t1,legislative
19137,7,ARDECHE,76073,50125,583,49542,2012,t1,legislative
19138,8,ARDENNES,73277,42253,498,41755,2012,t1,legislative
19139,8,ARDENNES,64802,35247,439,34808,2012,t1,legislative
19140,8,ARDENNES,58526,35214,386,34828,2012,t1,legislative
19141,9,ARIEGE,56664,35176,756,34420,2012,t1,legislative
19142,9,ARIEGE,59754,37136,770,36366,2012,t1,legislative
19143,10,AUBE,64707,39014,776,38238,2012,t1,legislative
19144,10,AUBE,72912,43808,731,43077,2012,t1,legislative
19145,10,AUBE,66187,38248,397,37851,2012,t1,legislative
19146,11,AUDE,92762,57719,1246,56473,2012,t1,legislative
19147,11,AUDE,83701,51581,865,50716,2012,t1,legislative
19148,11,AUDE,87604,56786,1090,55696,2012,t1,legislative
19149,12,AVEYRON,75452,49797,872,48925,2012,t1,legislative
19150,12,AVEYRON,70585,46219,1023,45196,2012,t1,legislative
19151,12,AVEYRON,71920,47652,1119,46533,2012,t1,legislative
19152,13,BOUCHES-DU-RHONE,73892,42375,347,42028,2012,t1,legislative
19153,13,BOUCHES-DU-RHONE,77390,45680,371,45309,2012,t1,legislative
19154,13,BOUCHES-DU-RHONE,70351,37418,679,36739,2012,t1,legislative
19155,13,BOUCHES-DU-RHONE,58700,30864,394,30470,2012,t1,legislative
19156,13,BOUCHES-DU-RHONE,68685,40412,380,40032,2012,t1,legislative
19157,13,BOUCHES-DU-RHONE,72571,41031,384,40647,2012,t1,legislative
19158,13,BOUCHES-DU-RHONE,63082,30440,477,29963,2012,t1,legislative
19159,13,BOUCHES-DU-RHONE,93086,54691,695,53996,2012,t1,legislative
19160,13,BOUCHES-DU-RHONE,92601,54645,699,53946,2012,t1,legislative
19161,13,BOUCHES-DU-RHONE,100194,60188,789,59399,2012,t1,legislative
19162,13,BOUCHES-DU-RHONE,85348,48719,553,48166,2012,t1,legislative
19163,13,BOUCHES-DU-RHONE,89006,50365,668,49697,2012,t1,legislative
19164,13,BOUCHES-DU-RHONE,90594,54077,751,53326,2012,t1,legislative
19165,13,BOUCHES-DU-RHONE,93933,55542,618,54924,2012,t1,legislative
19166,13,BOUCHES-DU-RHONE,98301,59870,781,59089,2012,t1,legislative
19167,13,BOUCHES-DU-RHONE,88594,52414,776,51638,2012,t1,legislative
19168,14,CALVADOS,70197,41383,502,40881,2012,t1,legislative
19169,14,CALVADOS,67111,39200,395,38805,2012,t1,legislative
19170,14,CALVADOS,78477,45844,797,45047,2012,t1,legislative
19171,14,CALVADOS,97734,57323,805,56518,2012,t1,legislative
19172,14,CALVADOS,86425,52289,704,51585,2012,t1,legislative
19173,14,CALVADOS,90979,56081,1042,55039,2012,t1,legislative
19174,15,CANTAL,64438,40690,726,39964,2012,t1,legislative
19175,15,CANTAL,56422,35703,497,35206,2012,t1,legislative
19176,16,CHARENTE,84304,46619,676,45943,2012,t1,legislative
19177,16,CHARENTE,84854,48915,901,48014,2012,t1,legislative
19178,16,CHARENTE,91869,55921,1157,54764,2012,t1,legislative
19179,17,CHARENTE-MARITIME,98753,59904,570,59334,2012,t1,legislative
19180,17,CHARENTE-MARITIME,97490,57098,879,56219,2012,t1,legislative
19181,17,CHARENTE-MARITIME,81745,47262,849,46413,2012,t1,legislative
19182,17,CHARENTE-MARITIME,87692,52072,873,51199,2012,t1,legislative
19183,17,CHARENTE-MARITIME,106006,63007,811,62196,2012,t1,legislative
19184,18,CHER,73619,43701,783,42918,2012,t1,legislative
19185,18,CHER,70128,38827,965,37862,2012,t1,legislative
19186,18,CHER,87187,52460,1006,51454,2012,t1,legislative
19187,19,CORREZE,94582,65881,1264,64617,2012,t1,legislative
19188,19,CORREZE,91937,59076,1284,57792,2012,t1,legislative
19189,21,COTE-D'OR,67638,42769,444,42325,2012,t1,legislative
19190,21,COTE-D'OR,66186,40146,425,39721,2012,t1,legislative
19191,21,COTE-D'OR,69190,40161,511,39650,2012,t1,legislative
19192,21,COTE-D'OR,69044,44723,638,44085,2012,t1,legislative
19193,21,COTE-D'OR,82966,50444,692,49752,2012,t1,legislative
19194,22,COTES-D'ARMOR,89082,54426,1041,53385,2012,t1,legislative
19195,22,COTES-D'ARMOR,93788,60241,1110,59131,2012,t1,legislative
19196,22,COTES-D'ARMOR,86365,58946,662,58284,2012,t1,legislative
19197,22,COTES-D'ARMOR,79622,51791,852,50939,2012,t1,legislative
19198,22,COTES-D'ARMOR,102353,64943,1148,63795,2012,t1,legislative
19199,23,CREUSE,96749,62489,1163,61326,2012,t1,legislative
19200,24,DORDOGNE,75065,47453,958,46495,2012,t1,legislative
19201,24,DORDOGNE,81128,51284,872,50412,2012,t1,legislative
19202,24,DORDOGNE,68980,46609,1030,45579,2012,t1,legislative
19203,24,DORDOGNE,86687,56975,1149,55826,2012,t1,legislative
19204,25,DOUBS,73025,43557,535,43022,2012,t1,legislative
19205,25,DOUBS,76302,47324,691,46633,2012,t1,legislative
19206,25,DOUBS,65469,39675,773,38902,2012,t1,legislative
19207,25,DOUBS,67395,40771,534,40237,2012,t1,legislative
19208,25,DOUBS,77342,48267,739,47528,2012,t1,legislative
19209,26,DROME,72894,42591,563,42028,2012,t1,legislative
19210,26,DROME,87792,52368,632,51736,2012,t1,legislative
19211,26,DROME,102613,66799,752,66047,2012,t1,legislative
19212,26,DROME,90017,54296,625,53671,2012,t1,legislative
19213,27,EURE,85371,48833,693,48140,2012,t1,legislative
19214,27,EURE,77004,45558,693,44865,2012,t1,legislative
19215,27,EURE,81703,49617,851,48766,2012,t1,legislative
19216,27,EURE,86749,49757,699,49058,2012,t1,legislative
19217,27,EURE,87236,50710,811,49899,2012,t1,legislative
19218,28,EURE-ET-LOIR,87301,51436,770,50666,2012,t1,legislative
19219,28,EURE-ET-LOIR,71962,38979,618,38361,2012,t1,legislative
19220,28,EURE-ET-LOIR,71269,42028,622,41406,2012,t1,legislative
19221,28,EURE-ET-LOIR,67206,41379,759,40620,2012,t1,legislative
19222,29,FINISTERE,85917,53346,781,52565,2012,t1,legislative
19223,29,FINISTERE,78114,42621,776,41845,2012,t1,legislative
19224,29,FINISTERE,86268,52603,623,51980,2012,t1,legislative
19225,29,FINISTERE,82128,52194,547,51647,2012,t1,legislative
19226,29,FINISTERE,91131,55709,748,54961,2012,t1,legislative
19227,29,FINISTERE,89396,57363,695,56668,2012,t1,legislative
19228,29,FINISTERE,79860,50950,542,50408,2012,t1,legislative
19229,29,FINISTERE,84438,50454,865,49589,2012,t1,legislative
19230,2A,CORSE-DU-SUD,47854,27278,346,26932,2012,t1,legislative
19231,2A,CORSE-DU-SUD,53677,32740,432,32308,2012,t1,legislative
19232,2B,HAUTE-CORSE,54669,33325,490,32835,2012,t1,legislative
19233,2B,HAUTE-CORSE,63918,39540,617,38923,2012,t1,legislative
19234,30,GARD,83399,48518,528,47990,2012,t1,legislative
19235,30,GARD,82317,52158,598,51560,2012,t1,legislative
19236,30,GARD,88900,55635,733,54902,2012,t1,legislative
19237,30,GARD,87721,55396,732,54664,2012,t1,legislative
19238,30,GARD,93440,58460,1045,57415,2012,t1,legislative
19239,30,GARD,77652,44823,554,44269,2012,t1,legislative
19240,31,HAUTE-GARONNE,76439,43461,466,42995,2012,t1,legislative
19241,31,HAUTE-GARONNE,94408,55279,712,54567,2012,t1,legislative
19242,31,HAUTE-GARONNE,73131,45644,399,45245,2012,t1,legislative
19243,31,HAUTE-GARONNE,66108,35238,355,34883,2012,t1,legislative
19244,31,HAUTE-GARONNE,90353,54931,834,54097,2012,t1,legislative
19245,31,HAUTE-GARONNE,103296,62938,976,61962,2012,t1,legislative
19246,31,HAUTE-GARONNE,92519,56577,919,55658,2012,t1,legislative
19247,31,HAUTE-GARONNE,84888,52193,1141,51052,2012,t1,legislative
19248,31,HAUTE-GARONNE,76393,43084,584,42500,2012,t1,legislative
19249,31,HAUTE-GARONNE,88459,59470,831,58639,2012,t1,legislative
19250,32,GERS,73647,46377,1209,45168,2012,t1,legislative
19251,32,GERS,70161,45619,925,44694,2012,t1,legislative
19252,33,GIRONDE,86025,50099,562,49537,2012,t1,legislative
19253,33,GIRONDE,62176,35747,372,35375,2012,t1,legislative
19254,33,GIRONDE,74223,42762,742,42020,2012,t1,legislative
19255,33,GIRONDE,86720,47100,756,46344,2012,t1,legislative
19256,33,GIRONDE,102499,60294,758,59536,2012,t1,legislative
19257,33,GIRONDE,95240,57020,594,56426,2012,t1,legislative
19258,33,GIRONDE,72718,44300,507,43793,2012,t1,legislative
19259,33,GIRONDE,97831,59215,855,58360,2012,t1,legislative
19260,33,GIRONDE,85660,52881,888,51993,2012,t1,legislative
19261,33,GIRONDE,78548,47675,835,46840,2012,t1,legislative
19262,33,GIRONDE,88171,50689,996,49693,2012,t1,legislative
19263,33,GIRONDE,78599,49122,764,48358,2012,t1,legislative
19264,34,HERAULT,79113,46277,716,45561,2012,t1,legislative
19265,34,HERAULT,58306,31073,481,30592,2012,t1,legislative
19266,34,HERAULT,77414,48642,612,48030,2012,t1,legislative
19267,34,HERAULT,103261,62775,809,61966,2012,t1,legislative
19268,34,HERAULT,90977,55547,1088,54459,2012,t1,legislative
19269,34,HERAULT,86217,51015,748,50267,2012,t1,legislative
19270,34,HERAULT,95983,59648,878,58770,2012,t1,legislative
19271,34,HERAULT,80691,47579,790,46789,2012,t1,legislative
19272,34,HERAULT,75618,44508,658,43850,2012,t1,legislative
19273,35,ILLE-ET-VILAINE,87110,49620,757,48863,2012,t1,legislative
19274,35,ILLE-ET-VILAINE,86964,53804,766,53038,2012,t1,legislative
19275,35,ILLE-ET-VILAINE,81491,49634,840,48794,2012,t1,legislative
19276,35,ILLE-ET-VILAINE,85092,49739,1239,48500,2012,t1,legislative
19277,35,ILLE-ET-VILAINE,97503,57910,1044,56866,2012,t1,legislative
19278,35,ILLE-ET-VILAINE,85292,52039,1154,50885,2012,t1,legislative
19279,35,ILLE-ET-VILAINE,95132,57133,706,56427,2012,t1,legislative
19280,35,ILLE-ET-VILAINE,78953,45500,602,44898,2012,t1,legislative
19281,36,INDRE,82183,48351,834,47517,2012,t1,legislative
19282,36,INDRE,91528,56873,1294,55579,2012,t1,legislative
19283,37,INDRE-ET-LOIRE,65540,35959,373,35586,2012,t1,legislative
19284,37,INDRE-ET-LOIRE,84414,51069,748,50321,2012,t1,legislative
19285,37,INDRE-ET-LOIRE,94510,58554,847,57707,2012,t1,legislative
19286,37,INDRE-ET-LOIRE,88306,52948,804,52144,2012,t1,legislative
19287,37,INDRE-ET-LOIRE,80469,49161,558,48603,2012,t1,legislative
19288,38,ISERE,79795,49695,377,49318,2012,t1,legislative
19289,38,ISERE,75155,42759,464,42295,2012,t1,legislative
19290,38,ISERE,59259,32733,319,32414,2012,t1,legislative
19291,38,ISERE,87911,51762,509,51253,2012,t1,legislative
19292,38,ISERE,97933,58903,524,58379,2012,t1,legislative
19293,38,ISERE,77141,43569,453,43116,2012,t1,legislative
19294,38,ISERE,87613,52579,657,51922,2012,t1,legislative
19295,38,ISERE,75071,44108,472,43636,2012,t1,legislative
19296,38,ISERE,93414,54123,975,53148,2012,t1,legislative
19297,38,ISERE,87767,48661,639,48022,2012,t1,legislative
19298,39,JURA,65069,41506,645,40861,2012,t1,legislative
19299,39,JURA,54874,33451,478,32973,2012,t1,legislative
19300,39,JURA,68321,43620,623,42997,2012,t1,legislative
19301,40,LANDES,97693,59101,1088,58013,2012,t1,legislative
19302,40,LANDES,104784,63229,1246,61983,2012,t1,legislative
19303,40,LANDES,94594,61300,1365,59935,2012,t1,legislative
19304,41,LOIR-ET-CHER,80490,47048,686,46362,2012,t1,legislative
19305,41,LOIR-ET-CHER,80287,48607,755,47852,2012,t1,legislative
19306,41,LOIR-ET-CHER,82404,52618,901,51717,2012,t1,legislative
19307,42,LOIRE,67997,36899,349,36550,2012,t1,legislative
19308,42,LOIRE,57300,29814,272,29542,2012,t1,legislative
19309,42,LOIRE,80444,46863,558,46305,2012,t1,legislative
19310,42,LOIRE,99123,58962,847,58115,2012,t1,legislative
19311,42,LOIRE,101389,62218,940,61278,2012,t1,legislative
19312,42,LOIRE,103991,62633,962,61671,2012,t1,legislative
19313,43,HAUTE-LOIRE,95803,63027,871,62156,2012,t1,legislative
19314,43,HAUTE-LOIRE,80304,49279,1231,48048,2012,t1,legislative
19315,44,LOIRE-ATLANTIQUE,72772,43981,486,43495,2012,t1,legislative
19316,44,LOIRE-ATLANTIQUE,81581,47641,335,47306,2012,t1,legislative
19317,44,LOIRE-ATLANTIQUE,88763,51459,602,50857,2012,t1,legislative
19318,44,LOIRE-ATLANTIQUE,82817,50563,736,49827,2012,t1,legislative
19319,44,LOIRE-ATLANTIQUE,105669,65540,783,64757,2012,t1,legislative
19320,44,LOIRE-ATLANTIQUE,106921,65377,1403,63974,2012,t1,legislative
19321,44,LOIRE-ATLANTIQUE,102073,62648,732,61916,2012,t1,legislative
19322,44,LOIRE-ATLANTIQUE,81111,45988,583,45405,2012,t1,legislative
19323,44,LOIRE-ATLANTIQUE,107736,67621,1083,66538,2012,t1,legislative
19324,44,LOIRE-ATLANTIQUE,106663,67784,984,66800,2012,t1,legislative
19325,45,LOIRET,73262,43594,571,43023,2012,t1,legislative
19326,45,LOIRET,81929,48575,563,48012,2012,t1,legislative
19327,45,LOIRET,71107,43521,623,42898,2012,t1,legislative
19328,45,LOIRET,75011,44323,668,43655,2012,t1,legislative
19329,45,LOIRET,72691,43067,718,42349,2012,t1,legislative
19330,45,LOIRET,69230,40950,587,40363,2012,t1,legislative
19331,46,LOT,70184,45504,824,44680,2012,t1,legislative
19332,46,LOT,64982,42485,1119,41366,2012,t1,legislative
19333,47,LOT-ET-GARONNE,86737,55548,2716,52832,2012,t1,legislative
19334,47,LOT-ET-GARONNE,77684,48839,1020,47819,2012,t1,legislative
19335,47,LOT-ET-GARONNE,76356,48988,817,48171,2012,t1,legislative
19336,48,LOZERE,59906,40767,652,40115,2012,t1,legislative
19337,49,MAINE-ET-LOIRE,80923,47548,725,46823,2012,t1,legislative
19338,49,MAINE-ET-LOIRE,87424,51529,1022,50507,2012,t1,legislative
19339,49,MAINE-ET-LOIRE,68437,41277,832,40445,2012,t1,legislative
19340,49,MAINE-ET-LOIRE,73567,44472,878,43594,2012,t1,legislative
19341,49,MAINE-ET-LOIRE,75351,43548,724,42824,2012,t1,legislative
19342,49,MAINE-ET-LOIRE,92534,55496,1288,54208,2012,t1,legislative
19343,49,MAINE-ET-LOIRE,75311,45788,768,45020,2012,t1,legislative
19344,50,MANCHE,86501,51991,766,51225,2012,t1,legislative
19345,50,MANCHE,94610,58375,1248,57127,2012,t1,legislative
19346,50,MANCHE,105851,62614,1147,61467,2012,t1,legislative
19347,50,MANCHE,88710,50634,558,50076,2012,t1,legislative
19348,51,MARNE,69252,36671,497,36174,2012,t1,legislative
19349,51,MARNE,72609,40386,437,39949,2012,t1,legislative
19350,51,MARNE,81314,44946,609,44337,2012,t1,legislative
19351,51,MARNE,80952,45029,574,44455,2012,t1,legislative
19352,51,MARNE,78229,46887,645,46242,2012,t1,legislative
19353,52,HAUTE-MARNE,74514,45728,665,45063,2012,t1,legislative
19354,52,HAUTE-MARNE,64325,37091,470,36621,2012,t1,legislative
19355,53,MAYENNE,72668,43623,974,42649,2012,t1,legislative
19356,53,MAYENNE,76725,45457,878,44579,2012,t1,legislative
19357,53,MAYENNE,72344,43865,944,42921,2012,t1,legislative
19358,54,MEURTHE-ET-MOSELLE,80689,45190,498,44692,2012,t1,legislative
19359,54,MEURTHE-ET-MOSELLE,70932,40871,440,40431,2012,t1,legislative
19360,54,MEURTHE-ET-MOSELLE,83088,41661,533,41128,2012,t1,legislative
19361,54,MEURTHE-ET-MOSELLE,97182,56254,873,55381,2012,t1,legislative
19362,54,MEURTHE-ET-MOSELLE,76628,46718,763,45955,2012,t1,legislative
19363,54,MEURTHE-ET-MOSELLE,87342,47147,698,46449,2012,t1,legislative
19364,55,MEUSE,78905,47624,746,46878,2012,t1,legislative
19365,55,MEUSE,61307,35542,459,35083,2012,t1,legislative
19366,56,MORBIHAN,98889,62742,644,62098,2012,t1,legislative
19367,56,MORBIHAN,98529,62946,716,62230,2012,t1,legislative
19368,56,MORBIHAN,86770,54638,1091,53547,2012,t1,legislative
19369,56,MORBIHAN,102164,62961,1216,61745,2012,t1,legislative
19370,56,MORBIHAN,80305,46274,873,45401,2012,t1,legislative
19371,56,MORBIHAN,89093,56796,839,55957,2012,t1,legislative
19372,57,MOSELLE,88220,46893,566,46327,2012,t1,legislative
19373,57,MOSELLE,76233,40679,480,40199,2012,t1,legislative
19374,57,MOSELLE,74069,40206,502,39704,2012,t1,legislative
19375,57,MOSELLE,81179,46947,810,46137,2012,t1,legislative
19376,57,MOSELLE,74632,39793,851,38942,2012,t1,legislative
19377,57,MOSELLE,72287,34645,596,34049,2012,t1,legislative
19378,57,MOSELLE,91564,47923,748,47175,2012,t1,legislative
19379,57,MOSELLE,91179,42061,670,41391,2012,t1,legislative
19380,57,MOSELLE,97029,50905,633,50272,2012,t1,legislative
19381,58,NIEVRE,78206,44247,878,43369,2012,t1,legislative
19382,58,NIEVRE,86675,52346,946,51400,2012,t1,legislative
19383,59,NORD,60531,29930,385,29545,2012,t1,legislative
19384,59,NORD,87326,46161,699,45462,2012,t1,legislative
19385,59,NORD,96585,50952,769,50183,2012,t1,legislative
19386,59,NORD,97182,53416,748,52668,2012,t1,legislative
19387,59,NORD,96489,56643,888,55755,2012,t1,legislative
19388,59,NORD,84774,52691,704,51987,2012,t1,legislative
19389,59,NORD,72159,38108,528,37580,2012,t1,legislative
19390,59,NORD,69045,30618,544,30074,2012,t1,legislative
19391,59,NORD,89257,47234,532,46702,2012,t1,legislative
19392,59,NORD,80361,38141,609,37532,2012,t1,legislative
19393,59,NORD,90402,48148,628,47520,2012,t1,legislative
19394,59,NORD,93685,52727,919,51808,2012,t1,legislative
19395,59,NORD,90528,48302,1164,47138,2012,t1,legislative
19396,59,NORD,98801,59778,1008,58770,2012,t1,legislative
19397,59,NORD,95223,58046,1058,56988,2012,t1,legislative
19398,59,NORD,83611,45610,768,44842,2012,t1,legislative
19399,59,NORD,75067,40804,584,40220,2012,t1,legislative
19400,59,NORD,92022,52351,810,51541,2012,t1,legislative
19401,59,NORD,79055,42657,767,41890,2012,t1,legislative
19402,59,NORD,80858,40408,574,39834,2012,t1,legislative
19403,59,NORD,81075,43441,519,42922,2012,t1,legislative
19404,60,OISE,80777,48747,753,47994,2012,t1,legislative
19405,60,OISE,86065,50620,966,49654,2012,t1,legislative
19406,60,OISE,71330,38786,611,38175,2012,t1,legislative
19407,60,OISE,90399,51762,687,51075,2012,t1,legislative
19408,60,OISE,71393,41401,491,40910,2012,t1,legislative
19409,60,OISE,74667,43963,750,43213,2012,t1,legislative
19410,60,OISE,75112,44185,521,43664,2012,t1,legislative
19411,61,ORNE,71233,42903,743,42160,2012,t1,legislative
19412,61,ORNE,68823,40640,847,39793,2012,t1,legislative
19413,61,ORNE,72537,45217,749,44468,2012,t1,legislative
19414,62,PAS-DE-CALAIS,103094,63733,1475,62258,2012,t1,legislative
19415,62,PAS-DE-CALAIS,84287,50962,1229,49733,2012,t1,legislative
19416,62,PAS-DE-CALAIS,87348,46419,1082,45337,2012,t1,legislative
19417,62,PAS-DE-CALAIS,87381,53683,1009,52674,2012,t1,legislative
19418,62,PAS-DE-CALAIS,89827,50434,684,49750,2012,t1,legislative
19419,62,PAS-DE-CALAIS,89029,55745,1394,54351,2012,t1,legislative
19420,62,PAS-DE-CALAIS,92413,47986,837,47149,2012,t1,legislative
19421,62,PAS-DE-CALAIS,93192,55013,1163,53850,2012,t1,legislative
19422,62,PAS-DE-CALAIS,79278,46481,1127,45354,2012,t1,legislative
19423,62,PAS-DE-CALAIS,89833,47611,1108,46503,2012,t1,legislative
19424,62,PAS-DE-CALAIS,94135,54124,975,53149,2012,t1,legislative
19425,62,PAS-DE-CALAIS,94597,51321,1353,49968,2012,t1,legislative
19426,63,PUY-DE-DOME,80630,43722,564,43158,2012,t1,legislative
19427,63,PUY-DE-DOME,85929,53342,986,52356,2012,t1,legislative
19428,63,PUY-DE-DOME,86568,52698,807,51891,2012,t1,legislative
19429,63,PUY-DE-DOME,95541,56563,835,55728,2012,t1,legislative
19430,63,PUY-DE-DOME,100343,60626,1050,59576,2012,t1,legislative
19431,64,PYRENEES-ATLANTIQUES,68853,40022,934,39088,2012,t1,legislative
19432,64,PYRENEES-ATLANTIQUES,77703,48796,776,48020,2012,t1,legislative
19433,64,PYRENEES-ATLANTIQUES,81929,51586,1118,50468,2012,t1,legislative
19434,64,PYRENEES-ATLANTIQUES,80345,52196,873,51323,2012,t1,legislative
19435,64,PYRENEES-ATLANTIQUES,85476,50427,672,49755,2012,t1,legislative
19436,64,PYRENEES-ATLANTIQUES,94887,55984,797,55187,2012,t1,legislative
19437,65,HAUTES-PYRENEES,88400,53758,1040,52718,2012,t1,legislative
19438,65,HAUTES-PYRENEES,88978,54427,1098,53329,2012,t1,legislative
19439,66,PYRENEES-ORIENTALES,67612,39882,523,39359,2012,t1,legislative
19440,66,PYRENEES-ORIENTALES,89077,54082,997,53085,2012,t1,legislative
19441,66,PYRENEES-ORIENTALES,80130,49138,827,48311,2012,t1,legislative
19442,66,PYRENEES-ORIENTALES,92344,57860,998,56862,2012,t1,legislative
19443,67,BAS-RHIN,63978,33297,280,33017,2012,t1,legislative
19444,67,BAS-RHIN,71162,37489,323,37166,2012,t1,legislative
19445,67,BAS-RHIN,68329,35658,402,35256,2012,t1,legislative
19446,67,BAS-RHIN,89933,50587,629,49958,2012,t1,legislative
19447,67,BAS-RHIN,98427,54519,977,53542,2012,t1,legislative
19448,67,BAS-RHIN,91200,50949,707,50242,2012,t1,legislative
19449,67,BAS-RHIN,84670,47038,841,46197,2012,t1,legislative
19450,67,BAS-RHIN,92744,50184,1006,49178,2012,t1,legislative
19451,67,BAS-RHIN,88326,47713,691,47022,2012,t1,legislative
19452,68,HAUT-RHIN,74093,41472,539,40933,2012,t1,legislative
19453,68,HAUT-RHIN,91139,51910,836,51074,2012,t1,legislative
19454,68,HAUT-RHIN,83583,46309,671,45638,2012,t1,legislative
19455,68,HAUT-RHIN,99189,56242,1059,55183,2012,t1,legislative
19456,68,HAUT-RHIN,78848,41537,701,40836,2012,t1,legislative
19457,68,HAUT-RHIN,92482,48041,959,47082,2012,t1,legislative
19458,69,RHONE,68147,37560,292,37268,2012,t1,legislative
19459,69,RHONE,74893,43606,269,43337,2012,t1,legislative
19460,69,RHONE,70342,39681,290,39391,2012,t1,legislative
19461,69,RHONE,79524,46028,316,45712,2012,t1,legislative
19462,69,RHONE,80543,49525,367,49158,2012,t1,legislative
19463,69,RHONE,78362,41438,409,41029,2012,t1,legislative
19464,69,RHONE,64848,31796,344,31452,2012,t1,legislative
19465,69,RHONE,98429,60032,548,59484,2012,t1,legislative
19466,69,RHONE,85945,49735,501,49234,2012,t1,legislative
19467,69,RHONE,89520,54622,455,54167,2012,t1,legislative
19468,69,RHONE,85531,50807,518,50289,2012,t1,legislative
19469,69,RHONE,76167,45910,333,45577,2012,t1,legislative
19470,69,RHONE,79506,45419,438,44981,2012,t1,legislative
19471,69,RHONE,70147,34146,492,33654,2012,t1,legislative
19472,70,HAUTE-SAONE,88840,57413,927,56486,2012,t1,legislative
19473,70,HAUTE-SAONE,91956,58317,1184,57133,2012,t1,legislative
19474,71,SAONE-ET-LOIRE,72452,42726,562,42164,2012,t1,legislative
19475,71,SAONE-ET-LOIRE,81300,48552,955,47597,2012,t1,legislative
19476,71,SAONE-ET-LOIRE,83735,51394,802,50592,2012,t1,legislative
19477,71,SAONE-ET-LOIRE,81151,48854,740,48114,2012,t1,legislative
19478,71,SAONE-ET-LOIRE,91106,50993,983,50010,2012,t1,legislative
19479,72,SARTHE,72569,42781,816,41965,2012,t1,legislative
19480,72,SARTHE,83350,46779,1039,45740,2012,t1,legislative
19481,72,SARTHE,84851,51125,1100,50025,2012,t1,legislative
19482,72,SARTHE,78913,47492,944,46548,2012,t1,legislative
19483,72,SARTHE,87469,52617,919,51698,2012,t1,legislative
19484,73,SAVOIE,82250,49042,692,48350,2012,t1,legislative
19485,73,SAVOIE,75056,41211,452,40759,2012,t1,legislative
19486,73,SAVOIE,70401,42358,552,41806,2012,t1,legislative
19487,73,SAVOIE,71722,41882,498,41384,2012,t1,legislative
19488,74,HAUTE-SAVOIE,93164,54771,660,54111,2012,t1,legislative
19489,74,HAUTE-SAVOIE,90295,52504,564,51940,2012,t1,legislative
19490,74,HAUTE-SAVOIE,75157,42591,606,41985,2012,t1,legislative
19491,74,HAUTE-SAVOIE,80042,40903,392,40511,2012,t1,legislative
19492,74,HAUTE-SAVOIE,89907,48628,583,48045,2012,t1,legislative
19493,74,HAUTE-SAVOIE,75888,41832,416,41416,2012,t1,legislative
19494,75,PARIS,76662,45728,261,45467,2012,t1,legislative
19495,75,PARIS,71198,45567,264,45303,2012,t1,legislative
19496,75,PARIS,65007,37901,342,37559,2012,t1,legislative
19497,75,PARIS,67401,39259,220,39039,2012,t1,legislative
19498,75,PARIS,70918,42614,337,42277,2012,t1,legislative
19499,75,PARIS,73170,43925,537,43388,2012,t1,legislative
19500,75,PARIS,72464,44396,322,44074,2012,t1,legislative
19501,75,PARIS,80080,48949,473,48476,2012,t1,legislative
19502,75,PARIS,66545,39381,434,38947,2012,t1,legislative
19503,75,PARIS,66720,39484,563,38921,2012,t1,legislative
19504,75,PARIS,69530,44535,354,44181,2012,t1,legislative
19505,75,PARIS,71312,45125,269,44856,2012,t1,legislative
19506,75,PARIS,72599,45719,292,45427,2012,t1,legislative
19507,75,PARIS,69895,39857,259,39598,2012,t1,legislative
19508,75,PARIS,73938,42667,429,42238,2012,t1,legislative
19509,75,PARIS,66230,36416,367,36049,2012,t1,legislative
19510,75,PARIS,55059,28883,313,28570,2012,t1,legislative
19511,75,PARIS,64943,38392,309,38083,2012,t1,legislative
19512,76,SEINE-MARITIME,64761,37229,520,36709,2012,t1,legislative
19513,76,SEINE-MARITIME,91521,55618,928,54690,2012,t1,legislative
19514,76,SEINE-MARITIME,69261,37697,966,36731,2012,t1,legislative
19515,76,SEINE-MARITIME,88988,50174,987,49187,2012,t1,legislative
19516,76,SEINE-MARITIME,94267,54940,893,54047,2012,t1,legislative
19517,76,SEINE-MARITIME,110282,66288,1000,65288,2012,t1,legislative
19518,76,SEINE-MARITIME,89254,49187,719,48468,2012,t1,legislative
19519,76,SEINE-MARITIME,70545,34027,648,33379,2012,t1,legislative
19520,76,SEINE-MARITIME,92403,55056,796,54260,2012,t1,legislative
19521,76,SEINE-MARITIME,105897,66327,1076,65251,2012,t1,legislative
19522,77,SEINE-ET-MARNE,67785,37891,354,37537,2012,t1,legislative
19523,77,SEINE-ET-MARNE,78548,46314,509,45805,2012,t1,legislative
19524,77,SEINE-ET-MARNE,72468,42803,600,42203,2012,t1,legislative
19525,77,SEINE-ET-MARNE,85125,49984,678,49306,2012,t1,legislative
19526,77,SEINE-ET-MARNE,78929,44511,514,43997,2012,t1,legislative
19527,77,SEINE-ET-MARNE,74061,43909,475,43434,2012,t1,legislative
19528,77,SEINE-ET-MARNE,81916,45425,472,44953,2012,t1,legislative
19529,77,SEINE-ET-MARNE,82686,44519,530,43989,2012,t1,legislative
19530,77,SEINE-ET-MARNE,82229,44402,521,43881,2012,t1,legislative
19531,77,SEINE-ET-MARNE,78331,40380,503,39877,2012,t1,legislative
19532,77,SEINE-ET-MARNE,62581,31949,627,31322,2012,t1,legislative
19533,78,YVELINES,81679,49640,443,49197,2012,t1,legislative
19534,78,YVELINES,83179,52069,385,51684,2012,t1,legislative
19535,78,YVELINES,81513,49142,411,48731,2012,t1,legislative
19536,78,YVELINES,76867,45966,359,45607,2012,t1,legislative
19537,78,YVELINES,72106,41591,401,41190,2012,t1,legislative
19538,78,YVELINES,74205,41377,416,40961,2012,t1,legislative
19539,78,YVELINES,78360,44348,490,43858,2012,t1,legislative
19540,78,YVELINES,71093,37987,549,37438,2012,t1,legislative
19541,78,YVELINES,89317,49483,941,48542,2012,t1,legislative
19542,78,YVELINES,86791,53576,590,52986,2012,t1,legislative
19543,78,YVELINES,65700,37300,401,36899,2012,t1,legislative
19544,78,YVELINES,66393,39435,472,38963,2012,t1,legislative
19545,79,DEUX-SEVRES,88446,51507,931,50576,2012,t1,legislative
19546,79,DEUX-SEVRES,97217,58275,1437,56838,2012,t1,legislative
19547,79,DEUX-SEVRES,85113,51193,1052,50141,2012,t1,legislative
19548,80,SOMME,85137,47732,987,46745,2012,t1,legislative
19549,80,SOMME,75033,42748,560,42188,2012,t1,legislative
19550,80,SOMME,84696,54980,1178,53802,2012,t1,legislative
19551,80,SOMME,82797,52138,992,51146,2012,t1,legislative
19552,80,SOMME,81995,51551,680,50871,2012,t1,legislative
19553,81,TARN,83084,54095,929,53166,2012,t1,legislative
19554,81,TARN,102423,64853,1575,63278,2012,t1,legislative
19555,81,TARN,98454,64727,1161,63566,2012,t1,legislative
19556,82,TARN-ET-GARONNE,86113,55018,944,54074,2012,t1,legislative
19557,82,TARN-ET-GARONNE,89296,55596,1167,54429,2012,t1,legislative
19558,83,VAR,73594,40386,411,39975,2012,t1,legislative
19559,83,VAR,87294,48582,589,47993,2012,t1,legislative
19560,83,VAR,97734,56961,798,56163,2012,t1,legislative
19561,83,VAR,99234,56968,715,56253,2012,t1,legislative
19562,83,VAR,91027,52484,596,51888,2012,t1,legislative
19563,83,VAR,108178,63588,695,62893,2012,t1,legislative
19564,83,VAR,101228,56652,680,55972,2012,t1,legislative
19565,83,VAR,99861,60075,715,59360,2012,t1,legislative
19566,84,VAUCLUSE,72480,41038,570,40468,2012,t1,legislative
19567,84,VAUCLUSE,80396,49703,647,49056,2012,t1,legislative
19568,84,VAUCLUSE,70918,44301,509,43792,2012,t1,legislative
19569,84,VAUCLUSE,86087,53007,842,52165,2012,t1,legislative
19570,84,VAUCLUSE,78545,47751,708,47043,2012,t1,legislative
19571,85,VENDEE,102171,60327,1493,58834,2012,t1,legislative
19572,85,VENDEE,97865,60388,1505,58883,2012,t1,legislative
19573,85,VENDEE,113872,67930,1031,66899,2012,t1,legislative
19574,85,VENDEE,94523,56858,1102,55756,2012,t1,legislative
19575,85,VENDEE,80539,49735,838,48897,2012,t1,legislative
19576,86,VIENNE,77232,43966,869,43097,2012,t1,legislative
19577,86,VIENNE,75580,44734,711,44023,2012,t1,legislative
19578,86,VIENNE,74817,44839,1162,43677,2012,t1,legislative
19579,86,VIENNE,75948,43012,953,42059,2012,t1,legislative
19580,87,HAUTE-VIENNE,84652,51359,1176,50183,2012,t1,legislative
19581,87,HAUTE-VIENNE,96680,61593,1445,60148,2012,t1,legislative
19582,87,HAUTE-VIENNE,83525,51980,1114,50866,2012,t1,legislative
19583,88,VOSGES,76603,45084,1051,44033,2012,t1,legislative
19584,88,VOSGES,74268,44919,881,44038,2012,t1,legislative
19585,88,VOSGES,66793,41194,808,40386,2012,t1,legislative
19586,88,VOSGES,67906,42240,847,41393,2012,t1,legislative
19587,89,YONNE,78339,47187,666,46521,2012,t1,legislative
19588,89,YONNE,77710,46904,707,46197,2012,t1,legislative
19589,89,YONNE,89161,52079,767,51312,2012,t1,legislative
19590,90,TERRITOIRE-DE-BELFORT,47187,28539,406,28133,2012,t1,legislative
19591,90,TERRITOIRE-DE-BELFORT,47779,28539,515,28024,2012,t1,legislative
19592,91,ESSONNE,70325,34638,567,34071,2012,t1,legislative
19593,91,ESSONNE,87370,51618,491,51127,2012,t1,legislative
19594,91,ESSONNE,92141,54485,648,53837,2012,t1,legislative
19595,91,ESSONNE,92245,57089,566,56523,2012,t1,legislative
19596,91,ESSONNE,66683,42308,405,41903,2012,t1,legislative
19597,91,ESSONNE,76221,44801,435,44366,2012,t1,legislative
19598,91,ESSONNE,71747,40294,601,39693,2012,t1,legislative
19599,91,ESSONNE,75339,44446,301,44145,2012,t1,legislative
19600,91,ESSONNE,76276,43617,579,43038,2012,t1,legislative
19601,91,ESSONNE,60673,32064,486,31578,2012,t1,legislative
19602,92,HAUTS-DE-SEINE,59481,28911,532,28379,2012,t1,legislative
19603,92,HAUTS-DE-SEINE,63572,37912,424,37488,2012,t1,legislative
19604,92,HAUTS-DE-SEINE,76553,45815,727,45088,2012,t1,legislative
19605,92,HAUTS-DE-SEINE,70836,39067,639,38428,2012,t1,legislative
19606,92,HAUTS-DE-SEINE,68822,40634,512,40122,2012,t1,legislative
19607,92,HAUTS-DE-SEINE,73407,43852,758,43094,2012,t1,legislative
19608,92,HAUTS-DE-SEINE,83959,50909,493,50416,2012,t1,legislative
19609,92,HAUTS-DE-SEINE,67018,41575,415,41160,2012,t1,legislative
19610,92,HAUTS-DE-SEINE,61020,36441,340,36101,2012,t1,legislative
19611,92,HAUTS-DE-SEINE,71749,43923,533,43390,2012,t1,legislative
19612,92,HAUTS-DE-SEINE,67356,39420,387,39033,2012,t1,legislative
19613,92,HAUTS-DE-SEINE,89869,55919,501,55418,2012,t1,legislative
19614,92,HAUTS-DE-SEINE,86549,54997,728,54269,2012,t1,legislative
19615,93,SEINE-SAINT-DENIS,55214,25524,390,25134,2012,t1,legislative
19616,93,SEINE-SAINT-DENIS,51767,22507,379,22128,2012,t1,legislative
19617,93,SEINE-SAINT-DENIS,70715,37313,553,36760,2012,t1,legislative
19618,93,SEINE-SAINT-DENIS,60162,26474,519,25955,2012,t1,legislative
19619,93,SEINE-SAINT-DENIS,62242,30024,412,29612,2012,t1,legislative
19620,93,SEINE-SAINT-DENIS,49966,22887,357,22530,2012,t1,legislative
19621,93,SEINE-SAINT-DENIS,70898,36020,605,35415,2012,t1,legislative
19622,93,SEINE-SAINT-DENIS,60129,33135,476,32659,2012,t1,legislative
19623,93,SEINE-SAINT-DENIS,66535,33188,598,32590,2012,t1,legislative
19624,93,SEINE-SAINT-DENIS,67078,32746,480,32266,2012,t1,legislative
19625,93,SEINE-SAINT-DENIS,62048,30182,445,29737,2012,t1,legislative
19626,93,SEINE-SAINT-DENIS,64451,33657,379,33278,2012,t1,legislative
19627,94,VAL-DE-MARNE,82695,48653,550,48103,2012,t1,legislative
19628,94,VAL-DE-MARNE,65093,32317,501,31816,2012,t1,legislative
19629,94,VAL-DE-MARNE,70815,37848,588,37260,2012,t1,legislative
19630,94,VAL-DE-MARNE,71850,40933,486,40447,2012,t1,legislative
19631,94,VAL-DE-MARNE,86113,47449,532,46917,2012,t1,legislative
19632,94,VAL-DE-MARNE,78031,46268,415,45853,2012,t1,legislative
19633,94,VAL-DE-MARNE,63662,36627,375,36252,2012,t1,legislative
19634,94,VAL-DE-MARNE,73789,44434,399,44035,2012,t1,legislative
19635,94,VAL-DE-MARNE,53318,26363,359,26004,2012,t1,legislative
19636,94,VAL-DE-MARNE,63302,32860,430,32430,2012,t1,legislative
19637,94,VAL-DE-MARNE,59907,31725,445,31280,2012,t1,legislative
19638,95,VAL-D'OISE,78679,46238,518,45720,2012,t1,legislative
19639,95,VAL-D'OISE,73480,42473,475,41998,2012,t1,legislative
19640,95,VAL-D'OISE,88017,48926,578,48348,2012,t1,legislative
19641,95,VAL-D'OISE,72614,41304,441,40863,2012,t1,legislative
19642,95,VAL-D'OISE,68075,34304,488,33816,2012,t1,legislative
19643,95,VAL-D'OISE,74709,40961,344,40617,2012,t1,legislative
19644,95,VAL-D'OISE,67830,36339,370,35969,2012,t1,legislative
19645,95,VAL-D'OISE,52042,22367,471,21896,2012,t1,legislative
19646,95,VAL-D'OISE,67835,33907,492,33415,2012,t1,legislative
19647,95,VAL-D'OISE,62833,32347,416,31931,2012,t1,legislative
19648,971,GUADELOUPE,73195,22239,1781,20458,2012,t1,legislative
19649,971,GUADELOUPE,81526,25497,1173,24324,2012,t1,legislative
19650,971,GUADELOUPE,76966,26755,1314,25441,2012,t1,legislative
19651,971,GUADELOUPE,66943,28421,1383,27038,2012,t1,legislative
19652,972,MARTINIQUE,76402,24466,1483,22983,2012,t1,legislative
19653,972,MARTINIQUE,81699,28392,1811,26581,2012,t1,legislative
19654,972,MARTINIQUE,65814,19569,1062,18507,2012,t1,legislative
19655,972,MARTINIQUE,79005,27281,1258,26023,2012,t1,legislative
19656,973,GUYANE,46389,13418,850,12568,2012,t1,legislative
19657,973,GUYANE,30818,10097,406,9691,2012,t1,legislative
19658,974,LA-REUNION,73995,34003,1294,32709,2012,t1,legislative
19659,974,LA-REUNION,84036,39881,1553,38328,2012,t1,legislative
19660,974,LA-REUNION,83850,41921,2129,39792,2012,t1,legislative
19661,974,LA-REUNION,94872,49864,2269,47595,2012,t1,legislative
19662,974,LA-REUNION,75802,31596,1496,30100,2012,t1,legislative
19663,974,LA-REUNION,67883,29184,1629,27555,2012,t1,legislative
19664,974,LA-REUNION,99102,45388,2480,42908,2012,t1,legislative
19665,975,SAINT-PIERRE-ET-MIQUELON,4926,2636,81,2555,2012,t1,legislative
19666,979,SAINT-MARTIN/SAINT-BARTHELEMY,22734,6835,216,6619,2012,t1,legislative
19667,985,MAYOTTE,35601,16280,806,15474,2012,t1,legislative
19668,985,MAYOTTE,41990,22449,1167,21282,2012,t1,legislative
19669,986,WALLIS-ET-FUTUNA,8980,7012,78,6934,2012,t1,legislative
19670,987,POLYNESIE-FRANCAISE,67132,30746,560,30186,2012,t1,legislative
19671,987,POLYNESIE-FRANCAISE,59491,26303,498,25805,2012,t1,legislative
19672,987,POLYNESIE-FRANCAISE,60194,28498,503,27995,2012,t1,legislative
19673,988,NOUVELLE-CALEDONIE,76453,35765,620,35145,2012,t1,legislative
19674,988,NOUVELLE-CALEDONIE,89323,44910,1009,43901,2012,t1,legislative
19675,99,FRANCAIS-DE-L'ETRANGER,156683,31958,359,31599,2012,t1,legislative
19676,99,FRANCAIS-DE-L'ETRANGER,73237,11680,175,11505,2012,t1,legislative
19677,99,FRANCAIS-DE-L'ETRANGER,88513,18402,212,18190,2012,t1,legislative
19678,99,FRANCAIS-DE-L'ETRANGER,96959,23332,208,23124,2012,t1,legislative
19679,99,FRANCAIS-DE-L'ETRANGER,79386,16185,229,15956,2012,t1,legislative
19680,99,FRANCAIS-DE-L'ETRANGER,106695,23390,220,23170,2012,t1,legislative
19681,99,FRANCAIS-DE-L'ETRANGER,89033,21072,216,20856,2012,t1,legislative
19682,99,FRANCAIS-DE-L'ETRANGER,109411,14626,202,14424,2012,t1,legislative
19683,99,FRANCAIS-DE-L'ETRANGER,96769,17150,210,16940,2012,t1,legislative
19684,99,FRANCAIS-DE-L'ETRANGER,91600,21325,320,21005,2012,t1,legislative
19685,99,FRANCAIS-DE-L'ETRANGER,79171,22117,285,21832,2012,t1,legislative
19686,1,AIN,86633,52073,744,51329,2007,t1,legislative
19687,1,AIN,92466,51453,727,50726,2007,t1,legislative
19688,1,AIN,86694,48252,803,47449,2007,t1,legislative
19689,1,AIN,109734,64519,957,63562,2007,t1,legislative
19690,2,AISNE,72349,44389,830,43559,2007,t1,legislative
19691,2,AISNE,74698,45905,847,45058,2007,t1,legislative
19692,2,AISNE,72227,44740,898,43842,2007,t1,legislative
19693,2,AISNE,79255,45829,740,45089,2007,t1,legislative
19694,2,AISNE,80005,48584,780,47804,2007,t1,legislative
19695,3,ALLIER,58298,36848,811,36037,2007,t1,legislative
19696,3,ALLIER,66362,42110,951,41159,2007,t1,legislative
19697,3,ALLIER,70737,46393,1244,45149,2007,t1,legislative
19698,3,ALLIER,64844,40793,671,40122,2007,t1,legislative
19699,4,ALPES-DE-HAUTE-PROVENCE,58493,38951,754,38197,2007,t1,legislative
19700,4,ALPES-DE-HAUTE-PROVENCE,60866,40132,671,39461,2007,t1,legislative
19701,5,HAUTES-ALPES,57650,37776,759,37017,2007,t1,legislative
19702,5,HAUTES-ALPES,45853,31025,495,30530,2007,t1,legislative
19703,6,ALPES-MARITIMES,58304,34087,386,33701,2007,t1,legislative
19704,6,ALPES-MARITIMES,62011,35594,380,35214,2007,t1,legislative
19705,6,ALPES-MARITIMES,70019,39368,875,38493,2007,t1,legislative
19706,6,ALPES-MARITIMES,73676,42447,770,41677,2007,t1,legislative
19707,6,ALPES-MARITIMES,86809,54907,676,54231,2007,t1,legislative
19708,6,ALPES-MARITIMES,107076,65126,863,64263,2007,t1,legislative
19709,6,ALPES-MARITIMES,98611,59043,778,58265,2007,t1,legislative
19710,6,ALPES-MARITIMES,67697,40625,526,40099,2007,t1,legislative
19711,6,ALPES-MARITIMES,106458,66617,704,65913,2007,t1,legislative
19712,7,ARDECHE,73760,47402,731,46671,2007,t1,legislative
19713,7,ARDECHE,88921,55389,1032,54357,2007,t1,legislative
19714,7,ARDECHE,73240,48480,805,47675,2007,t1,legislative
19715,8,ARDENNES,73473,43346,590,42756,2007,t1,legislative
19716,8,ARDENNES,66252,37434,533,36901,2007,t1,legislative
19717,8,ARDENNES,59999,36706,454,36252,2007,t1,legislative
19718,9,ARIEGE,56045,36494,1061,35433,2007,t1,legislative
19719,9,ARIEGE,58240,38172,967,37205,2007,t1,legislative
19720,10,AUBE,58054,34744,1151,33593,2007,t1,legislative
19721,10,AUBE,73373,43071,814,42257,2007,t1,legislative
19722,10,AUBE,74340,42563,772,41791,2007,t1,legislative
19723,11,AUDE,70199,45848,993,44855,2007,t1,legislative
19724,11,AUDE,110430,70795,1402,69393,2007,t1,legislative
19725,11,AUDE,74191,50707,1335,49372,2007,t1,legislative
19726,12,AVEYRON,74596,50761,1218,49543,2007,t1,legislative
19727,12,AVEYRON,71709,48299,1317,46982,2007,t1,legislative
19728,12,AVEYRON,72119,49593,1344,48249,2007,t1,legislative
19729,13,BOUCHES-DU-RHONE,60376,35427,399,35028,2007,t1,legislative
19730,13,BOUCHES-DU-RHONE,65315,39129,354,38775,2007,t1,legislative
19731,13,BOUCHES-DU-RHONE,46659,26728,336,26392,2007,t1,legislative
19732,13,BOUCHES-DU-RHONE,48055,24973,359,24614,2007,t1,legislative
19733,13,BOUCHES-DU-RHONE,54197,31025,390,30635,2007,t1,legislative
19734,13,BOUCHES-DU-RHONE,70103,39610,540,39070,2007,t1,legislative
19735,13,BOUCHES-DU-RHONE,52038,26403,484,25919,2007,t1,legislative
19736,13,BOUCHES-DU-RHONE,74134,42048,560,41488,2007,t1,legislative
19737,13,BOUCHES-DU-RHONE,89495,53401,880,52521,2007,t1,legislative
19738,13,BOUCHES-DU-RHONE,123763,74487,902,73585,2007,t1,legislative
19739,13,BOUCHES-DU-RHONE,100136,58770,910,57860,2007,t1,legislative
19740,13,BOUCHES-DU-RHONE,109083,60727,1168,59559,2007,t1,legislative
19741,13,BOUCHES-DU-RHONE,89518,53765,1014,52751,2007,t1,legislative
19742,13,BOUCHES-DU-RHONE,101909,61052,843,60209,2007,t1,legislative
19743,13,BOUCHES-DU-RHONE,100081,62537,1236,61301,2007,t1,legislative
19744,13,BOUCHES-DU-RHONE,84630,51131,844,50287,2007,t1,legislative
19745,14,CALVADOS,71009,43596,568,43028,2007,t1,legislative
19746,14,CALVADOS,67480,39771,747,39024,2007,t1,legislative
19747,14,CALVADOS,74344,44965,976,43989,2007,t1,legislative
19748,14,CALVADOS,81648,50394,841,49553,2007,t1,legislative
19749,14,CALVADOS,101401,63408,919,62489,2007,t1,legislative
19750,14,CALVADOS,88719,56575,1087,55488,2007,t1,legislative
19751,15,CANTAL,64765,41385,812,40573,2007,t1,legislative
19752,15,CANTAL,58700,37612,830,36782,2007,t1,legislative
19753,16,CHARENTE,63710,39044,895,38149,2007,t1,legislative
19754,16,CHARENTE,62486,37787,725,37062,2007,t1,legislative
19755,16,CHARENTE,69148,45265,1154,44111,2007,t1,legislative
19756,16,CHARENTE,65346,40644,813,39831,2007,t1,legislative
19757,17,CHARENTE-MARITIME,96453,59242,556,58686,2007,t1,legislative
19758,17,CHARENTE-MARITIME,92261,55516,992,54524,2007,t1,legislative
19759,17,CHARENTE-MARITIME,79765,49234,956,48278,2007,t1,legislative
19760,17,CHARENTE-MARITIME,85792,52695,1808,50887,2007,t1,legislative
19761,17,CHARENTE-MARITIME,100474,60808,1218,59590,2007,t1,legislative
19762,18,CHER,75006,45170,931,44239,2007,t1,legislative
19763,18,CHER,70167,41324,898,40426,2007,t1,legislative
19764,18,CHER,87463,53748,1308,52440,2007,t1,legislative
19765,19,CORREZE,65958,48127,1082,47045,2007,t1,legislative
19766,19,CORREZE,69686,46020,1029,44991,2007,t1,legislative
19767,19,CORREZE,51949,37604,995,36609,2007,t1,legislative
19768,21,COTE-D'OR,67218,43016,453,42563,2007,t1,legislative
19769,21,COTE-D'OR,64506,39422,556,38866,2007,t1,legislative
19770,21,COTE-D'OR,68655,39827,652,39175,2007,t1,legislative
19771,21,COTE-D'OR,69521,44049,1104,42945,2007,t1,legislative
19772,21,COTE-D'OR,81389,48848,802,48046,2007,t1,legislative
19773,22,COTES-D'ARMOR,88612,56746,1215,55531,2007,t1,legislative
19774,22,COTES-D'ARMOR,91353,61734,1108,60626,2007,t1,legislative
19775,22,COTES-D'ARMOR,85600,58571,1048,57523,2007,t1,legislative
19776,22,COTES-D'ARMOR,79896,53200,1022,52178,2007,t1,legislative
19777,22,COTES-D'ARMOR,101768,67738,1056,66682,2007,t1,legislative
19778,23,CREUSE,50902,32491,745,31746,2007,t1,legislative
19779,23,CREUSE,48955,33143,901,32242,2007,t1,legislative
19780,24,DORDOGNE,74714,50599,1073,49526,2007,t1,legislative
19781,24,DORDOGNE,79137,52556,1244,51312,2007,t1,legislative
19782,24,DORDOGNE,70433,50936,1471,49465,2007,t1,legislative
19783,24,DORDOGNE,85689,59658,1297,58361,2007,t1,legislative
19784,25,DOUBS,71436,43289,673,42616,2007,t1,legislative
19785,25,DOUBS,75388,47143,629,46514,2007,t1,legislative
19786,25,DOUBS,66143,40648,777,39871,2007,t1,legislative
19787,25,DOUBS,67563,40314,771,39543,2007,t1,legislative
19788,25,DOUBS,74591,47136,882,46254,2007,t1,legislative
19789,26,DROME,73065,42351,648,41703,2007,t1,legislative
19790,26,DROME,82526,50256,817,49439,2007,t1,legislative
19791,26,DROME,98034,64152,1063,63089,2007,t1,legislative
19792,26,DROME,85625,51688,703,50985,2007,t1,legislative
19793,27,EURE,83353,49194,905,48289,2007,t1,legislative
19794,27,EURE,74702,46281,883,45398,2007,t1,legislative
19795,27,EURE,78235,49462,1040,48422,2007,t1,legislative
19796,27,EURE,83473,50577,941,49636,2007,t1,legislative
19797,27,EURE,84999,51403,1110,50293,2007,t1,legislative
19798,28,EURE-ET-LOIR,85310,51487,917,50570,2007,t1,legislative
19799,28,EURE-ET-LOIR,70131,40043,644,39399,2007,t1,legislative
19800,28,EURE-ET-LOIR,71277,42545,855,41690,2007,t1,legislative
19801,28,EURE-ET-LOIR,67909,42890,1016,41874,2007,t1,legislative
19802,29,FINISTERE,84724,57402,737,56665,2007,t1,legislative
19803,29,FINISTERE,71219,43219,650,42569,2007,t1,legislative
19804,29,FINISTERE,92511,59753,766,58987,2007,t1,legislative
19805,29,FINISTERE,82373,54262,745,53517,2007,t1,legislative
19806,29,FINISTERE,88793,57713,658,57055,2007,t1,legislative
19807,29,FINISTERE,88705,60434,850,59584,2007,t1,legislative
19808,29,FINISTERE,79288,53638,671,52967,2007,t1,legislative
19809,29,FINISTERE,82005,53969,954,53015,2007,t1,legislative
19810,2A,CORSE-DU-SUD,44702,26514,313,26201,2007,t1,legislative
19811,2A,CORSE-DU-SUD,49711,29276,481,28795,2007,t1,legislative
19812,2B,HAUTE-CORSE,51544,29674,626,29048,2007,t1,legislative
19813,2B,HAUTE-CORSE,60371,39952,506,39446,2007,t1,legislative
19814,30,GARD,83134,47449,804,46645,2007,t1,legislative
19815,30,GARD,114608,67363,1217,66146,2007,t1,legislative
19816,30,GARD,114080,69865,1417,68448,2007,t1,legislative
19817,30,GARD,85477,54290,885,53405,2007,t1,legislative
19818,30,GARD,93691,59784,1104,58680,2007,t1,legislative
19819,31,HAUTE-GARONNE,70421,40914,449,40465,2007,t1,legislative
19820,31,HAUTE-GARONNE,110647,71198,930,70268,2007,t1,legislative
19821,31,HAUTE-GARONNE,85676,55642,737,54905,2007,t1,legislative
19822,31,HAUTE-GARONNE,55578,32286,341,31945,2007,t1,legislative
19823,31,HAUTE-GARONNE,138363,87568,1533,86035,2007,t1,legislative
19824,31,HAUTE-GARONNE,130034,80825,1437,79388,2007,t1,legislative
19825,31,HAUTE-GARONNE,121352,80152,1778,78374,2007,t1,legislative
19826,31,HAUTE-GARONNE,82836,52824,1325,51499,2007,t1,legislative
19827,32,GERS,72235,48469,1257,47212,2007,t1,legislative
19828,32,GERS,68540,46552,1088,45464,2007,t1,legislative
19829,33,GIRONDE,82500,51208,510,50698,2007,t1,legislative
19830,33,GIRONDE,60329,36472,294,36178,2007,t1,legislative
19831,33,GIRONDE,72243,45293,783,44510,2007,t1,legislative
19832,33,GIRONDE,82735,49223,716,48507,2007,t1,legislative
19833,33,GIRONDE,95595,59700,1176,58524,2007,t1,legislative
19834,33,GIRONDE,89294,57405,700,56705,2007,t1,legislative
19835,33,GIRONDE,96647,62992,805,62187,2007,t1,legislative
19836,33,GIRONDE,119365,77884,1046,76838,2007,t1,legislative
19837,33,GIRONDE,98811,64415,1076,63339,2007,t1,legislative
19838,33,GIRONDE,78587,49969,960,49009,2007,t1,legislative
19839,33,GIRONDE,82999,51476,1223,50253,2007,t1,legislative
19840,34,HERAULT,76675,45124,695,44429,2007,t1,legislative
19841,34,HERAULT,67096,39048,589,38459,2007,t1,legislative
19842,34,HERAULT,126007,79847,1221,78626,2007,t1,legislative
19843,34,HERAULT,134232,86410,1490,84920,2007,t1,legislative
19844,34,HERAULT,95751,62499,1261,61238,2007,t1,legislative
19845,34,HERAULT,84451,49827,1022,48805,2007,t1,legislative
19846,34,HERAULT,119819,73707,1288,72419,2007,t1,legislative
19847,35,ILLE-ET-VILAINE,74388,44089,555,43534,2007,t1,legislative
19848,35,ILLE-ET-VILAINE,98110,62319,860,61459,2007,t1,legislative
19849,35,ILLE-ET-VILAINE,91318,58257,796,57461,2007,t1,legislative
19850,35,ILLE-ET-VILAINE,109625,67794,1344,66450,2007,t1,legislative
19851,35,ILLE-ET-VILAINE,118780,75651,1170,74481,2007,t1,legislative
19852,35,ILLE-ET-VILAINE,77986,49413,1321,48092,2007,t1,legislative
19853,35,ILLE-ET-VILAINE,99052,62510,864,61646,2007,t1,legislative
19854,36,INDRE,56273,33972,772,33200,2007,t1,legislative
19855,36,INDRE,64650,40864,1285,39579,2007,t1,legislative
19856,36,INDRE,56668,37047,1057,35990,2007,t1,legislative
19857,37,INDRE-ET-LOIRE,54537,32199,301,31898,2007,t1,legislative
19858,37,INDRE-ET-LOIRE,92052,57888,1027,56861,2007,t1,legislative
19859,37,INDRE-ET-LOIRE,92487,59358,1062,58296,2007,t1,legislative
19860,37,INDRE-ET-LOIRE,86403,54109,850,53259,2007,t1,legislative
19861,37,INDRE-ET-LOIRE,78148,49460,767,48693,2007,t1,legislative
19862,38,ISERE,79528,50195,606,49589,2007,t1,legislative
19863,38,ISERE,73047,42600,578,42022,2007,t1,legislative
19864,38,ISERE,60329,33889,401,33488,2007,t1,legislative
19865,38,ISERE,85431,51548,557,50991,2007,t1,legislative
19866,38,ISERE,93100,57490,686,56804,2007,t1,legislative
19867,38,ISERE,106192,58887,930,57957,2007,t1,legislative
19868,38,ISERE,100185,58084,975,57109,2007,t1,legislative
19869,38,ISERE,102583,58962,985,57977,2007,t1,legislative
19870,38,ISERE,88999,54675,681,53994,2007,t1,legislative
19871,39,JURA,64544,41054,758,40296,2007,t1,legislative
19872,39,JURA,55538,33598,661,32937,2007,t1,legislative
19873,39,JURA,67880,42969,685,42284,2007,t1,legislative
19874,40,LANDES,92996,60690,1237,59453,2007,t1,legislative
19875,40,LANDES,107686,70273,1327,68946,2007,t1,legislative
19876,40,LANDES,83242,58991,1092,57899,2007,t1,legislative
19877,41,LOIR-ET-CHER,90614,55678,1511,54167,2007,t1,legislative
19878,41,LOIR-ET-CHER,80085,50835,897,49938,2007,t1,legislative
19879,41,LOIR-ET-CHER,70851,45793,1154,44639,2007,t1,legislative
19880,42,LOIRE,68932,37369,466,36903,2007,t1,legislative
19881,42,LOIRE,50133,26733,279,26454,2007,t1,legislative
19882,42,LOIRE,79118,44824,680,44144,2007,t1,legislative
19883,42,LOIRE,69176,40026,611,39415,2007,t1,legislative
19884,42,LOIRE,69277,42308,694,41614,2007,t1,legislative
19885,42,LOIRE,69461,41631,915,40716,2007,t1,legislative
19886,42,LOIRE,101752,60114,970,59144,2007,t1,legislative
19887,43,HAUTE-LOIRE,93127,60583,1130,59453,2007,t1,legislative
19888,43,HAUTE-LOIRE,80368,50873,1490,49383,2007,t1,legislative
19889,44,LOIRE-ATLANTIQUE,72900,45765,612,45153,2007,t1,legislative
19890,44,LOIRE-ATLANTIQUE,82595,49782,421,49361,2007,t1,legislative
19891,44,LOIRE-ATLANTIQUE,87052,53382,701,52681,2007,t1,legislative
19892,44,LOIRE-ATLANTIQUE,79656,50157,689,49468,2007,t1,legislative
19893,44,LOIRE-ATLANTIQUE,114929,76029,1257,74772,2007,t1,legislative
19894,44,LOIRE-ATLANTIQUE,77241,49732,1126,48606,2007,t1,legislative
19895,44,LOIRE-ATLANTIQUE,105603,67388,951,66437,2007,t1,legislative
19896,44,LOIRE-ATLANTIQUE,79112,46550,745,45805,2007,t1,legislative
19897,44,LOIRE-ATLANTIQUE,99468,64264,1319,62945,2007,t1,legislative
19898,44,LOIRE-ATLANTIQUE,99066,67354,2751,64603,2007,t1,legislative
19899,45,LOIRET,82688,51109,735,50374,2007,t1,legislative
19900,45,LOIRET,81761,49493,749,48744,2007,t1,legislative
19901,45,LOIRET,89957,54533,982,53551,2007,t1,legislative
19902,45,LOIRET,93586,56666,1000,55666,2007,t1,legislative
19903,45,LOIRET,89807,55323,1072,54251,2007,t1,legislative
19904,46,LOT,68789,47041,1072,45969,2007,t1,legislative
19905,46,LOT,64697,44465,1259,43206,2007,t1,legislative
19906,47,LOT-ET-GARONNE,85911,55453,1408,54045,2007,t1,legislative
19907,47,LOT-ET-GARONNE,77364,51140,1358,49782,2007,t1,legislative
19908,47,LOT-ET-GARONNE,76202,50751,1112,49639,2007,t1,legislative
19909,48,LOZERE,32054,22421,405,22016,2007,t1,legislative
19910,48,LOZERE,27563,19564,491,19073,2007,t1,legislative
19911,49,MAINE-ET-LOIRE,79739,49659,1193,48466,2007,t1,legislative
19912,49,MAINE-ET-LOIRE,85505,52718,1073,51645,2007,t1,legislative
19913,49,MAINE-ET-LOIRE,67733,41303,1110,40193,2007,t1,legislative
19914,49,MAINE-ET-LOIRE,72254,44972,1177,43795,2007,t1,legislative
19915,49,MAINE-ET-LOIRE,74425,45858,1201,44657,2007,t1,legislative
19916,49,MAINE-ET-LOIRE,90199,57879,1541,56338,2007,t1,legislative
19917,49,MAINE-ET-LOIRE,72773,46183,1160,45023,2007,t1,legislative
19918,50,MANCHE,74479,45741,876,44865,2007,t1,legislative
19919,50,MANCHE,76020,49929,1278,48651,2007,t1,legislative
19920,50,MANCHE,76815,48090,833,47257,2007,t1,legislative
19921,50,MANCHE,73232,45078,730,44348,2007,t1,legislative
19922,50,MANCHE,72119,43579,521,43058,2007,t1,legislative
19923,51,MARNE,57918,30785,815,29970,2007,t1,legislative
19924,51,MARNE,67392,38554,869,37685,2007,t1,legislative
19925,51,MARNE,65614,36056,869,35187,2007,t1,legislative
19926,51,MARNE,61229,33952,557,33395,2007,t1,legislative
19927,51,MARNE,63920,37478,802,36676,2007,t1,legislative
19928,51,MARNE,68021,38855,665,38190,2007,t1,legislative
19929,52,HAUTE-MARNE,76457,46354,1091,45263,2007,t1,legislative
19930,52,HAUTE-MARNE,66277,37657,744,36913,2007,t1,legislative
19931,53,MAYENNE,81703,52060,1122,50938,2007,t1,legislative
19932,53,MAYENNE,66988,41341,1179,40162,2007,t1,legislative
19933,53,MAYENNE,72003,46529,1231,45298,2007,t1,legislative
19934,54,MEURTHE-ET-MOSELLE,52930,29505,302,29203,2007,t1,legislative
19935,54,MEURTHE-ET-MOSELLE,78217,45620,640,44980,2007,t1,legislative
19936,54,MEURTHE-ET-MOSELLE,58299,33665,404,33261,2007,t1,legislative
19937,54,MEURTHE-ET-MOSELLE,77958,45592,792,44800,2007,t1,legislative
19938,54,MEURTHE-ET-MOSELLE,75355,45884,792,45092,2007,t1,legislative
19939,54,MEURTHE-ET-MOSELLE,78422,42587,803,41784,2007,t1,legislative
19940,54,MEURTHE-ET-MOSELLE,71293,36414,605,35809,2007,t1,legislative
19941,55,MEUSE,80070,47850,1203,46647,2007,t1,legislative
19942,55,MEUSE,61656,35959,695,35264,2007,t1,legislative
19943,56,MORBIHAN,104525,67704,1290,66414,2007,t1,legislative
19944,56,MORBIHAN,93252,61387,877,60510,2007,t1,legislative
19945,56,MORBIHAN,83363,54983,1059,53924,2007,t1,legislative
19946,56,MORBIHAN,87247,56339,1201,55138,2007,t1,legislative
19947,56,MORBIHAN,81377,49200,1519,47681,2007,t1,legislative
19948,56,MORBIHAN,87095,58293,1119,57174,2007,t1,legislative
19949,57,MOSELLE,74267,38597,664,37933,2007,t1,legislative
19950,57,MOSELLE,75382,39769,737,39032,2007,t1,legislative
19951,57,MOSELLE,72476,39029,599,38430,2007,t1,legislative
19952,57,MOSELLE,69857,40271,1198,39073,2007,t1,legislative
19953,57,MOSELLE,75379,40296,1168,39128,2007,t1,legislative
19954,57,MOSELLE,73486,33423,879,32544,2007,t1,legislative
19955,57,MOSELLE,79960,40739,1080,39659,2007,t1,legislative
19956,57,MOSELLE,76558,39466,937,38529,2007,t1,legislative
19957,57,MOSELLE,73850,38373,547,37826,2007,t1,legislative
19958,57,MOSELLE,70850,33280,643,32637,2007,t1,legislative
19959,58,NIEVRE,55622,32441,694,31747,2007,t1,legislative
19960,58,NIEVRE,60586,37304,710,36594,2007,t1,legislative
19961,58,NIEVRE,53505,34504,673,33831,2007,t1,legislative
19962,59,NORD,58780,30928,390,30538,2007,t1,legislative
19963,59,NORD,73200,41867,633,41234,2007,t1,legislative
19964,59,NORD,64298,35791,400,35391,2007,t1,legislative
19965,59,NORD,72845,43671,601,43070,2007,t1,legislative
19966,59,NORD,88186,52519,913,51606,2007,t1,legislative
19967,59,NORD,81031,52806,844,51962,2007,t1,legislative
19968,59,NORD,71031,36717,798,35919,2007,t1,legislative
19969,59,NORD,71976,35131,856,34275,2007,t1,legislative
19970,59,NORD,69867,39754,483,39271,2007,t1,legislative
19971,59,NORD,78409,40044,1008,39036,2007,t1,legislative
19972,59,NORD,86867,52300,900,51400,2007,t1,legislative
19973,59,NORD,70350,38982,1540,37442,2007,t1,legislative
19974,59,NORD,65044,41323,744,40579,2007,t1,legislative
19975,59,NORD,74163,48099,1244,46855,2007,t1,legislative
19976,59,NORD,74139,44637,1563,43074,2007,t1,legislative
19977,59,NORD,82277,47425,1128,46297,2007,t1,legislative
19978,59,NORD,75025,43579,740,42839,2007,t1,legislative
19979,59,NORD,79468,47857,982,46875,2007,t1,legislative
19980,59,NORD,80245,45643,1012,44631,2007,t1,legislative
19981,59,NORD,82715,46610,749,45861,2007,t1,legislative
19982,59,NORD,78768,44605,642,43963,2007,t1,legislative
19983,59,NORD,75051,46512,1020,45492,2007,t1,legislative
19984,59,NORD,66382,37721,661,37060,2007,t1,legislative
19985,59,NORD,65009,36713,897,35816,2007,t1,legislative
19986,60,OISE,79336,49479,1102,48377,2007,t1,legislative
19987,60,OISE,83957,50489,1556,48933,2007,t1,legislative
19988,60,OISE,69820,39445,694,38751,2007,t1,legislative
19989,60,OISE,88982,50995,784,50211,2007,t1,legislative
19990,60,OISE,69707,41238,534,40704,2007,t1,legislative
19991,60,OISE,73674,44489,839,43650,2007,t1,legislative
19992,60,OISE,73742,43378,759,42619,2007,t1,legislative
19993,61,ORNE,72490,45393,998,44395,2007,t1,legislative
19994,61,ORNE,70409,43843,780,43063,2007,t1,legislative
19995,61,ORNE,74026,47301,773,46528,2007,t1,legislative
19996,62,PAS-DE-CALAIS,79843,51657,1424,50233,2007,t1,legislative
19997,62,PAS-DE-CALAIS,76522,50382,1064,49318,2007,t1,legislative
19998,62,PAS-DE-CALAIS,75375,53024,1256,51768,2007,t1,legislative
19999,62,PAS-DE-CALAIS,78966,49658,1135,48523,2007,t1,legislative
20000,62,PAS-DE-CALAIS,64863,39524,741,38783,2007,t1,legislative
20001,62,PAS-DE-CALAIS,73692,43942,1048,42894,2007,t1,legislative
20002,62,PAS-DE-CALAIS,85833,48421,1175,47246,2007,t1,legislative
20003,62,PAS-DE-CALAIS,69110,45352,1105,44247,2007,t1,legislative
20004,62,PAS-DE-CALAIS,80924,51499,1366,50133,2007,t1,legislative
20005,62,PAS-DE-CALAIS,72398,41816,1110,40706,2007,t1,legislative
20006,62,PAS-DE-CALAIS,96649,56629,1667,54962,2007,t1,legislative
20007,62,PAS-DE-CALAIS,78977,44506,1300,43206,2007,t1,legislative
20008,62,PAS-DE-CALAIS,72668,40534,1339,39195,2007,t1,legislative
20009,62,PAS-DE-CALAIS,75660,44278,997,43281,2007,t1,legislative
20010,63,PUY-DE-DOME,61592,34329,575,33754,2007,t1,legislative
20011,63,PUY-DE-DOME,76660,46815,763,46052,2007,t1,legislative
20012,63,PUY-DE-DOME,74603,46805,777,46028,2007,t1,legislative
20013,63,PUY-DE-DOME,77677,49630,853,48777,2007,t1,legislative
20014,63,PUY-DE-DOME,66319,42132,1048,41084,2007,t1,legislative
20015,63,PUY-DE-DOME,88376,56216,1347,54869,2007,t1,legislative
20016,64,PYRENEES-ATLANTIQUES,68553,43696,644,43052,2007,t1,legislative
20017,64,PYRENEES-ATLANTIQUES,74315,49626,639,48987,2007,t1,legislative
20018,64,PYRENEES-ATLANTIQUES,80189,54394,978,53416,2007,t1,legislative
20019,64,PYRENEES-ATLANTIQUES,80284,55156,919,54237,2007,t1,legislative
20020,64,PYRENEES-ATLANTIQUES,82921,50613,699,49914,2007,t1,legislative
20021,64,PYRENEES-ATLANTIQUES,91679,56868,738,56130,2007,t1,legislative
20022,65,HAUTES-PYRENEES,60116,38674,1108,37566,2007,t1,legislative
20023,65,HAUTES-PYRENEES,63116,41957,844,41113,2007,t1,legislative
20024,65,HAUTES-PYRENEES,53431,33824,669,33155,2007,t1,legislative
20025,66,PYRENEES-ORIENTALES,66218,39192,659,38533,2007,t1,legislative
20026,66,PYRENEES-ORIENTALES,96750,59509,1468,58041,2007,t1,legislative
20027,66,PYRENEES-ORIENTALES,65996,41189,883,40306,2007,t1,legislative
20028,66,PYRENEES-ORIENTALES,87687,57244,1053,56191,2007,t1,legislative
20029,67,BAS-RHIN,52670,29739,255,29484,2007,t1,legislative
20030,67,BAS-RHIN,52296,28032,256,27776,2007,t1,legislative
20031,67,BAS-RHIN,66888,34655,419,34236,2007,t1,legislative
20032,67,BAS-RHIN,114052,64927,947,63980,2007,t1,legislative
20033,67,BAS-RHIN,99091,55352,1433,53919,2007,t1,legislative
20034,67,BAS-RHIN,80815,46929,776,46153,2007,t1,legislative
20035,67,BAS-RHIN,82832,46211,1131,45080,2007,t1,legislative
20036,67,BAS-RHIN,70558,39319,993,38326,2007,t1,legislative
20037,67,BAS-RHIN,104442,57715,1112,56603,2007,t1,legislative
20038,68,HAUT-RHIN,71936,41528,707,40821,2007,t1,legislative
20039,68,HAUT-RHIN,74954,43108,965,42143,2007,t1,legislative
20040,68,HAUT-RHIN,83080,49955,845,49110,2007,t1,legislative
20041,68,HAUT-RHIN,72707,39607,998,38609,2007,t1,legislative
20042,68,HAUT-RHIN,54524,29206,621,28585,2007,t1,legislative
20043,68,HAUT-RHIN,74758,39220,811,38409,2007,t1,legislative
20044,68,HAUT-RHIN,77078,43123,917,42206,2007,t1,legislative
20045,69,RHONE,63766,37381,358,37023,2007,t1,legislative
20046,69,RHONE,71687,44099,284,43815,2007,t1,legislative
20047,69,RHONE,67341,40235,294,39941,2007,t1,legislative
20048,69,RHONE,75061,46502,427,46075,2007,t1,legislative
20049,69,RHONE,83884,52760,443,52317,2007,t1,legislative
20050,69,RHONE,74405,41697,420,41277,2007,t1,legislative
20051,69,RHONE,60697,32115,353,31762,2007,t1,legislative
20052,69,RHONE,82222,51288,977,50311,2007,t1,legislative
20053,69,RHONE,80672,47040,603,46437,2007,t1,legislative
20054,69,RHONE,89806,56333,507,55826,2007,t1,legislative
20055,69,RHONE,80135,48678,733,47945,2007,t1,legislative
20056,69,RHONE,73979,45449,406,45043,2007,t1,legislative
20057,69,RHONE,91374,51393,551,50842,2007,t1,legislative
20058,69,RHONE,50332,25813,428,25385,2007,t1,legislative
20059,70,HAUTE-SAONE,63989,41972,746,41226,2007,t1,legislative
20060,70,HAUTE-SAONE,64120,39945,1225,38720,2007,t1,legislative
20061,70,HAUTE-SAONE,51743,33394,977,32417,2007,t1,legislative
20062,71,SAONE-ET-LOIRE,67442,40195,681,39514,2007,t1,legislative
20063,71,SAONE-ET-LOIRE,64533,40380,828,39552,2007,t1,legislative
20064,71,SAONE-ET-LOIRE,66700,41602,996,40606,2007,t1,legislative
20065,71,SAONE-ET-LOIRE,61845,38028,620,37408,2007,t1,legislative
20066,71,SAONE-ET-LOIRE,64593,38833,584,38249,2007,t1,legislative
20067,71,SAONE-ET-LOIRE,85150,55317,900,54417,2007,t1,legislative
20068,72,SARTHE,71456,43350,1272,42078,2007,t1,legislative
20069,72,SARTHE,82212,47908,1348,46560,2007,t1,legislative
20070,72,SARTHE,84049,51832,1494,50338,2007,t1,legislative
20071,72,SARTHE,78009,49558,964,48594,2007,t1,legislative
20072,72,SARTHE,86796,53757,1260,52497,2007,t1,legislative
20073,73,SAVOIE,109016,64363,884,63479,2007,t1,legislative
20074,73,SAVOIE,84730,47992,782,47210,2007,t1,legislative
20075,73,SAVOIE,95797,56994,732,56262,2007,t1,legislative
20076,74,HAUTE-SAVOIE,103984,61026,1154,59872,2007,t1,legislative
20077,74,HAUTE-SAVOIE,86645,50286,801,49485,2007,t1,legislative
20078,74,HAUTE-SAVOIE,86639,47706,497,47209,2007,t1,legislative
20079,74,HAUTE-SAVOIE,93007,49174,698,48476,2007,t1,legislative
20080,74,HAUTE-SAVOIE,106694,58237,1062,57175,2007,t1,legislative
20081,75,PARIS,63049,39560,317,39243,2007,t1,legislative
20082,75,PARIS,53592,36354,360,35994,2007,t1,legislative
20083,75,PARIS,43795,27746,170,27576,2007,t1,legislative
20084,75,PARIS,59601,37714,268,37446,2007,t1,legislative
20085,75,PARIS,49775,30200,279,29921,2007,t1,legislative
20086,75,PARIS,66033,40551,445,40106,2007,t1,legislative
20087,75,PARIS,63801,40833,324,40509,2007,t1,legislative
20088,75,PARIS,70833,46541,441,46100,2007,t1,legislative
20089,75,PARIS,61840,37693,450,37243,2007,t1,legislative
20090,75,PARIS,65243,43425,356,43069,2007,t1,legislative
20091,75,PARIS,59996,39235,317,38918,2007,t1,legislative
20092,75,PARIS,67807,43970,321,43649,2007,t1,legislative
20093,75,PARIS,70849,46388,288,46100,2007,t1,legislative
20094,75,PARIS,50765,31483,219,31264,2007,t1,legislative
20095,75,PARIS,43760,25575,124,25451,2007,t1,legislative
20096,75,PARIS,55455,35337,251,35086,2007,t1,legislative
20097,75,PARIS,56436,34102,372,33730,2007,t1,legislative
20098,75,PARIS,55839,34150,327,33823,2007,t1,legislative
20099,75,PARIS,48139,26927,339,26588,2007,t1,legislative
20100,75,PARIS,65986,38431,478,37953,2007,t1,legislative
20101,75,PARIS,75331,45189,486,44703,2007,t1,legislative
20102,76,SEINE-MARITIME,61131,36082,434,35648,2007,t1,legislative
20103,76,SEINE-MARITIME,87829,55910,1006,54904,2007,t1,legislative
20104,76,SEINE-MARITIME,56934,33989,677,33312,2007,t1,legislative
20105,76,SEINE-MARITIME,72432,44164,853,43311,2007,t1,legislative
20106,76,SEINE-MARITIME,89070,55473,1017,54456,2007,t1,legislative
20107,76,SEINE-MARITIME,79324,46129,819,45310,2007,t1,legislative
20108,76,SEINE-MARITIME,59175,34107,731,33376,2007,t1,legislative
20109,76,SEINE-MARITIME,52299,26115,833,25282,2007,t1,legislative
20110,76,SEINE-MARITIME,85480,53161,923,52238,2007,t1,legislative
20111,76,SEINE-MARITIME,84831,55328,1140,54188,2007,t1,legislative
20112,76,SEINE-MARITIME,75603,48422,763,47659,2007,t1,legislative
20113,76,SEINE-MARITIME,73187,47473,1009,46464,2007,t1,legislative
20114,77,SEINE-ET-MARNE,88516,49858,948,48910,2007,t1,legislative
20115,77,SEINE-ET-MARNE,77275,46787,582,46205,2007,t1,legislative
20116,77,SEINE-ET-MARNE,76553,45431,763,44668,2007,t1,legislative
20117,77,SEINE-ET-MARNE,82179,49808,767,49041,2007,t1,legislative
20118,77,SEINE-ET-MARNE,92701,53159,856,52303,2007,t1,legislative
20119,77,SEINE-ET-MARNE,81812,47562,587,46975,2007,t1,legislative
20120,77,SEINE-ET-MARNE,88626,49883,581,49302,2007,t1,legislative
20121,77,SEINE-ET-MARNE,111309,61682,760,60922,2007,t1,legislative
20122,77,SEINE-ET-MARNE,107419,61350,1045,60305,2007,t1,legislative
20123,78,YVELINES,91526,58209,834,57375,2007,t1,legislative
20124,78,YVELINES,77023,49636,506,49130,2007,t1,legislative
20125,78,YVELINES,69758,44688,332,44356,2007,t1,legislative
20126,78,YVELINES,75622,47331,457,46874,2007,t1,legislative
20127,78,YVELINES,70513,42810,442,42368,2007,t1,legislative
20128,78,YVELINES,60655,36787,456,36331,2007,t1,legislative
20129,78,YVELINES,75536,45779,559,45220,2007,t1,legislative
20130,78,YVELINES,67332,38348,843,37505,2007,t1,legislative
20131,78,YVELINES,86557,51272,830,50442,2007,t1,legislative
20132,78,YVELINES,101199,65205,992,64213,2007,t1,legislative
20133,78,YVELINES,58013,33600,455,33145,2007,t1,legislative
20134,78,YVELINES,71603,42212,783,41429,2007,t1,legislative
20135,79,DEUX-SEVRES,64340,39214,731,38483,2007,t1,legislative
20136,79,DEUX-SEVRES,73620,47703,1260,46443,2007,t1,legislative
20137,79,DEUX-SEVRES,61748,40744,959,39785,2007,t1,legislative
20138,79,DEUX-SEVRES,70157,45017,1331,43686,2007,t1,legislative
20139,80,SOMME,60149,32928,730,32198,2007,t1,legislative
20140,80,SOMME,64508,37559,750,36809,2007,t1,legislative
20141,80,SOMME,68507,47422,1195,46227,2007,t1,legislative
20142,80,SOMME,73104,46914,1764,45150,2007,t1,legislative
20143,80,SOMME,66054,42369,838,41531,2007,t1,legislative
20144,80,SOMME,78879,51141,1048,50093,2007,t1,legislative
20145,81,TARN,57444,38785,1361,37424,2007,t1,legislative
20146,81,TARN,79974,52931,1034,51897,2007,t1,legislative
20147,81,TARN,59763,40107,1039,39068,2007,t1,legislative
20148,81,TARN,80079,54820,1153,53667,2007,t1,legislative
20149,82,TARN-ET-GARONNE,82035,54606,1247,53359,2007,t1,legislative
20150,82,TARN-ET-GARONNE,84401,54417,1427,52990,2007,t1,legislative
20151,83,VAR,51322,29073,401,28672,2007,t1,legislative
20152,83,VAR,56870,31507,478,31029,2007,t1,legislative
20153,83,VAR,111745,65861,1037,64824,2007,t1,legislative
20154,83,VAR,121429,72343,1082,71261,2007,t1,legislative
20155,83,VAR,108222,63710,907,62803,2007,t1,legislative
20156,83,VAR,163122,98645,1726,96919,2007,t1,legislative
20157,83,VAR,107869,62231,970,61261,2007,t1,legislative
20158,84,VAUCLUSE,71552,42580,694,41886,2007,t1,legislative
20159,84,VAUCLUSE,120724,74930,1243,73687,2007,t1,legislative
20160,84,VAUCLUSE,97325,59562,1044,58518,2007,t1,legislative
20161,84,VAUCLUSE,82860,52108,1035,51073,2007,t1,legislative
20162,85,VENDEE,95367,58937,1692,57245,2007,t1,legislative
20163,85,VENDEE,91771,58443,1459,56984,2007,t1,legislative
20164,85,VENDEE,108496,66074,1360,64714,2007,t1,legislative
20165,85,VENDEE,90924,58244,1719,56525,2007,t1,legislative
20166,85,VENDEE,79289,50733,1188,49545,2007,t1,legislative
20167,86,VIENNE,82889,51923,1063,50860,2007,t1,legislative
20168,86,VIENNE,73476,46983,850,46133,2007,t1,legislative
20169,86,VIENNE,67732,44012,1232,42780,2007,t1,legislative
20170,86,VIENNE,75889,45382,1540,43842,2007,t1,legislative
20171,87,HAUTE-VIENNE,54280,35780,822,34958,2007,t1,legislative
20172,87,HAUTE-VIENNE,74006,51934,1548,50386,2007,t1,legislative
20173,87,HAUTE-VIENNE,66257,44679,1008,43671,2007,t1,legislative
20174,87,HAUTE-VIENNE,72016,48169,1126,47043,2007,t1,legislative
20175,88,VOSGES,76937,45040,1117,43923,2007,t1,legislative
20176,88,VOSGES,75672,43280,1230,42050,2007,t1,legislative
20177,88,VOSGES,67485,41802,964,40838,2007,t1,legislative
20178,88,VOSGES,69424,43122,966,42156,2007,t1,legislative
20179,89,YONNE,79225,47568,847,46721,2007,t1,legislative
20180,89,YONNE,73863,44099,1058,43041,2007,t1,legislative
20181,89,YONNE,93246,54900,1567,53333,2007,t1,legislative
20182,90,TERRITOIRE DE BELFORT,46738,28697,603,28094,2007,t1,legislative
20183,90,TERRITOIRE DE BELFORT,47487,29373,684,28689,2007,t1,legislative
20184,91,ESSONNE,67565,37660,521,37139,2007,t1,legislative
20185,91,ESSONNE,83858,52492,652,51840,2007,t1,legislative
20186,91,ESSONNE,93556,58241,725,57516,2007,t1,legislative
20187,91,ESSONNE,84608,53255,705,52550,2007,t1,legislative
20188,91,ESSONNE,65753,43579,391,43188,2007,t1,legislative
20189,91,ESSONNE,73040,45793,564,45229,2007,t1,legislative
20190,91,ESSONNE,71879,42352,538,41814,2007,t1,legislative
20191,91,ESSONNE,73380,44544,441,44103,2007,t1,legislative
20192,91,ESSONNE,74164,45050,490,44560,2007,t1,legislative
20193,91,ESSONNE,60771,35025,488,34537,2007,t1,legislative
20194,92,HAUTS-DE-SEINE,59278,30272,686,29586,2007,t1,legislative
20195,92,HAUTS-DE-SEINE,62446,37519,519,37000,2007,t1,legislative
20196,92,HAUTS-DE-SEINE,81948,50095,930,49165,2007,t1,legislative
20197,92,HAUTS-DE-SEINE,67297,39627,520,39107,2007,t1,legislative
20198,92,HAUTS-DE-SEINE,68265,41161,701,40460,2007,t1,legislative
20199,92,HAUTS-DE-SEINE,65925,42358,581,41777,2007,t1,legislative
20200,92,HAUTS-DE-SEINE,82882,52567,542,52025,2007,t1,legislative
20201,92,HAUTS-DE-SEINE,67440,42845,584,42261,2007,t1,legislative
20202,92,HAUTS-DE-SEINE,60773,38351,535,37816,2007,t1,legislative
20203,92,HAUTS-DE-SEINE,66488,42311,603,41708,2007,t1,legislative
20204,92,HAUTS-DE-SEINE,65593,40312,595,39717,2007,t1,legislative
20205,92,HAUTS-DE-SEINE,85821,56058,498,55560,2007,t1,legislative
20206,92,HAUTS-DE-SEINE,85152,55556,819,54737,2007,t1,legislative
20207,93,SEINE-SAINT-DENIS,50448,25325,397,24928,2007,t1,legislative
20208,93,SEINE-SAINT-DENIS,50029,24226,470,23756,2007,t1,legislative
20209,93,SEINE-SAINT-DENIS,45096,22171,435,21736,2007,t1,legislative
20210,93,SEINE-SAINT-DENIS,45413,22439,499,21940,2007,t1,legislative
20211,93,SEINE-SAINT-DENIS,53223,28121,376,27745,2007,t1,legislative
20212,93,SEINE-SAINT-DENIS,60998,33775,633,33142,2007,t1,legislative
20213,93,SEINE-SAINT-DENIS,49878,28060,376,27684,2007,t1,legislative
20214,93,SEINE-SAINT-DENIS,60720,35096,695,34401,2007,t1,legislative
20215,93,SEINE-SAINT-DENIS,55287,29434,472,28962,2007,t1,legislative
20216,93,SEINE-SAINT-DENIS,52429,28460,697,27763,2007,t1,legislative
20217,93,SEINE-SAINT-DENIS,58653,32237,448,31789,2007,t1,legislative
20218,93,SEINE-SAINT-DENIS,61850,35349,489,34860,2007,t1,legislative
20219,93,SEINE-SAINT-DENIS,69561,39750,612,39138,2007,t1,legislative
20220,94,VAL-DE-MARNE,54868,35046,427,34619,2007,t1,legislative
20221,94,VAL-DE-MARNE,64455,35233,566,34667,2007,t1,legislative
20222,94,VAL-DE-MARNE,68679,38777,615,38162,2007,t1,legislative
20223,94,VAL-DE-MARNE,70264,42621,671,41950,2007,t1,legislative
20224,94,VAL-DE-MARNE,61976,36231,381,35850,2007,t1,legislative
20225,94,VAL-DE-MARNE,77931,48097,419,47678,2007,t1,legislative
20226,94,VAL-DE-MARNE,58878,36343,411,35932,2007,t1,legislative
20227,94,VAL-DE-MARNE,61608,38917,404,38513,2007,t1,legislative
20228,94,VAL-DE-MARNE,51790,28023,521,27502,2007,t1,legislative
20229,94,VAL-DE-MARNE,61084,34114,467,33647,2007,t1,legislative
20230,94,VAL-DE-MARNE,56973,33327,522,32805,2007,t1,legislative
20231,94,VAL-DE-MARNE,64530,38646,456,38190,2007,t1,legislative
20232,95,VAL-D'OISE,76974,47098,667,46431,2007,t1,legislative
20233,95,VAL-D'OISE,114933,67128,1035,66093,2007,t1,legislative
20234,95,VAL-D'OISE,83938,49405,600,48805,2007,t1,legislative
20235,95,VAL-D'OISE,71858,43053,537,42516,2007,t1,legislative
20236,95,VAL-D'OISE,64076,34596,608,33988,2007,t1,legislative
20237,95,VAL-D'OISE,72546,41972,454,41518,2007,t1,legislative
20238,95,VAL-D'OISE,80868,46456,604,45852,2007,t1,legislative
20239,95,VAL-D'OISE,48848,24859,410,24449,2007,t1,legislative
20240,95,VAL-D'OISE,65352,35236,575,34661,2007,t1,legislative
20241,971,GUADELOUPE,62700,20528,1967,18561,2007,t1,legislative
20242,971,GUADELOUPE,88472,31024,1786,29238,2007,t1,legislative
20243,971,GUADELOUPE,81866,27865,2277,25588,2007,t1,legislative
20244,971,GUADELOUPE,70707,24254,1740,22514,2007,t1,legislative
20245,972,MARTINIQUE,60754,24120,1676,22444,2007,t1,legislative
20246,972,MARTINIQUE,61724,22025,1318,20707,2007,t1,legislative
20247,972,MARTINIQUE,62271,21884,1075,20809,2007,t1,legislative
20248,972,MARTINIQUE,103516,35854,1881,33973,2007,t1,legislative
20249,973,GUYANE,22318,8876,379,8497,2007,t1,legislative
20250,973,GUYANE,40490,15116,674,14442,2007,t1,legislative
20251,974,LA REUNION,83901,40485,1813,38672,2007,t1,legislative
20252,974,LA REUNION,108180,50586,3007,47579,2007,t1,legislative
20253,974,LA REUNION,126760,70209,2909,67300,2007,t1,legislative
20254,974,LA REUNION,93924,53484,2136,51348,2007,t1,legislative
20255,974,LA REUNION,100258,45542,2448,43094,2007,t1,legislative
20256,975,SAINT-PIERRE-ET-MIQUELON,4924,3233,123,3110,2007,t1,legislative
20257,985,MAYOTTE,64775,31797,1467,30330,2007,t1,legislative
20258,986,WALLIS ET FUTUNA,11160,7849,65,7784,2007,t1,legislative
20259,987,POLYNESIE FRANCAISE,93813,52894,413,52481,2007,t1,legislative
20260,987,POLYNESIE FRANCAISE,73916,39222,408,38814,2007,t1,legislative
20261,988,NOUVELLE-CALEDONIE,68940,37863,808,37055,2007,t1,legislative
20262,988,NOUVELLE-CALEDONIE,69695,37001,1242,35759,2007,t1,legislative
