,0 à 19 ans,20 à 39 ans,40 à 59 ans,60 à 74 ans,75 ans et plus,Total,region,year,gender
0,924706,980928,940648,430140,188377,3464799,Auvergne-Rhône-Alpes,2002,male
1,346292,359365,369787,180637,85288,1341369,Bourgogne-Franche-Comté,2002,male
2,378901,399448,387586,194917,86372,1447224,Bretagne,2002,male
3,311880,319996,330302,161616,81084,1204878,Centre-Val-de-Loire,2002,male
4,31667,34516,37906,20616,8743,133448,Corse,2002,male
5,711760,765534,728228,325409,123997,2654928,Grand Est,2002,male
6,848201,819338,753853,303331,128694,2853417,Hauts-de-France,2002,male
7,1491376,1712714,1462639,528483,213904,5409116,Île-de-France,2002,male
8,435882,428703,425548,191632,85292,1567057,Normandie,2002,male
9,624157,683948,718918,380865,192734,2600622,Nouvelle-Aquitaine,2002,male
10,598201,652670,657412,348670,175242,2432195,Occitanie,2002,male
11,440634,451573,428029,201355,93857,1615448,Pays de la Loire,2002,male
12,569720,583537,597864,312401,150981,2214503,Provence-Alpes-Côte d'Azur,2002,male
13,7713377,8192270,7838720,3580072,1614565,28939004,France métropolitaine,2002,male
14,64003,52629,44887,17499,7809,186827,Guadeloupe ,2002,male
15,58936,50940,45354,19756,8163,183149,Martinique ,2002,male
16,40175,25627,17724,3647,1199,88372,Guyane,2002,male
17,138131,112496,79038,24893,7423,361981,La Réunion,2002,male
18,301245,241692,187003,65795,24594,820329,DOM,2002,male
19,8014622,8433962,8025723,3645867,1639159,29759333,France métropolitaine et DOM,2002,male
20,928439,981192,955020,433191,194397,3492239,Auvergne-Rhône-Alpes,2003,male
21,344381,356813,374686,179853,88208,1343941,Bourgogne-Franche-Comté,2003,male
22,380473,399096,397156,193732,90114,1460571,Bretagne,2003,male
23,311265,318621,335419,161024,83405,1209734,Centre-Val-de-Loire,2003,male
24,31849,34928,38756,21094,9120,135747,Corse,2003,male
25,707265,760356,739102,324931,129118,2660772,Grand Est,2003,male
26,841699,815029,765801,298850,133470,2854849,Hauts-de-France,2003,male
27,1501201,1715858,1477787,533204,220474,5448524,Île-de-France,2003,male
28,432970,425270,432114,190591,88851,1569796,Normandie,2003,male
29,626735,682617,733709,380243,198411,2621715,Nouvelle-Aquitaine,2003,male
30,605954,654483,673355,350504,179555,2463851,Occitanie,2003,male
31,442168,452152,438192,200853,97893,1631258,Pays de la Loire,2003,male
32,573601,583116,606661,315981,155455,2234814,Provence-Alpes-Côte d'Azur,2003,male
33,7728000,8179531,7967758,3584051,1668471,29127811,France métropolitaine,2003,male
34,63762,50878,46446,17911,8154,187151,Guadeloupe ,2003,male
35,58691,49464,47121,20118,8341,183735,Martinique ,2003,male
36,41871,26607,18695,3843,1257,92273,Guyane,2003,male
37,138909,111490,82165,25909,7901,366374,La Réunion,2003,male
38,303233,238439,194427,67781,25653,829533,DOM,2003,male
39,8031233,8417970,8162185,3651832,1694124,29957344,France métropolitaine et DOM,2003,male
40,935647,976914,969438,437392,200492,3519883,Auvergne-Rhône-Alpes,2004,male
41,343737,352363,379797,179673,90821,1346391,Bourgogne-Franche-Comté,2004,male
42,383873,397023,405691,193758,93880,1474225,Bretagne,2004,male
43,312000,315828,339554,161329,85456,1214167,Centre-Val-de-Loire,2004,male
44,31962,35308,39724,21525,9535,138054,Corse,2004,male
45,705080,751778,751632,323543,134037,2666070,Grand Est,2004,male
46,838391,806338,776695,296242,138264,2855930,Hauts-de-France,2004,male
47,1512821,1714402,1493359,539546,225690,5485818,Île-de-France,2004,male
48,431592,419545,438313,191048,91993,1572491,Normandie,2004,male
49,631081,678869,746913,381474,203900,2642237,Nouvelle-Aquitaine,2004,male
50,615251,653744,688165,354323,184293,2495776,Occitanie,2004,male
51,445642,450777,447611,201599,101210,1646839,Pays de la Loire,2004,male
52,578499,580791,615579,320180,159742,2254791,Provence-Alpes-Côte d'Azur,2004,male
53,7765576,8133680,8092471,3601632,1719313,29312672,France métropolitaine,2004,male
54,63484,49261,48032,18334,8492,187603,Guadeloupe ,2004,male
55,58427,48041,48748,20557,8530,184303,Martinique ,2004,male
56,43840,27438,19597,4079,1346,96300,Guyane,2004,male
57,139757,110134,85995,26789,8380,371055,La Réunion,2004,male
58,305508,234874,202372,69759,26748,839261,DOM,2004,male
59,8071084,8368554,8294843,3671391,1746061,30151933,France métropolitaine et DOM,2004,male
60,941954,972732,984029,442771,207725,3549211,Auvergne-Rhône-Alpes,2005,male
61,342906,348352,384326,180330,93611,1349525,Bourgogne-Franche-Comté,2005,male
62,386924,395114,414793,194111,97548,1488490,Bretagne,2005,male
63,312463,313390,343685,161969,88022,1219529,Centre-Val-de-Loire,2005,male
64,32175,35442,40829,21917,10084,140447,Corse,2005,male
65,701776,744060,764678,322365,139744,2672623,Grand Est,2005,male
66,834032,799577,786133,295318,143808,2858868,Hauts-de-France,2005,male
67,1523903,1714639,1507668,547595,233402,5527207,Île-de-France,2005,male
68,429766,414913,443766,191603,95626,1575674,Normandie,2005,male
69,635661,674782,761512,383258,210261,2665474,Nouvelle-Aquitaine,2005,male
70,624624,653111,704175,357857,190088,2529855,Occitanie,2005,male
71,449120,449521,457451,202601,104997,1663690,Pays de la Loire,2005,male
72,583351,578670,625032,324893,164822,2276768,Provence-Alpes-Côte d'Azur,2005,male
73,7798655,8094303,8218077,3626588,1779738,29517361,France métropolitaine,2005,male
74,63488,47599,49270,18994,8807,188158,Guadeloupe ,2005,male
75,58068,46800,50041,21150,8782,184841,Martinique ,2005,male
76,45094,28028,20349,4319,1433,99223,Guyane,2005,male
77,140360,109192,89874,27756,8827,376009,La Réunion,2005,male
78,307010,231619,209534,72219,27849,848231,DOM,2005,male
79,8105665,8325922,8427611,3698807,1807587,30365592,France métropolitaine et DOM,2005,male
80,942316,972966,995733,447423,219242,3577680,Auvergne-Rhône-Alpes,2006,male
81,342762,345128,388798,181118,96153,1353959,Bourgogne-Franche-Comté,2006,male
82,388002,395815,423574,194000,99903,1501294,Bretagne,2006,male
83,313046,311260,348058,161737,90083,1224184,Centre-Val-de-Loire,2006,male
84,32862,35630,41762,22135,10695,143084,Corse,2006,male
85,697214,737346,773360,322187,147873,2677980,Grand Est,2006,male
86,827173,793442,796815,299803,143842,2861075,Hauts-de-France,2006,male
87,1532898,1721270,1520851,554267,240955,5570241,Île-de-France,2006,male
88,427348,411666,450191,191803,98329,1579337,Normandie,2006,male
89,640728,672451,774170,380466,218780,2686595,Nouvelle-Aquitaine,2006,male
90,631159,657057,717558,357166,199794,2562734,Occitanie,2006,male
91,453665,449748,466184,202806,108182,1680585,Pays de la Loire,2006,male
92,585627,579424,631977,327928,170707,2295663,Provence-Alpes-Côte d'Azur,2006,male
93,7814800,8083203,8329031,3642839,1844538,29714411,France métropolitaine,2006,male
94,63601,45987,50457,20181,8546,188772,Guadeloupe ,2006,male
95,58288,45310,50911,21815,9295,185619,Martinique ,2006,male
96,46744,28661,20826,4544,1257,102032,Guyane,2006,male
97,140283,107900,93844,28488,8695,379210,La Réunion,2006,male
98,308916,227858,216038,75028,27793,855633,DOM,2006,male
99,8123716,8311061,8545069,3717867,1872331,30570044,France métropolitaine et DOM,2006,male
100,946106,968266,999635,460030,226723,3600760,Auvergne-Rhône-Alpes,2007,male
101,343265,343000,388984,186685,98993,1360927,Bourgogne-Franche-Comté,2007,male
102,391673,392687,426878,199993,103440,1514671,Bretagne,2007,male
103,312587,309220,347977,166247,91980,1228011,Centre-Val-de-Loire,2007,male
104,32859,36436,42380,22826,11134,145635,Corse,2007,male
105,693412,731643,776846,330449,154360,2686710,Grand Est,2007,male
106,821823,792008,795384,310132,148487,2867834,Hauts-de-France,2007,male
107,1541012,1718376,1520894,573647,248482,5602411,Île-de-France,2007,male
108,426324,409349,450565,197874,101345,1585457,Normandie,2007,male
109,645555,672449,778862,391476,224834,2713176,Nouvelle-Aquitaine,2007,male
110,637846,658042,724763,367284,205542,2593477,Occitanie,2007,male
111,456938,449501,469689,209215,111804,1697147,Pays de la Loire,2007,male
112,589462,580350,638195,337649,175706,2321362,Provence-Alpes-Côte d'Azur,2007,male
113,7838862,8061327,8361052,3753507,1902830,29917578,France métropolitaine,2007,male
114,63118,44730,51025,20686,8766,188325,Guadeloupe ,2007,male
115,57391,44191,51680,22116,9592,184970,Martinique ,2007,male
116,47623,30538,21381,4720,1284,105546,Guyane,2007,male
117,141874,107793,97687,29243,8738,385335,La Réunion,2007,male
118,310006,227252,221773,76765,28380,864176,DOM,2007,male
119,8148868,8288579,8582825,3830272,1931210,30781754,France métropolitaine et DOM,2007,male
120,950173,966520,1001432,476479,233769,3628373,Auvergne-Rhône-Alpes,2008,male
121,343257,340497,386903,193131,101725,1365513,Bourgogne-Franche-Comté,2008,male
122,393983,392828,428901,207408,106348,1529468,Bretagne,2008,male
123,311134,306722,347094,171048,94642,1230640,Centre-Val-de-Loire,2008,male
124,32629,36628,43291,23668,11616,147832,Corse,2008,male
125,691107,725125,777576,339782,159631,2693221,Grand Est,2008,male
126,818196,791041,791976,320619,150606,2872438,Hauts-de-France,2008,male
127,1544247,1714616,1518008,595365,259149,5631385,Île-de-France,2008,male
128,425804,406673,449869,205081,104320,1591747,Normandie,2008,male
129,649040,669794,778512,405220,230335,2732901,Nouvelle-Aquitaine,2008,male
130,642408,659073,727296,378538,211872,2619187,Occitanie,2008,male
131,459550,448122,469779,217292,115564,1710307,Pays de la Loire,2008,male
132,588675,576934,638108,346655,181363,2331735,Provence-Alpes-Côte d'Azur,2008,male
133,7850203,8034573,8358745,3880286,1960940,30084747,France métropolitaine,2008,male
134,62866,43428,51583,21311,9201,188389,Guadeloupe ,2008,male
135,56042,42924,52617,22942,9912,184437,Martinique ,2008,male
136,49041,31065,22178,5039,1350,108673,Guyane,2008,male
137,143232,107767,100891,31137,9014,392041,La Réunion,2008,male
138,311181,225184,227269,80429,29477,873540,DOM,2008,male
139,8161384,8259757,8586014,3960715,1990417,30958287,France métropolitaine et DOM,2008,male
140,956040,966067,1003733,491818,240458,3658116,Auvergne-Rhône-Alpes,2009,male
141,343069,338115,384491,200497,103665,1369837,Bourgogne-Franche-Comté,2009,male
142,397154,390729,429027,215412,109036,1541358,Bretagne,2009,male
143,312362,303438,344921,176631,96454,1233806,Centre-Val-de-Loire,2009,male
144,32635,37235,43439,24393,11812,149514,Corse,2009,male
145,687643,719535,775193,351803,163544,2697718,Grand Est,2009,male
146,815948,788518,788362,333944,153246,2880018,Hauts-de-France,2009,male
147,1547605,1715425,1516081,616995,265665,5661771,Île-de-France,2009,male
148,424858,403951,448377,212751,107248,1597185,Normandie,2009,male
149,652415,666010,777536,419569,236088,2751618,Nouvelle-Aquitaine,2009,male
150,647842,659567,730742,391247,216901,2646299,Occitanie,2009,male
151,462113,447592,469879,225935,119120,1724639,Pays de la Loire,2009,male
152,584414,573663,636208,354898,186372,2335555,Provence-Alpes-Côte d'Azur,2009,male
153,7864098,8009845,8347989,4015893,2009609,30247434,France métropolitaine,2009,male
154,61891,41915,52453,22140,9468,187867,Guadeloupe ,2009,male
155,54973,41471,53091,23748,10372,183655,Martinique ,2009,male
156,50651,31046,22754,5333,1417,111201,Guyane,2009,male
157,142580,107599,103565,32516,9428,395688,La Réunion,2009,male
158,310095,222031,231863,83737,30685,878411,DOM,2009,male
159,8174193,8231876,8579852,4099630,2040294,31125845,France métropolitaine et DOM,2009,male
160,963054,963939,1008065,507106,246799,3688963,Auvergne-Rhône-Alpes,2010,male
161,341804,335179,382673,206355,105644,1371655,Bourgogne-Franche-Comté,2010,male
162,398753,388339,430247,222930,112979,1553248,Bretagne,2010,male
163,313943,299240,344095,182533,98862,1238673,Centre-Val-de-Loire,2010,male
164,33728,37357,43804,24786,11958,151633,Corse,2010,male
165,683063,712723,771668,363169,168351,2698974,Grand Est,2010,male
166,815216,782567,784532,346051,156020,2884386,Hauts-de-France,2010,male
167,1555858,1712418,1515473,634226,273259,5691234,Île-de-France,2010,male
168,422934,401484,446706,219978,109930,1601032,Normandie,2010,male
169,655557,663675,776595,432539,241260,2769626,Nouvelle-Aquitaine,2010,male
170,651525,659216,731786,403323,222175,2668025,Occitanie,2010,male
171,465782,445388,471839,233805,123050,1739864,Pays de la Loire,2010,male
172,581392,572121,635040,361966,190118,2340637,Provence-Alpes-Côte d'Azur,2010,male
173,7882609,7973646,8342523,4138767,2060405,30397950,France métropolitaine,2010,male
174,60830,40968,53018,23059,10037,187912,Guadeloupe ,2010,male
175,53523,39945,53444,24367,10831,182110,Martinique ,2010,male
176,51602,31336,23455,5678,1536,113607,Guyane,2010,male
177,142322,106232,106049,33732,9618,397953,La Réunion,2010,male
178,308277,218481,235966,86836,32022,881582,DOM,2010,male
179,8190886,8192127,8578489,4225603,2092427,31279532,France métropolitaine et DOM,2010,male
180,966480,964095,1010208,522490,252859,3716132,Auvergne-Rhône-Alpes,2011,male
181,340699,330867,380955,212934,107381,1372836,Bourgogne-Franche-Comté,2011,male
182,399979,385621,431952,230488,115301,1563341,Bretagne,2011,male
183,314707,295460,343153,188014,100724,1242058,Centre-Val-de-Loire,2011,male
184,33966,37600,44055,25924,12530,154075,Corse,2011,male
185,681467,705903,767746,375543,172376,2703035,Grand Est,2011,male
186,812607,775544,781855,359566,158663,2888235,Hauts-de-France,2011,male
187,1563721,1707551,1519793,654174,280252,5725491,Île-de-France,2011,male
188,422017,396768,444651,228124,112360,1603920,Normandie,2011,male
189,657211,659192,776428,445656,245383,2783870,Nouvelle-Aquitaine,2011,male
190,657995,659377,735744,416398,226254,2695768,Occitanie,2011,male
191,469575,442726,473385,242117,126351,1754154,Pays de la Loire,2011,male
192,581242,571107,634961,370293,193110,2350713,Provence-Alpes-Côte d'Azur,2011,male
193,7901666,7931811,8344886,4271721,2103544,30553628,France métropolitaine,2011,male
194,59401,40060,53628,24236,10457,187782,Guadeloupe ,2011,male
195,51780,38296,53842,25078,11680,180676,Martinique ,2011,male
196,53214,32107,24630,6170,1611,117732,Guyane,2011,male
197,140564,106143,108302,35724,10406,401139,La Réunion,2011,male
198,304959,216606,240402,91208,34154,887329,DOM,2011,male
199,8206625,8148417,8585288,4362929,2137698,31440957,France métropolitaine et DOM,2011,male
200,972109,961515,1017948,535788,258183,3745543,Auvergne-Rhône-Alpes,2012,male
201,338197,326898,380385,218433,109113,1373026,Bourgogne-Franche-Comté,2012,male
202,400595,381708,433913,237588,119293,1573097,Bretagne,2012,male
203,314120,291689,343475,193106,102444,1244834,Centre-Val-de-Loire,2012,male
204,33978,37686,44019,26281,12804,154768,Corse,2012,male
205,677762,696507,768409,386584,177324,2706586,Grand Est,2012,male
206,809000,767113,783096,372881,163157,2895247,Hauts-de-France,2012,male
207,1568454,1698577,1529170,666472,283989,5746662,Île-de-France,2012,male
208,420477,391551,444764,235775,114942,1607509,Normandie,2012,male
209,657883,654859,780339,457284,249956,2800321,Nouvelle-Aquitaine,2012,male
210,661698,658313,742112,428232,230823,2721178,Occitanie,2012,male
211,472678,440500,477471,250062,129066,1769777,Pays de la Loire,2012,male
212,581392,568392,637073,377731,196034,2360622,Provence-Alpes-Côte d'Azur,2012,male
213,7908343,7875308,8382174,4386217,2147128,30699170,France métropolitaine,2012,male
214,58237,39115,53912,25070,10704,187038,Guadeloupe ,2012,male
215,50482,36892,53894,25419,12137,178824,Martinique ,2012,male
216,52514,34009,24896,6518,1601,119538,Guyane,2012,male
217,139210,104954,110727,37357,11256,403504,La Réunion,2012,male
218,300443,214970,243429,94364,35698,888904,DOM,2012,male
219,8208786,8090278,8625603,4480581,2182826,31588074,France métropolitaine et DOM,2012,male
220,979659,958379,1027286,548909,263100,3777333,Auvergne-Rhône-Alpes,2013,male
221,338733,321890,379194,224129,110671,1374617,Bourgogne-Franche-Comté,2013,male
222,401755,379216,436282,244538,122281,1584072,Bretagne,2013,male
223,314931,287666,343857,198083,103639,1248176,Centre-Val-de-Loire,2013,male
224,34004,37750,44562,26734,13215,156265,Corse,2013,male
225,675895,687757,766137,397375,181580,2708744,Grand Est,2013,male
226,809437,759100,784359,384818,165177,2902891,Hauts-de-France,2013,male
227,1575965,1688427,1541486,682826,290633,5779337,Île-de-France,2013,male
228,420661,385955,444066,243630,116725,1611037,Normandie,2013,male
229,663074,648599,784181,470812,252863,2819529,Nouvelle-Aquitaine,2013,male
230,666735,656690,748254,442126,234463,2748268,Occitanie,2013,male
231,476639,437251,479880,258885,131721,1784376,Pays de la Loire,2013,male
232,582420,563858,641393,385162,198531,2371364,Provence-Alpes-Côte d'Azur,2013,male
233,7939908,7812538,8420937,4508027,2184599,30866009,France métropolitaine,2013,male
234,56808,37908,54439,26037,10885,186077,Guadeloupe ,2013,male
235,49379,35752,54090,26173,12561,177955,Martinique ,2013,male
236,53474,33985,25563,6990,1641,121653,Guyane,2013,male
237,137391,103259,112191,38999,11891,403731,La Réunion,2013,male
238,297052,210904,246283,98199,36978,889416,DOM,2013,male
239,8236960,8023442,8667220,4606226,2221577,31755425,France métropolitaine et DOM,2013,male
240,987520,952842,1035050,563083,268850,3807345,Auvergne-Rhône-Alpes,2014,male
241,338419,316414,378466,229048,112900,1375247,Bourgogne-Franche-Comté,2014,male
242,404493,372958,438799,251943,124617,1592810,Bretagne,2014,male
243,316044,283461,343864,202542,105337,1251248,Centre-Val-de-Loire,2014,male
244,34047,37721,44994,27528,13672,157962,Corse,2014,male
245,673625,679837,763218,407208,185770,2709658,Grand Est,2014,male
246,814070,752212,785731,395103,166988,2914104,Hauts-de-France,2014,male
247,1581715,1677874,1555256,698283,297060,5810188,Île-de-France,2014,male
248,421547,380873,443105,250859,118339,1614723,Normandie,2014,male
249,669567,641448,786579,483160,255576,2836330,Nouvelle-Aquitaine,2014,male
250,672547,654822,752111,453809,237176,2770465,Occitanie,2014,male
251,480786,433735,483383,266155,134528,1798587,Pays de la Loire,2014,male
252,582969,559403,645821,394842,203222,2386257,Provence-Alpes-Côte d'Azur,2014,male
253,7977349,7743600,8456377,4623563,2224035,31024924,France métropolitaine,2014,male
254,56294,36478,54120,26529,11251,184672,Guadeloupe ,2014,male
255,48444,34844,54208,27045,12961,177502,Martinique ,2014,male
256,55089,34315,26723,7395,1667,125189,Guyane,2014,male
257,138101,102223,113297,41099,12587,407307,La Réunion,2014,male
258,60648,26184,16891,3830,980,108533,Mayotte,2014,male
259,358576,234044,265239,105898,39446,1003203,DOM,2014,male
260,8335925,7977644,8721616,4729461,2263481,32028127,France métropolitaine et DOM,2014,male
261,994981,949489,1037705,575908,274898,3832981,Auvergne-Rhône-Alpes,2015,male
262,338678,311258,375277,234368,114865,1374446,Bourgogne-Franche-Comté,2015,male
263,406726,368626,439638,258701,127516,1601207,Bretagne,2015,male
264,315610,279225,342442,206915,106895,1251087,Centre-Val-de-Loire,2015,male
265,34945,36929,44994,28326,14232,159426,Corse,2015,male
266,671950,672558,757461,418365,190542,2710876,Grand Est,2015,male
267,813669,741174,782724,406835,169804,2914206,Hauts-de-France,2015,male
268,1592225,1667316,1560368,711494,303560,5834963,Île-de-France,2015,male
269,420227,376810,439938,258312,120671,1615958,Normandie,2015,male
270,671882,637498,786087,496191,258829,2850487,Nouvelle-Aquitaine,2015,male
271,676640,655262,752573,466426,241014,2791915,Occitanie,2015,male
272,484163,430738,485094,274238,137250,1811483,Pays de la Loire,2015,male
273,585060,558331,645657,402499,206804,2398351,Provence-Alpes-Côte d'Azur,2015,male
274,8006756,7685214,8449958,4738578,2266880,31147386,France métropolitaine,2015,male
275,54796,35299,54321,27175,11619,183210,Guadeloupe ,2015,male
276,47397,34085,53463,27908,13224,176077,Martinique ,2015,male
277,56262,35052,27781,8068,1719,128882,Guyane,2015,male
278,138820,101181,114045,43653,13063,410762,La Réunion,2015,male
279,61714,25938,17878,4127,1009,110666,Mayotte,2015,male
280,358989,231555,267488,110931,40634,1009597,DOM,2015,male
281,8365745,7916769,8717446,4849509,2307514,32156983,France métropolitaine et DOM,2015,male
282,996853,949189,1037421,589812,277965,3851240,Auvergne-Rhône-Alpes,2016,male
283,337115,309563,371249,239032,115833,1372792,Bourgogne-Franche-Comté,2016,male
284,405377,366919,438870,266317,128511,1605994,Bretagne,2016,male
285,314816,276480,339898,211953,107041,1250188,Centre-Val-de-Loire,2016,male
286,35004,36869,45340,28821,14765,160799,Corse,2016,male
287,669817,665503,750494,429903,192807,2708524,Grand Est,2016,male
288,809906,736338,777050,418528,170610,2912432,Hauts-de-France,2016,male
289,1594653,1659763,1562578,724375,307716,5849085,Île-de-France,2016,male
290,418286,372657,435454,265398,121513,1613308,Normandie,2016,male
291,672198,636012,781522,511069,259385,2860186,Nouvelle-Aquitaine,2016,male
292,680638,654404,750935,479764,242008,2807749,Occitanie,2016,male
293,484696,428800,484719,283577,138641,1820433,Pays de la Loire,2016,male
294,585309,556482,642606,408445,210630,2403472,Provence-Alpes-Côte d'Azur,2016,male
295,8004668,7648979,8418136,4856994,2287425,31216202,France métropolitaine,2016,male
296,53336,34319,53520,28307,11842,181324,Guadeloupe ,2016,male
297,45457,32963,52732,28726,13607,173485,Martinique ,2016,male
298,57410,36581,29150,8661,1857,133659,Guyane,2016,male
299,137123,99201,114529,45724,13981,410558,La Réunion,2016,male
300,64053,26920,18556,4284,1046,114859,Mayotte,2016,male
301,357379,229984,268487,115702,42333,1013885,DOM,2016,male
302,8362047,7878963,8686623,4972696,2329758,32230087,France métropolitaine et DOM,2016,male
303,997234,948780,1034817,601808,282054,3864693,Auvergne-Rhône-Alpes,2017,male
304,333554,306898,366617,245381,116275,1368725,Bourgogne-Franche-Comté,2017,male
305,405187,365297,437323,276331,128288,1612426,Bretagne,2017,male
306,313708,275083,336334,216923,106869,1248917,Centre-Val-de-Loire,2017,male
307,35358,37044,45407,29956,15171,162936,Corse,2017,male
308,666571,662074,741151,441128,194794,2705718,Grand Est,2017,male
309,804406,733632,770589,433007,168943,2910577,Hauts-de-France,2017,male
310,1601393,1658932,1566796,736236,311208,5874565,Île-de-France,2017,male
311,413853,371371,429345,273352,122120,1610041,Normandie,2017,male
312,671543,635564,775760,525064,260897,2868828,Nouvelle-Aquitaine,2017,male
313,681110,656092,749622,492338,244574,2823736,Occitanie,2017,male
314,484333,428368,484381,293206,139389,1829677,Pays de la Loire,2017,male
315,584578,553042,638541,415436,214393,2405990,Provence-Alpes-Côte d'Azur,2017,male
316,7992828,7632177,8376683,4980166,2304975,31286829,France métropolitaine,2017,male
317,51225,33663,52118,29620,12379,179005,Guadeloupe ,2017,male
318,43803,31878,51280,30113,14160,171234,Martinique ,2017,male
319,57104,35225,28438,9237,2012,132016,Guyane,2017,male
320,134596,97174,114204,48283,14700,408957,La Réunion,2017,male
321,66487,27941,19261,4449,1081,119219,Mayotte,2017,male
322,353215,225881,265301,121702,44332,1010431,DOM,2017,male
323,8346043,7858058,8641984,5101868,2349307,32297260,France métropolitaine et DOM,2017,male
324,879616,976323,956493,499243,339470,3651145,Auvergne-Rhône-Alpes,2002,female
325,329396,351955,369865,208760,148547,1408523,Bourgogne-Franche-Comté,2002,female
326,359771,383920,389444,237809,163597,1534541,Bretagne,2002,female
327,298946,319217,332031,184091,133815,1268100,Centre-Val-de-Loire,2002,female
328,29577,35718,37625,22440,15285,140645,Corse,2002,female
329,678929,750884,725061,381557,241356,2777787,Grand Est,2002,female
330,809666,819633,764123,384530,248524,3026476,Hauts-de-France,2002,female
331,1438402,1776728,1522238,624369,414710,5776447,Île-de-France,2002,female
332,419617,428071,430303,230925,155927,1664843,Normandie,2002,female
333,594368,684661,740600,437756,328301,2785686,Nouvelle-Aquitaine,2002,female
334,571018,661540,682414,397278,286258,2598508,Occitanie,2002,female
335,421594,441829,433585,237636,164557,1699201,Pays de la Loire,2002,female
336,541799,607907,639333,364123,261831,2414993,Provence-Alpes-Côte d'Azur,2002,female
337,7372699,8238386,8023115,4210517,2902178,30746895,France métropolitaine,2002,female
338,61608,60446,51107,21180,11856,206197,Guadeloupe ,2002,female
339,58079,59058,52198,23648,13170,206153,Martinique ,2002,female
340,39173,27572,16338,3496,1687,88266,Guyane,2002,female
341,133424,120372,82078,29128,13224,378226,La Réunion,2002,female
342,292284,267448,201721,77452,39937,878842,DOM,2002,female
343,7664983,8505834,8224836,4287969,2942115,31625737,France métropolitaine et DOM,2002,female
344,882260,977120,973884,499361,349055,3681680,Auvergne-Rhône-Alpes,2003,female
345,327500,349758,376251,207105,152184,1412798,Bourgogne-Franche-Comté,2003,female
346,361208,384070,399529,235646,168225,1548678,Bretagne,2003,female
347,298561,317950,338214,182999,136830,1274554,Centre-Val-de-Loire,2003,female
348,29663,36105,38895,22952,15665,143280,Corse,2003,female
349,674017,746288,738492,378573,248303,2785673,Grand Est,2003,female
350,803321,816777,779775,377293,255692,3032858,Hauts-de-France,2003,female
351,1447355,1779823,1546733,624513,423126,5821550,Île-de-France,2003,female
352,416689,425482,439314,228964,160595,1671044,Normandie,2003,female
353,596870,683554,757619,435140,336847,2810030,Nouvelle-Aquitaine,2003,female
354,578747,663856,700608,398077,293938,2635226,Occitanie,2003,female
355,423048,442726,444204,236899,169540,1716417,Pays de la Loire,2003,female
356,545277,608266,651323,367119,268257,2440242,Provence-Alpes-Côte d'Azur,2003,female
357,7384516,8231775,8184841,4194641,2978257,30974030,France métropolitaine,2003,female
358,61065,59440,53203,21639,12383,207730,Guadeloupe ,2003,female
359,57928,57933,54406,24051,13623,207941,Martinique ,2003,female
360,40920,28828,17333,3654,1784,92519,Guyane,2003,female
361,134196,120167,86162,30167,13774,384466,La Réunion,2003,female
362,294109,266368,211104,79511,41564,892656,DOM,2003,female
363,7678625,8498143,8395945,4274152,3019821,31866686,France métropolitaine et DOM,2003,female
364,887448,973387,991961,500878,358276,3711950,Auvergne-Rhône-Alpes,2004,female
365,326810,345819,382697,205867,155350,1416543,Bourgogne-Franche-Comté,2004,female
366,364154,382215,408932,234610,172941,1562852,Bretagne,2004,female
367,299099,315035,344187,182177,139614,1280112,Centre-Val-de-Loire,2004,female
368,29775,36303,40270,23302,16268,145918,Corse,2004,female
369,671954,737633,753405,375094,254722,2792808,Grand Est,2004,female
370,799189,809885,794418,372135,262400,3038027,Hauts-de-France,2004,female
371,1458148,1779446,1570483,626828,429567,5864472,Île-de-France,2004,female
372,415444,420991,447320,228081,164893,1676729,Normandie,2004,female
373,601045,680027,773139,434568,345497,2834276,Nouvelle-Aquitaine,2004,female
374,588044,663670,717754,400882,301426,2671776,Occitanie,2004,female
375,426571,441316,454102,236967,173989,1732945,Pays de la Loire,2004,female
376,549082,606386,663500,371153,274220,2464341,Provence-Alpes-Côte d'Azur,2004,female
377,7416763,8192113,8342168,4192542,3049163,31192749,France métropolitaine,2004,female
378,60826,58339,55345,21968,12911,209389,Guadeloupe ,2004,female
379,57634,56757,56740,24342,14076,209549,Martinique ,2004,female
380,42834,29864,18425,3872,1872,96867,Guyane,2004,female
381,134832,119883,90337,31159,14364,390575,La Réunion,2004,female
382,296126,264843,220847,81341,43223,906380,DOM,2004,female
383,7712889,8456956,8563015,4273883,3092386,32099129,France métropolitaine et DOM,2004,female
384,892981,969773,1009214,504461,369875,3746304,Auvergne-Rhône-Alpes,2005,female
385,326242,342239,388544,205328,160056,1422409,Bourgogne-Franche-Comté,2005,female
386,366989,380587,418443,233836,178240,1578095,Bretagne,2005,female
387,299643,312344,349879,182141,143710,1287717,Centre-Val-de-Loire,2005,female
388,29901,36375,41646,23816,16907,148645,Corse,2005,female
389,669428,730439,767892,372104,262784,2802647,Grand Est,2005,female
390,794312,804716,807231,369081,270433,3045773,Hauts-de-France,2005,female
391,1468211,1780808,1593052,631599,441266,5914936,Île-de-France,2005,female
392,413675,416902,454944,227867,170040,1683428,Normandie,2005,female
393,605431,676238,789231,434689,355927,2861516,Nouvelle-Aquitaine,2005,female
394,596427,664048,735750,404072,310639,2710936,Occitanie,2005,female
395,430069,440011,464635,237125,179861,1751701,Pays de la Loire,2005,female
396,553025,604480,675491,375599,283201,2491796,Provence-Alpes-Côte d'Azur,2005,female
397,7446334,8158960,8495952,4201718,3142939,31445903,France métropolitaine,2005,female
398,60667,56963,57339,22746,13305,211020,Guadeloupe ,2005,female
399,57179,55649,58835,24911,14567,211141,Martinique ,2005,female
400,43962,30742,19265,4034,1980,99983,Guyane,2005,female
401,135050,120048,94670,32185,14945,396898,La Réunion,2005,female
402,296858,263402,230109,83876,44797,919042,DOM,2005,female
403,7743192,8422362,8726061,4285594,3187736,32364945,France métropolitaine et DOM,2005,female
404,896237,968716,1024398,505357,384896,3779604,Auvergne-Rhône-Alpes,2006,female
405,324401,338631,392841,204395,165234,1425502,Bourgogne-Franche-Comté,2006,female
406,369351,380514,426865,231558,184952,1593240,Bretagne,2006,female
407,300683,310078,355288,181795,147539,1295383,Centre-Val-de-Loire,2006,female
408,30414,36031,42944,24179,17466,151034,Corse,2006,female
409,664690,724170,781627,367424,274201,2812112,Grand Est,2006,female
410,789199,798931,820031,367226,276537,3051924,Hauts-de-France,2006,female
411,1475559,1787532,1613109,635145,450812,5962157,Île-de-France,2006,female
412,410979,414411,460989,226614,175518,1688511,Normandie,2006,female
413,609445,673901,806249,433409,365222,2888226,Nouvelle-Aquitaine,2006,female
414,603803,666154,752267,404428,321580,2748232,Occitanie,2006,female
415,433440,440171,474122,235820,186275,1769828,Pays de la Loire,2006,female
416,557400,604029,687405,379511,291224,2519569,Provence-Alpes-Côte d'Azur,2006,female
417,7465601,8143269,8638135,4196861,3241456,31685322,France métropolitaine,2006,female
418,60449,55512,58664,23933,13406,211964,Guadeloupe ,2006,female
419,56521,54111,60352,25943,15186,212113,Martinique ,2006,female
420,45784,31987,20052,4352,1747,103922,Guyane,2006,female
421,135682,119133,98891,33970,15076,402752,La Réunion,2006,female
422,298436,260743,237959,88198,45415,930751,DOM,2006,female
423,7764037,8404012,8876094,4285059,3286871,32616073,France métropolitaine et DOM,2006,female
424,900885,964467,1028415,515150,395529,3804446,Auvergne-Rhône-Alpes,2007,female
425,323728,336569,393895,208561,168882,1431635,Bourgogne-Franche-Comté,2007,female
426,371180,378371,429892,236137,190037,1605617,Bretagne,2007,female
427,299260,308974,355158,185215,150301,1298908,Centre-Val-de-Loire,2007,female
428,30450,36710,43489,24844,18081,153574,Corse,2007,female
429,661364,719202,785778,371649,281913,2819906,Grand Est,2007,female
430,782050,796374,818398,373153,284221,3054196,Hauts-de-France,2007,female
431,1480965,1784919,1618036,650487,462048,5996455,Île-de-France,2007,female
432,408403,411234,460934,231018,181099,1692688,Normandie,2007,female
433,613588,673731,811557,442664,372955,2914495,Nouvelle-Aquitaine,2007,female
434,607939,666489,760406,412693,330113,2777640,Occitanie,2007,female
435,436676,439895,477465,240873,190538,1785447,Pays de la Loire,2007,female
436,559744,603175,694071,387898,297765,2542653,Provence-Alpes-Côte d'Azur,2007,female
437,7476232,8120110,8677494,4280342,3323482,31877660,France métropolitaine,2007,female
438,59859,53921,59947,24720,13812,212259,Guadeloupe ,2007,female
439,56422,52938,61543,26379,15478,212760,Martinique ,2007,female
440,47099,33399,20586,4500,1901,107485,Guyane,2007,female
441,136316,119899,102585,34505,15467,408772,La Réunion,2007,female
442,299696,260157,244661,90104,46658,941276,DOM,2007,female
443,7775928,8380267,8922155,4370446,3370140,32818936,France métropolitaine et DOM,2007,female
444,905583,963090,1029255,528082,404709,3830719,Auvergne-Rhône-Alpes,2008,female
445,323604,334318,393132,213161,172791,1437006,Bourgogne-Franche-Comté,2008,female
446,373689,377678,432621,242123,194122,1620233,Bretagne,2008,female
447,297674,306019,354456,189058,153741,1300948,Centre-Val-de-Loire,2008,female
448,30402,36831,44047,25521,18333,155134,Corse,2008,female
449,657888,715084,788155,378165,288939,2828231,Grand Est,2008,female
450,778989,795292,816241,380694,287437,3058653,Hauts-de-France,2008,female
451,1485107,1784818,1614028,670298,473624,6027875,Île-de-France,2008,female
452,408432,408892,461496,236609,185916,1701345,Normandie,2008,female
453,617508,671728,812334,453999,382606,2938175,Nouvelle-Aquitaine,2008,female
454,611389,665682,762119,423115,338454,2800759,Occitanie,2008,female
455,439130,438610,478685,246998,196440,1799863,Pays de la Loire,2008,female
456,557977,598789,694061,396923,303428,2551178,Provence-Alpes-Côte d'Azur,2008,female
457,7487372,8096831,8680630,4384746,3400540,32050119,France métropolitaine,2008,female
458,59449,53407,60781,25483,14275,213395,Guadeloupe ,2008,female
459,55659,51994,62619,27130,15854,213256,Martinique ,2008,female
460,48189,34272,21420,4747,1965,110593,Guyane,2008,female
461,136832,120660,106408,36419,15890,416209,La Réunion,2008,female
462,300129,260333,251228,93779,47984,953453,DOM,2008,female
463,7787501,8357164,8931858,4478525,3448524,33003572,France métropolitaine et DOM,2008,female
464,911885,962191,1032013,541852,411947,3859888,Auvergne-Rhône-Alpes,2009,female
465,323149,331081,391998,218383,176200,1440811,Bourgogne-Franche-Comté,2009,female
466,376498,377302,432451,249084,198371,1633706,Bretagne,2009,female
467,297520,303324,353210,194643,156087,1304784,Centre-Val-de-Loire,2009,female
468,30117,37270,44249,25960,18564,156160,Corse,2009,female
469,653588,710475,788347,387327,293663,2833400,Grand Est,2009,female
470,776196,791410,813629,391240,291861,3064336,Hauts-de-France,2009,female
471,1494658,1787978,1614047,689363,480423,6066469,Île-de-France,2009,female
472,407359,406116,459883,243263,190016,1706637,Normandie,2009,female
473,620106,669493,811376,467512,388392,2956879,Nouvelle-Aquitaine,2009,female
474,616544,664986,765289,435735,344744,2827298,Occitanie,2009,female
475,440977,438856,478389,255510,200677,1814409,Pays de la Loire,2009,female
476,556145,592125,691744,404462,309022,2553498,Provence-Alpes-Côte d'Azur,2009,female
477,7504742,8072607,8676625,4504334,3459967,32218275,France métropolitaine,2009,female
478,58421,52003,61951,26680,14632,213687,Guadeloupe ,2009,female
479,53918,50847,63649,27947,16388,212749,Martinique ,2009,female
480,49029,34727,22324,5145,2043,113268,Guyane,2009,female
481,137005,120139,109600,37452,16480,420676,La Réunion,2009,female
482,298373,257716,257524,97224,49543,960380,DOM,2009,female
483,7803115,8330323,8934149,4601558,3509510,33178655,France métropolitaine et DOM,2009,female
484,919149,960640,1034628,556243,418455,3889115,Auvergne-Rhône-Alpes,2010,female
485,322735,328349,389361,223544,178234,1442223,Bourgogne-Franche-Comté,2010,female
486,378889,374321,433509,255870,203229,1645818,Bretagne,2010,female
487,299316,299328,353134,199287,158327,1309392,Centre-Val-de-Loire,2010,female
488,31142,37121,44490,26458,18849,158060,Corse,2010,female
489,650013,702750,785227,397258,298308,2833556,Grand Est,2010,female
490,775571,785452,809454,401685,296453,3068615,Hauts-de-France,2010,female
491,1500287,1790007,1609778,707436,487492,6095000,Île-de-France,2010,female
492,404771,402905,458648,249661,193431,1709416,Normandie,2010,female
493,624003,666772,811976,478815,394294,2975860,Nouvelle-Aquitaine,2010,female
494,618852,666056,767502,447422,350249,2850081,Occitanie,2010,female
495,444417,438005,480028,263694,205487,1831631,Pays de la Loire,2010,female
496,554838,588701,689301,412792,312886,2558518,Provence-Alpes-Côte d'Azur,2010,female
497,7523983,8040407,8667036,4620165,3515694,32367285,France métropolitaine,2010,female
498,57945,51431,63186,27685,15196,215443,Guadeloupe ,2010,female
499,52170,49804,64519,28697,16873,212063,Martinique ,2010,female
500,49675,34993,23127,5557,2081,115433,Guyane,2010,female
501,135876,119207,112904,38009,17187,423183,La Réunion,2010,female
502,295666,255435,263736,99948,51337,966122,DOM,2010,female
503,7819649,8295842,8930772,4720113,3567031,33333407,France métropolitaine et DOM,2010,female
504,921718,962675,1036170,571842,425686,3918091,Auvergne-Rhône-Alpes,2011,female
505,321324,325188,386527,229654,180645,1443338,Bourgogne-Franche-Comté,2011,female
506,380429,371483,434229,262406,205879,1654426,Bretagne,2011,female
507,299922,296989,352326,204848,160692,1314777,Centre-Val-de-Loire,2011,female
508,31433,37582,44888,27388,19120,160411,Corse,2011,female
509,647104,696099,782000,408190,302607,2836000,Grand Est,2011,female
510,772436,780253,806625,413182,299439,3071935,Hauts-de-France,2011,female
511,1507296,1785488,1611430,729525,493621,6127360,Île-de-France,2011,female
512,402276,398510,457003,256619,196749,1711157,Normandie,2011,female
513,625795,661100,810566,492901,398846,2989208,Nouvelle-Aquitaine,2011,female
514,626114,663269,771791,460760,355764,2877698,Occitanie,2011,female
515,448567,436292,481161,271386,209553,1846959,Pays de la Loire,2011,female
516,554328,585124,688436,421501,315967,2565356,Provence-Alpes-Côte d'Azur,2011,female
517,7538742,8000052,8663152,4750202,3564568,32516716,France métropolitaine,2011,female
518,57146,50399,64232,28997,16079,216853,Guadeloupe ,2011,female
519,50533,48044,65456,29590,17992,211615,Martinique ,2011,female
520,50849,36287,24259,6170,2252,119817,Guyane,2011,female
521,134375,119189,115333,40123,18422,427442,La Réunion,2011,female
522,292903,253919,269280,104880,54745,975727,DOM,2011,female
523,7831645,8253971,8932432,4855082,3619313,33492443,France métropolitaine et DOM,2011,female
524,926799,961474,1044379,585944,431125,3949721,Auvergne-Rhône-Alpes,2012,female
525,320071,320668,386126,235011,181912,1443788,Bourgogne-Franche-Comté,2012,female
526,381402,368352,436170,268262,209814,1664000,Bretagne,2012,female
527,299255,294101,352062,210420,162914,1318752,Centre-Val-de-Loire,2012,female
528,31402,38014,44900,27669,19504,161489,Corse,2012,female
529,644989,687181,783149,419165,307885,2842369,Grand Est,2012,female
530,769766,771943,806852,424543,304747,3077851,Hauts-de-France,2012,female
531,1512782,1781245,1617210,746305,494298,6151840,Île-de-France,2012,female
532,400762,394676,457355,263613,198841,1715247,Normandie,2012,female
533,627716,657768,813855,506255,402679,3008273,Nouvelle-Aquitaine,2012,female
534,629012,664525,777807,473555,360781,2905680,Occitanie,2012,female
535,452387,433662,485225,279401,212162,1862837,Pays de la Loire,2012,female
536,552970,583645,690784,429693,317862,2574954,Provence-Alpes-Côte d'Azur,2012,female
537,7549313,7957254,8695874,4869836,3604524,32676801,France métropolitaine,2012,female
538,56208,48623,65235,29569,16641,216276,Guadeloupe ,2012,female
539,49364,45723,65519,30451,18483,209540,Martinique ,2012,female
540,50516,36338,24498,6483,2275,120110,Guyane,2012,female
541,132926,117936,118198,41800,19580,430440,La Réunion,2012,female
542,289014,248620,273450,108303,56979,976366,DOM,2012,female
543,7838327,8205874,8969324,4978139,3661503,33653167,France métropolitaine et DOM,2012,female
544,933024,959203,1050577,602367,435091,3980262,Auvergne-Rhône-Alpes,2013,female
545,319862,316033,385231,241180,182860,1445166,Bourgogne-Franche-Comté,2013,female
546,383135,366524,438059,274396,212521,1674635,Bretagne,2013,female
547,299879,290004,352060,216419,164010,1322372,Centre-Val-de-Loire,2013,female
548,31583,38321,45801,28428,19810,163943,Corse,2013,female
549,641881,678840,781552,430175,311196,2843644,Grand Est,2013,female
550,772037,763647,806453,436448,306407,3084992,Hauts-de-France,2013,female
551,1517387,1774810,1623225,767363,497685,6180470,Île-de-France,2013,female
552,400612,387998,456856,271453,200408,1717327,Normandie,2013,female
553,630307,652097,816238,521254,404752,3024648,Nouvelle-Aquitaine,2013,female
554,633927,664594,783139,488658,365292,2935610,Occitanie,2013,female
555,456082,429773,487008,288222,215391,1876476,Pays de la Loire,2013,female
556,553472,579680,692049,438126,318984,2582311,Provence-Alpes-Côte d'Azur,2013,female
557,7573188,7901524,8718248,5004489,3634407,32831856,France métropolitaine,2013,female
558,55312,47137,65772,30835,16986,216042,Guadeloupe ,2013,female
559,47937,43578,65897,31204,18980,207596,Martinique ,2013,female
560,51347,36334,25554,6804,2426,122465,Guyane,2013,female
561,131337,116637,119634,43398,20366,431372,La Réunion,2013,female
562,285933,243686,276857,112241,58758,977475,DOM,2013,female
563,7859121,8145210,8995105,5116730,3693165,33809331,France métropolitaine et DOM,2013,female
564,941415,955019,1056866,619102,441219,4013621,Auvergne-Rhône-Alpes,2014,female
565,319224,310948,384242,246511,184451,1445376,Bourgogne-Franche-Comté,2014,female
566,384483,361650,440909,281401,215290,1683733,Bretagne,2014,female
567,301250,287029,351862,220793,165253,1326187,Centre-Val-de-Loire,2014,female
568,31869,38953,46002,29339,20087,166250,Corse,2014,female
569,640862,670138,778916,439968,315103,2844987,Grand Est,2014,female
570,774400,755837,806633,447747,307435,3092052,Hauts-de-France,2014,female
571,1525668,1768699,1636168,786290,500552,6217377,Île-de-France,2014,female
572,401789,382207,456543,278196,202187,1720922,Normandie,2014,female
573,635414,645471,818963,535450,407516,3042814,Nouvelle-Aquitaine,2014,female
574,640571,664038,787050,501008,367621,2960288,Occitanie,2014,female
575,460218,427767,489855,295946,218460,1892246,Pays de la Loire,2014,female
576,554196,573863,695936,449397,323789,2597181,Provence-Alpes-Côte d'Azur,2014,female
577,7611359,7841619,8749945,5131148,3668963,33003034,France métropolitaine,2014,female
578,54486,45876,65976,32031,17145,215514,Guadeloupe ,2014,female
579,46508,41997,65998,32286,19620,206409,Martinique ,2014,female
580,53526,37294,26712,7188,2429,127149,Guyane,2014,female
581,131704,115562,121302,45476,21416,435460,La Réunion,2014,female
582,61217,34417,15032,3401,1113,115180,Mayotte,2014,female
583,347441,275146,295020,120382,61723,1099712,DOM,2014,female
584,7958800,8116765,9044965,5251530,3730686,34102746,France métropolitaine et DOM,2014,female
585,950208,954172,1059846,635091,445400,4044717,Auvergne-Rhône-Alpes,2015,female
586,319241,306894,381864,252402,186093,1446494,Bourgogne-Franche-Comté,2015,female
587,386004,358616,441672,288513,217838,1692643,Bretagne,2015,female
588,302285,282451,350588,225375,166806,1327505,Centre-Val-de-Loire,2015,female
589,32778,38095,46134,30288,20562,167857,Corse,2015,female
590,639345,665117,773551,451757,318405,2848175,Grand Est,2015,female
591,776307,746405,802892,460835,309331,3095770,Hauts-de-France,2015,female
592,1535267,1766242,1639456,803307,502909,6247181,Île-de-France,2015,female
593,400427,378484,453591,285726,204945,1723173,Normandie,2015,female
594,640167,643399,817706,549952,409771,3060995,Nouvelle-Aquitaine,2015,female
595,643641,665758,786220,515394,371257,2982270,Occitanie,2015,female
596,463313,426848,491431,303957,221480,1907029,Pays de la Loire,2015,female
597,556039,573665,694363,459444,326115,2609626,Provence-Alpes-Côte d'Azur,2015,female
598,7645022,7806146,8739314,5262041,3700912,33153435,France métropolitaine,2015,female
599,53261,44574,66390,32797,17758,214780,Guadeloupe ,2015,female
600,45236,40962,65352,33272,19978,204800,Martinique ,2015,female
601,54549,38469,27574,7853,2538,130983,Guyane,2015,female
602,132114,114770,122740,48339,22002,439965,La Réunion,2015,female
603,63087,35817,17735,3772,1112,121523,Mayotte,2015,female
604,348247,274592,299791,126033,63388,1112051,DOM,2015,female
605,7993269,8080738,9039105,5388074,3764300,34265486,France métropolitaine et DOM,2015,female
606,950888,957288,1057136,653045,447292,4065649,Auvergne-Rhône-Alpes,2016,female
607,317349,305265,378236,258544,186152,1445546,Bourgogne-Franche-Comté,2016,female
608,386235,357394,441891,297042,217973,1700535,Bretagne,2016,female
609,300792,280084,348015,231736,167051,1327678,Centre-Val-de-Loire,2016,female
610,32663,38482,46773,30907,20831,169656,Corse,2016,female
611,636442,659913,766564,465750,317993,2846662,Grand Est,2016,female
612,772154,742218,796976,474644,308446,3094438,Hauts-de-France,2016,female
613,1537835,1765582,1637860,822730,504040,6268047,Île-de-France,2016,female
614,397836,376336,448629,294401,205419,1722621,Normandie,2016,female
615,640280,643378,814985,567250,409524,3075417,Nouvelle-Aquitaine,2016,female
616,649620,663468,786295,530365,370938,3000686,Occitanie,2016,female
617,462034,426612,491823,314343,222387,1917199,Pays de la Loire,2016,female
618,556730,573220,690719,468442,329345,2618456,Provence-Alpes-Côte d'Azur,2016,female
619,7640858,7789240,8705902,5409199,3707391,33252590,France métropolitaine,2016,female
620,51759,43127,65925,33927,18048,212786,Guadeloupe ,2016,female
621,43958,39755,64820,33890,20572,202995,Martinique ,2016,female
622,56015,39617,28912,8431,2718,135693,Guyane,2016,female
623,132016,112644,124023,50715,22968,442366,La Réunion,2016,female
624,65478,37173,18406,3916,1155,126128,Mayotte,2016,female
625,349226,272316,302086,130879,65461,1119968,DOM,2016,female
626,7990084,8061556,9007988,5540078,3772852,34372558,France métropolitaine et DOM,2016,female
627,950927,958995,1052486,668333,452853,4083594,Auvergne-Rhône-Alpes,2017,female
628,314295,302358,374312,265801,185932,1442698,Bourgogne-Franche-Comté,2017,female
629,384517,356533,440045,307862,217521,1706478,Bretagne,2017,female
630,299815,278675,344118,237557,167170,1327335,Centre-Val-de-Loire,2017,female
631,32502,39120,46997,31940,21443,172002,Corse,2017,female
632,631775,656643,755859,479764,319827,2843868,Grand Est,2017,female
633,767613,739087,788436,492855,305247,3093238,Hauts-de-France,2017,female
634,1544636,1769873,1636029,841785,507992,6300315,Île-de-France,2017,female
635,393714,374704,441924,303913,206182,1720437,Normandie,2017,female
636,638037,644180,809772,584085,412076,3088150,Nouvelle-Aquitaine,2017,female
637,649954,666788,784906,545312,374406,3021366,Occitanie,2017,female
638,460299,428330,490104,325149,224041,1927923,Pays de la Loire,2017,female
639,555236,572572,686801,476975,333316,2624900,Provence-Alpes-Côte d'Azur,2017,female
640,7623320,7787858,8651789,5561331,3728006,33352304,France métropolitaine,2017,female
641,50017,42076,65275,35105,18775,211248,Guadeloupe ,2017,female
642,42863,38497,63799,35105,21096,201360,Martinique ,2017,female
643,56162,39513,29082,9076,2851,136684,Guyane,2017,female
644,129976,112372,124779,53528,24047,444702,La Réunion,2017,female
645,67967,38586,19107,4066,1198,130924,Mayotte,2017,female
646,346985,271044,302042,136880,67967,1124918,DOM,2017,female
647,7970305,8058902,8953831,5698211,3795973,34477222,France métropolitaine et DOM,2017,female
